PokerStars Hand #222978954384:  Hold'em No Limit ($2.50/$5.00 USD) - 2021/01/23 19:01:47 ET
Table 'Aaltje II' 6-max Seat #1 is the button
Seat 1: Rabarber77 ($400 in chips)
Seat 2: tekstilschik ($214.35 in chips)
Seat 3: spat93 ($500 in chips)
tekstilschik: posts small blind $2.50
spat93: posts big blind $5
*** HOLE CARDS ***
777Koresh777 joins the table at seat #4
Rabarber77: folds
CarlosW1973 joins the table at seat #5
tekstilschik: raises $12.50 to $17.50
spat93: folds
Uncalled bet ($12.50) returned to tekstilschik
tekstilschik collected $10 from pot
tekstilschik: doesn't show hand
*** SUMMARY ***
Total pot $10 | Rake $0
Seat 1: Rabarber77 (button) folded before Flop (didn't bet)
Seat 2: tekstilschik (small blind) collected ($10)
Seat 3: spat93 (big blind) folded before Flop


PokerStars Hand #222978962726:  Hold'em No Limit ($2.50/$5.00 USD) - 2021/01/23 19:02:01 ET
Table 'Aaltje II' 6-max Seat #2 is the button
Seat 1: Rabarber77 ($400 in chips)
Seat 2: tekstilschik ($219.35 in chips)
Seat 3: spat93 ($500 in chips)
Seat 4: 777Koresh777 ($500 in chips)
spat93: posts small blind $2.50
777Koresh777: posts big blind $5
CarlosW1973: sits out
*** HOLE CARDS ***
Rabarber77: folds
tekstilschik: raises $6.25 to $11.25
spat93: raises $23.75 to $35
777Koresh777: folds
tekstilschik: folds
Uncalled bet ($23.75) returned to spat93
spat93 collected $27.50 from pot
spat93: doesn't show hand
*** SUMMARY ***
Total pot $27.50 | Rake $0
Seat 1: Rabarber77 folded before Flop (didn't bet)
Seat 2: tekstilschik (button) folded before Flop
Seat 3: spat93 (small blind) collected ($27.50)
Seat 4: 777Koresh777 (big blind) folded before Flop


PokerStars Hand #222978984879:  Hold'em No Limit ($2.50/$5.00 USD) - 2021/01/23 19:02:39 ET
Table 'Aaltje II' 6-max Seat #3 is the button
Seat 1: Rabarber77 ($400 in chips)
Seat 2: tekstilschik ($208.10 in chips)
Seat 3: spat93 ($516.25 in chips)
Seat 4: 777Koresh777 ($500 in chips)
Seat 5: CarlosW1973 ($500 in chips)
777Koresh777: posts small blind $2.50
CarlosW1973: posts big blind $5
*** HOLE CARDS ***
Rabarber77: folds
tekstilschik: raises $7.50 to $12.50
spat93: raises $25 to $37.50
piscogay joins the table at seat #6
777Koresh777: folds
CarlosW1973: folds
tekstilschik: raises $170.60 to $208.10 and is all-in
spat93: folds
Uncalled bet ($170.60) returned to tekstilschik
tekstilschik collected $82.50 from pot
tekstilschik: doesn't show hand
*** SUMMARY ***
Total pot $82.50 | Rake $0
Seat 1: Rabarber77 folded before Flop (didn't bet)
Seat 2: tekstilschik collected ($82.50)
Seat 3: spat93 (button) folded before Flop
Seat 4: 777Koresh777 (small blind) folded before Flop
Seat 5: CarlosW1973 (big blind) folded before Flop


PokerStars Hand #222978998333:  Hold'em No Limit ($2.50/$5.00 USD) - 2021/01/23 19:03:03 ET
Table 'Aaltje II' 6-max Seat #4 is the button
Seat 1: Rabarber77 ($400 in chips)
Seat 2: tekstilschik ($253.10 in chips)
Seat 3: spat93 ($500 in chips)
Seat 4: 777Koresh777 ($500 in chips)
Seat 5: CarlosW1973 ($495 in chips)
Seat 6: piscogay ($500 in chips)
CarlosW1973: posts small blind $2.50
piscogay: posts big blind $5
*** HOLE CARDS ***
Rabarber77: folds
tekstilschik: folds
spat93: folds
777Koresh777: raises $7.20 to $12.20
CarlosW1973: calls $9.70
piscogay: folds
*** FLOP *** [Js 6h 2s]
CarlosW1973: checks
777Koresh777: bets $21.51
CarlosW1973: folds
Uncalled bet ($21.51) returned to 777Koresh777
777Koresh777 collected $27.93 from pot
777Koresh777: doesn't show hand
*** SUMMARY ***
Total pot $29.40 | Rake $1.47
Board [Js 6h 2s]
Seat 1: Rabarber77 folded before Flop (didn't bet)
Seat 2: tekstilschik folded before Flop (didn't bet)
Seat 3: spat93 folded before Flop (didn't bet)
Seat 4: 777Koresh777 (button) collected ($27.93)
Seat 5: CarlosW1973 (small blind) folded on the Flop
Seat 6: piscogay (big blind) folded before Flop


PokerStars Hand #222979026807:  Hold'em No Limit ($2.50/$5.00 USD) - 2021/01/23 19:03:52 ET
Table 'Aaltje II' 6-max Seat #5 is the button
Seat 1: Rabarber77 ($400 in chips)
Seat 2: tekstilschik ($253.10 in chips)
Seat 3: spat93 ($500 in chips)
Seat 4: 777Koresh777 ($515.73 in chips)
Seat 5: CarlosW1973 ($482.80 in chips)
Seat 6: piscogay ($500 in chips)
piscogay: posts small blind $2.50
Rabarber77: posts big blind $5
*** HOLE CARDS ***
tekstilschik: raises $12.50 to $17.50
spat93: folds
777Koresh777: folds
CarlosW1973: calls $17.50
piscogay: folds
Rabarber77: folds
*** FLOP *** [Ts 9c 8s]
tekstilschik: bets $32.50
CarlosW1973: calls $32.50
*** TURN *** [Ts 9c 8s] [Ah]
tekstilschik: bets $75.24
CarlosW1973: raises $254.98 to $330.22
tekstilschik: calls $127.86 and is all-in
Uncalled bet ($127.12) returned to CarlosW1973
CarlosW1973 has timed out
*** RIVER *** [Ts 9c 8s Ah] [4c]
*** SHOW DOWN ***
tekstilschik: shows [Js Qc] (a straight, Eight to Queen)
CarlosW1973: shows [Jc Ac] (a pair of Aces)
tekstilschik collected $510.70 from pot
*** SUMMARY ***
Total pot $513.70 | Rake $3
Board [Ts 9c 8s Ah 4c]
Seat 1: Rabarber77 (big blind) folded before Flop
Seat 2: tekstilschik showed [Js Qc] and won ($510.70) with a straight, Eight to Queen
Seat 3: spat93 folded before Flop (didn't bet)
Seat 4: 777Koresh777 folded before Flop (didn't bet)
Seat 5: CarlosW1973 (button) showed [Jc Ac] and lost with a pair of Aces
Seat 6: piscogay (small blind) folded before Flop


PokerStars Hand #222979071650:  Hold'em No Limit ($2.50/$5.00 USD) - 2021/01/23 19:04:57 ET
Table 'Aaltje II' 6-max Seat #6 is the button
Seat 1: Rabarber77 ($395 in chips)
Seat 3: spat93 ($500 in chips)
Seat 4: 777Koresh777 ($515.73 in chips)
Seat 5: CarlosW1973 ($229.70 in chips)
Seat 6: piscogay ($500 in chips)
Rabarber77: posts small blind $2.50
tekstilschik: is sitting out
spat93: posts big blind $5
*** HOLE CARDS ***
tekstilschik leaves the table
777Koresh777: folds
CarlosW1973: folds
piscogay: folds
Obbis01 joins the table at seat #2
Rabarber77: folds
Uncalled bet ($2.50) returned to spat93
spat93 collected $5 from pot
spat93: doesn't show hand
*** SUMMARY ***
Total pot $5 | Rake $0
Seat 1: Rabarber77 (small blind) folded before Flop
Seat 3: spat93 (big blind) collected ($5)
Seat 4: 777Koresh777 folded before Flop (didn't bet)
Seat 5: CarlosW1973 folded before Flop (didn't bet)
Seat 6: piscogay (button) folded before Flop (didn't bet)


PokerStars Hand #222979084459:  Hold'em No Limit ($2.50/$5.00 USD) - 2021/01/23 19:05:18 ET
Table 'Aaltje II' 6-max Seat #1 is the button
Seat 1: Rabarber77 ($392.50 in chips)
Seat 3: spat93 ($502.50 in chips)
Seat 4: 777Koresh777 ($515.73 in chips)
Seat 5: CarlosW1973 ($229.70 in chips)
Seat 6: piscogay ($500 in chips)
spat93: posts small blind $2.50
777Koresh777: posts big blind $5
*** HOLE CARDS ***
CarlosW1973: folds
piscogay: raises $7.50 to $12.50
Rabarber77: calls $12.50
spat93: folds
777Koresh777: calls $7.50
*** FLOP *** [Kh 2c Ad]
777Koresh777: checks
piscogay: bets $19
Rabarber77: folds
777Koresh777: folds
Uncalled bet ($19) returned to piscogay
piscogay collected $38 from pot
piscogay: doesn't show hand
*** SUMMARY ***
Total pot $40 | Rake $2
Board [Kh 2c Ad]
Seat 1: Rabarber77 (button) folded on the Flop
Seat 3: spat93 (small blind) folded before Flop
Seat 4: 777Koresh777 (big blind) folded on the Flop
Seat 5: CarlosW1973 folded before Flop (didn't bet)
Seat 6: piscogay collected ($38)


PokerStars Hand #222979113249:  Hold'em No Limit ($2.50/$5.00 USD) - 2021/01/23 19:06:09 ET
Table 'Aaltje II' 6-max Seat #3 is the button
Seat 1: Rabarber77 ($380 in chips)
Seat 3: spat93 ($500 in chips)
Seat 4: 777Koresh777 ($503.23 in chips)
Seat 5: CarlosW1973 ($229.70 in chips)
Seat 6: piscogay ($525.50 in chips)
777Koresh777: posts small blind $2.50
CarlosW1973: posts big blind $5
Obbis01: sits out
*** HOLE CARDS ***
piscogay: raises $7.50 to $12.50
Rabarber77: folds
spat93: raises $25 to $37.50
777Koresh777: folds
CarlosW1973: folds
piscogay: calls $25
*** FLOP *** [Ts 3s 4s]
piscogay: checks
spat93: bets $19.88
piscogay: folds
Uncalled bet ($19.88) returned to spat93
spat93 collected $79.50 from pot
spat93: doesn't show hand
*** SUMMARY ***
Total pot $82.50 | Rake $3
Board [Ts 3s 4s]
Seat 1: Rabarber77 folded before Flop (didn't bet)
Seat 3: spat93 (button) collected ($79.50)
Seat 4: 777Koresh777 (small blind) folded before Flop
Seat 5: CarlosW1973 (big blind) folded before Flop
Seat 6: piscogay folded on the Flop


PokerStars Hand #222979140558:  Hold'em No Limit ($2.50/$5.00 USD) - 2021/01/23 19:06:55 ET
Table 'Aaltje II' 6-max Seat #4 is the button
Seat 1: Rabarber77 ($380 in chips)
Seat 3: spat93 ($542 in chips)
Seat 4: 777Koresh777 ($500.73 in chips)
Seat 5: CarlosW1973 ($224.70 in chips)
Seat 6: piscogay ($500 in chips)
CarlosW1973: posts small blind $2.50
piscogay: posts big blind $5
Obbis01: sits out
*** HOLE CARDS ***
Rabarber77: folds
spat93: folds
777Koresh777: raises $10 to $15
CarlosW1973: folds
piscogay: calls $10
*** FLOP *** [7h 4c 9h]
piscogay: checks
777Koresh777: bets $20
piscogay: calls $20
*** TURN *** [7h 4c 9h] [Qs]
piscogay: checks
777Koresh777: bets $60
piscogay: folds
Uncalled bet ($60) returned to 777Koresh777
777Koresh777 collected $69.50 from pot
777Koresh777: doesn't show hand
*** SUMMARY ***
Total pot $72.50 | Rake $3
Board [7h 4c 9h Qs]
Seat 1: Rabarber77 folded before Flop (didn't bet)
Seat 3: spat93 folded before Flop (didn't bet)
Seat 4: 777Koresh777 (button) collected ($69.50)
Seat 5: CarlosW1973 (small blind) folded before Flop
Seat 6: piscogay (big blind) folded on the Turn


PokerStars Hand #222979176559:  Hold'em No Limit ($2.50/$5.00 USD) - 2021/01/23 19:07:42 ET
Table 'Aaltje II' 6-max Seat #5 is the button
Seat 1: Rabarber77 ($380 in chips)
Seat 3: spat93 ($542 in chips)
Seat 4: 777Koresh777 ($535.23 in chips)
Seat 5: CarlosW1973 ($222.20 in chips)
Seat 6: piscogay ($500 in chips)
piscogay: posts small blind $2.50
Rabarber77: posts big blind $5
Obbis01: sits out
*** HOLE CARDS ***
spat93: raises $6 to $11
777Koresh777: folds
CarlosW1973: folds
piscogay: folds
Rabarber77: folds
Uncalled bet ($6) returned to spat93
spat93 collected $12.50 from pot
spat93: doesn't show hand
*** SUMMARY ***
Total pot $12.50 | Rake $0
Seat 1: Rabarber77 (big blind) folded before Flop
Seat 3: spat93 collected ($12.50)
Seat 4: 777Koresh777 folded before Flop (didn't bet)
Seat 5: CarlosW1973 (button) folded before Flop (didn't bet)
Seat 6: piscogay (small blind) folded before Flop


PokerStars Hand #222979188384:  Hold'em No Limit ($2.50/$5.00 USD) - 2021/01/23 19:08:03 ET
Table 'Aaltje II' 6-max Seat #6 is the button
Seat 1: Rabarber77 ($375 in chips)
Seat 2: Obbis01 ($500 in chips)
Seat 3: spat93 ($549.50 in chips)
Seat 4: 777Koresh777 ($535.23 in chips)
Seat 5: CarlosW1973 ($222.20 in chips)
Seat 6: piscogay ($500 in chips)
Rabarber77: posts small blind $2.50
Obbis01: posts big blind $5
*** HOLE CARDS ***
spat93: folds
777Koresh777: folds
CarlosW1973: folds
piscogay: folds
Rabarber77: folds
Uncalled bet ($2.50) returned to Obbis01
Obbis01 collected $5 from pot
*** SUMMARY ***
Total pot $5 | Rake $0
Seat 1: Rabarber77 (small blind) folded before Flop
Seat 2: Obbis01 (big blind) collected ($5)
Seat 3: spat93 folded before Flop (didn't bet)
Seat 4: 777Koresh777 folded before Flop (didn't bet)
Seat 5: CarlosW1973 folded before Flop (didn't bet)
Seat 6: piscogay (button) folded before Flop (didn't bet)


PokerStars Hand #222979198365:  Hold'em No Limit ($2.50/$5.00 USD) - 2021/01/23 19:08:21 ET
Table 'Aaltje II' 6-max Seat #1 is the button
Seat 1: Rabarber77 ($372.50 in chips)
Seat 2: Obbis01 ($502.50 in chips)
Seat 3: spat93 ($549.50 in chips)
Seat 4: 777Koresh777 ($535.23 in chips)
Seat 5: CarlosW1973 ($222.20 in chips)
Seat 6: piscogay ($500 in chips)
Obbis01: posts small blind $2.50
spat93: posts big blind $5
*** HOLE CARDS ***
777Koresh777: folds
CarlosW1973: raises $5 to $10
777Koresh777 leaves the table
piscogay: folds
Rabarber77: calls $10
Obbis01: folds
spat93: calls $5
*** FLOP *** [Ah 8c 6c]
spat93: checks
CarlosW1973: bets $15
Rabarber77: folds
spat93: folds
Uncalled bet ($15) returned to CarlosW1973
CarlosW1973 collected $30.88 from pot
*** SUMMARY ***
Total pot $32.50 | Rake $1.62
Board [Ah 8c 6c]
Seat 1: Rabarber77 (button) folded on the Flop
Seat 2: Obbis01 (small blind) folded before Flop
Seat 3: spat93 (big blind) folded on the Flop
Seat 4: 777Koresh777 folded before Flop (didn't bet)
Seat 5: CarlosW1973 collected ($30.88)
Seat 6: piscogay folded before Flop (didn't bet)


PokerStars Hand #222979215906:  Hold'em No Limit ($2.50/$5.00 USD) - 2021/01/23 19:08:52 ET
Table 'Aaltje II' 6-max Seat #2 is the button
Seat 1: Rabarber77 ($362.50 in chips)
Seat 2: Obbis01 ($500 in chips)
Seat 3: spat93 ($539.50 in chips)
Seat 5: CarlosW1973 ($243.08 in chips)
Seat 6: piscogay ($500 in chips)
spat93: posts small blind $2.50
CarlosW1973: posts big blind $5
*** HOLE CARDS ***
piscogay: folds
Rabarber77: raises $7 to $12
jjisnoob joins the table at seat #4
Obbis01: folds
spat93: folds
CarlosW1973: calls $7
*** FLOP *** [8s Th Ks]
CarlosW1973: checks
Rabarber77: bets $12.59
CarlosW1973: folds
Uncalled bet ($12.59) returned to Rabarber77
Rabarber77 collected $25.18 from pot
Rabarber77: doesn't show hand
*** SUMMARY ***
Total pot $26.50 | Rake $1.32
Board [8s Th Ks]
Seat 1: Rabarber77 collected ($25.18)
Seat 2: Obbis01 (button) folded before Flop (didn't bet)
Seat 3: spat93 (small blind) folded before Flop
Seat 5: CarlosW1973 (big blind) folded on the Flop
Seat 6: piscogay folded before Flop (didn't bet)


PokerStars Hand #222979234517:  Hold'em No Limit ($2.50/$5.00 USD) - 2021/01/23 19:09:25 ET
Table 'Aaltje II' 6-max Seat #3 is the button
Seat 1: Rabarber77 ($375.68 in chips)
Seat 2: Obbis01 ($500 in chips)
Seat 3: spat93 ($537 in chips)
Seat 5: CarlosW1973 ($231.08 in chips)
Seat 6: piscogay ($500 in chips)
CarlosW1973: posts small blind $2.50
piscogay: posts big blind $5
*** HOLE CARDS ***
Rabarber77: folds
Obbis01: folds
spat93: raises $7.50 to $12.50
CarlosW1973: folds
piscogay: folds
Uncalled bet ($7.50) returned to spat93
spat93 collected $12.50 from pot
spat93: doesn't show hand
*** SUMMARY ***
Total pot $12.50 | Rake $0
Seat 1: Rabarber77 folded before Flop (didn't bet)
Seat 2: Obbis01 folded before Flop (didn't bet)
Seat 3: spat93 (button) collected ($12.50)
Seat 5: CarlosW1973 (small blind) folded before Flop
Seat 6: piscogay (big blind) folded before Flop


PokerStars Hand #222979247036:  Hold'em No Limit ($2.50/$5.00 USD) - 2021/01/23 19:09:47 ET
Table 'Aaltje II' 6-max Seat #5 is the button
Seat 1: Rabarber77 ($375.68 in chips)
Seat 2: Obbis01 ($500 in chips)
Seat 3: spat93 ($544.50 in chips)
Seat 5: CarlosW1973 ($228.58 in chips)
Seat 6: piscogay ($500 in chips)
piscogay: posts small blind $2.50
Rabarber77: posts big blind $5
jjisnoob: sits out
*** HOLE CARDS ***
Obbis01: folds
spat93: folds
CarlosW1973: raises $10 to $15
piscogay: folds
Rabarber77: folds
Uncalled bet ($10) returned to CarlosW1973
CarlosW1973 collected $12.50 from pot
*** SUMMARY ***
Total pot $12.50 | Rake $0
Seat 1: Rabarber77 (big blind) folded before Flop
Seat 2: Obbis01 folded before Flop (didn't bet)
Seat 3: spat93 folded before Flop (didn't bet)
Seat 5: CarlosW1973 (button) collected ($12.50)
Seat 6: piscogay (small blind) folded before Flop


PokerStars Hand #222979259608:  Hold'em No Limit ($2.50/$5.00 USD) - 2021/01/23 19:10:10 ET
Table 'Aaltje II' 6-max Seat #6 is the button
Seat 1: Rabarber77 ($370.68 in chips)
Seat 2: Obbis01 ($500 in chips)
Seat 3: spat93 ($544.50 in chips)
Seat 5: CarlosW1973 ($236.08 in chips)
Seat 6: piscogay ($500 in chips)
Rabarber77: posts small blind $2.50
Obbis01: posts big blind $5
jjisnoob: sits out
*** HOLE CARDS ***
spat93: folds
CarlosW1973: folds
piscogay: raises $7.50 to $12.50
Rabarber77: folds
Obbis01: folds
Uncalled bet ($7.50) returned to piscogay
piscogay collected $12.50 from pot
piscogay: doesn't show hand
*** SUMMARY ***
Total pot $12.50 | Rake $0
Seat 1: Rabarber77 (small blind) folded before Flop
Seat 2: Obbis01 (big blind) folded before Flop
Seat 3: spat93 folded before Flop (didn't bet)
Seat 5: CarlosW1973 folded before Flop (didn't bet)
Seat 6: piscogay (button) collected ($12.50)


PokerStars Hand #222979275113:  Hold'em No Limit ($2.50/$5.00 USD) - 2021/01/23 19:10:37 ET
Table 'Aaltje II' 6-max Seat #1 is the button
Seat 1: Rabarber77 ($368.18 in chips)
Seat 2: Obbis01 ($495 in chips)
Seat 3: spat93 ($544.50 in chips)
Seat 5: CarlosW1973 ($236.08 in chips)
Seat 6: piscogay ($507.50 in chips)
Obbis01: posts small blind $2.50
spat93: posts big blind $5
jjisnoob: sits out
*** HOLE CARDS ***
CarlosW1973: folds
piscogay: folds
Rabarber77: calls $5
Obbis01: folds
spat93: checks
*** FLOP *** [Js Jc 4h]
spat93: checks
Rabarber77: checks
*** TURN *** [Js Jc 4h] [9c]
spat93: checks
Rabarber77: checks
*** RIVER *** [Js Jc 4h 9c] [4s]
spat93: bets $5
Rabarber77: raises $21.88 to $26.88
spat93: folds
Uncalled bet ($21.88) returned to Rabarber77
Rabarber77 collected $21.38 from pot
Rabarber77: doesn't show hand
*** SUMMARY ***
Total pot $22.50 | Rake $1.12
Board [Js Jc 4h 9c 4s]
Seat 1: Rabarber77 (button) collected ($21.38)
Seat 2: Obbis01 (small blind) folded before Flop
Seat 3: spat93 (big blind) folded on the River
Seat 5: CarlosW1973 folded before Flop (didn't bet)
Seat 6: piscogay folded before Flop (didn't bet)


PokerStars Hand #222979311707:  Hold'em No Limit ($2.50/$5.00 USD) - 2021/01/23 19:11:42 ET
Table 'Aaltje II' 6-max Seat #2 is the button
Seat 1: Rabarber77 ($379.56 in chips)
Seat 2: Obbis01 ($492.50 in chips)
Seat 3: spat93 ($534.50 in chips)
Seat 4: jjisnoob ($500 in chips)
Seat 5: CarlosW1973 ($236.08 in chips)
Seat 6: piscogay ($507.50 in chips)
spat93: posts small blind $2.50
jjisnoob: posts big blind $5
*** HOLE CARDS ***
CarlosW1973: raises $5 to $10
piscogay: calls $10
Rabarber77: folds
Obbis01: folds
spat93: folds
jjisnoob: folds
*** FLOP *** [7d 2s Qh]
CarlosW1973: checks
piscogay: checks
*** TURN *** [7d 2s Qh] [5c]
CarlosW1973: bets $13.06
piscogay: folds
Uncalled bet ($13.06) returned to CarlosW1973
CarlosW1973 collected $26.12 from pot
*** SUMMARY ***
Total pot $27.50 | Rake $1.38
Board [7d 2s Qh 5c]
Seat 1: Rabarber77 folded before Flop (didn't bet)
Seat 2: Obbis01 (button) folded before Flop (didn't bet)
Seat 3: spat93 (small blind) folded before Flop
Seat 4: jjisnoob (big blind) folded before Flop
Seat 5: CarlosW1973 collected ($26.12)
Seat 6: piscogay folded on the Turn


PokerStars Hand #222979327459:  Hold'em No Limit ($2.50/$5.00 USD) - 2021/01/23 19:12:10 ET
Table 'Aaltje II' 6-max Seat #3 is the button
Seat 1: Rabarber77 ($379.56 in chips)
Seat 2: Obbis01 ($492.50 in chips)
Seat 3: spat93 ($532 in chips)
Seat 4: jjisnoob ($500 in chips)
Seat 5: CarlosW1973 ($252.20 in chips)
Seat 6: piscogay ($500 in chips)
jjisnoob: posts small blind $2.50
CarlosW1973: posts big blind $5
*** HOLE CARDS ***
piscogay: folds
Rabarber77: folds
Obbis01: calls $5
spat93: folds
jjisnoob: folds
CarlosW1973: raises $12.50 to $17.50
Obbis01: calls $12.50
*** FLOP *** [Qs 6h Ad]
CarlosW1973: bets $17.81
Obbis01: calls $17.81
*** TURN *** [Qs 6h Ad] [7s]
CarlosW1973: checks
Obbis01: checks
*** RIVER *** [Qs 6h Ad 7s] [8h]
CarlosW1973: bets $35.06
Obbis01: raises $154.94 to $190
CarlosW1973: calls $154.94
*** SHOW DOWN ***
Obbis01: shows [6s 6c] (three of a kind, Sixes)
CarlosW1973: mucks hand
Obbis01 collected $450.12 from pot
*** SUMMARY ***
Total pot $453.12 | Rake $3
Board [Qs 6h Ad 7s 8h]
Seat 1: Rabarber77 folded before Flop (didn't bet)
Seat 2: Obbis01 showed [6s 6c] and won ($450.12) with three of a kind, Sixes
Seat 3: spat93 (button) folded before Flop (didn't bet)
Seat 4: jjisnoob (small blind) folded before Flop
Seat 5: CarlosW1973 (big blind) mucked
Seat 6: piscogay folded before Flop (didn't bet)


PokerStars Hand #222979374647:  Hold'em No Limit ($2.50/$5.00 USD) - 2021/01/23 19:13:35 ET
Table 'Aaltje II' 6-max Seat #4 is the button
Seat 1: Rabarber77 ($379.56 in chips)
Seat 2: Obbis01 ($717.31 in chips)
Seat 3: spat93 ($532 in chips)
Seat 4: jjisnoob ($500 in chips)
Seat 5: CarlosW1973 ($26.89 in chips)
Seat 6: piscogay ($500 in chips)
CarlosW1973: posts small blind $2.50
piscogay: posts big blind $5
*** HOLE CARDS ***
Rabarber77: folds
Obbis01: raises $10 to $15
spat93: folds
jjisnoob: folds
CarlosW1973: raises $11.89 to $26.89 and is all-in
piscogay: folds
Obbis01: calls $11.89
*** FLOP *** [5d 7s 8c]
*** TURN *** [5d 7s 8c] [Jd]
*** RIVER *** [5d 7s 8c Jd] [Ts]
*** SHOW DOWN ***
CarlosW1973: shows [Ah Jh] (a pair of Jacks)
Obbis01: shows [As Ks] (high card Ace)
CarlosW1973 collected $55.84 from pot
*** SUMMARY ***
Total pot $58.78 | Rake $2.94
Board [5d 7s 8c Jd Ts]
Seat 1: Rabarber77 folded before Flop (didn't bet)
Seat 2: Obbis01 showed [As Ks] and lost with high card Ace
Seat 3: spat93 folded before Flop (didn't bet)
Seat 4: jjisnoob (button) folded before Flop (didn't bet)
Seat 5: CarlosW1973 (small blind) showed [Ah Jh] and won ($55.84) with a pair of Jacks
Seat 6: piscogay (big blind) folded before Flop


PokerStars Hand #222979392813:  Hold'em No Limit ($2.50/$5.00 USD) - 2021/01/23 19:14:08 ET
Table 'Aaltje II' 6-max Seat #5 is the button
Seat 1: Rabarber77 ($379.56 in chips)
Seat 2: Obbis01 ($690.42 in chips)
Seat 3: spat93 ($532 in chips)
Seat 4: jjisnoob ($500 in chips)
Seat 5: CarlosW1973 ($55.84 in chips)
Seat 6: piscogay ($500 in chips)
piscogay: posts small blind $2.50
Rabarber77: posts big blind $5
*** HOLE CARDS ***
Obbis01: folds
spat93: folds
jjisnoob: folds
CarlosW1973: raises $50.84 to $55.84 and is all-in
piscogay: folds
Rabarber77: folds
Uncalled bet ($50.84) returned to CarlosW1973
CarlosW1973 collected $12.50 from pot
*** SUMMARY ***
Total pot $12.50 | Rake $0
Seat 1: Rabarber77 (big blind) folded before Flop
Seat 2: Obbis01 folded before Flop (didn't bet)
Seat 3: spat93 folded before Flop (didn't bet)
Seat 4: jjisnoob folded before Flop (didn't bet)
Seat 5: CarlosW1973 (button) collected ($12.50)
Seat 6: piscogay (small blind) folded before Flop


PokerStars Hand #222979432324:  Hold'em No Limit ($2.50/$5.00 USD) - 2021/01/23 19:15:20 ET
Table 'Aaltje II' 6-max Seat #1 is the button
Seat 1: Rabarber77 ($394.91 in chips)
Seat 2: Obbis01 ($679.42 in chips)
Seat 3: spat93 ($521 in chips)
Seat 4: jjisnoob ($500 in chips)
Seat 5: CarlosW1973 ($63.34 in chips)
Seat 6: piscogay ($500 in chips)
Obbis01: posts small blind $2.50
spat93: posts big blind $5
*** HOLE CARDS ***
jjisnoob: folds
CarlosW1973: raises $5 to $10
piscogay: folds
Rabarber77: folds
Obbis01: folds
spat93: folds
Uncalled bet ($5) returned to CarlosW1973
CarlosW1973 collected $12.50 from pot
*** SUMMARY ***
Total pot $12.50 | Rake $0
Seat 1: Rabarber77 (button) folded before Flop (didn't bet)
Seat 2: Obbis01 (small blind) folded before Flop
Seat 3: spat93 (big blind) folded before Flop
Seat 4: jjisnoob folded before Flop (didn't bet)
Seat 5: CarlosW1973 collected ($12.50)
Seat 6: piscogay folded before Flop (didn't bet)


PokerStars Hand #222979446841:  Hold'em No Limit ($2.50/$5.00 USD) - 2021/01/23 19:15:46 ET
Table 'Aaltje II' 6-max Seat #2 is the button
Seat 1: Rabarber77 ($394.91 in chips)
Seat 2: Obbis01 ($676.92 in chips)
Seat 3: spat93 ($516 in chips)
Seat 4: jjisnoob ($500 in chips)
Seat 5: CarlosW1973 ($70.84 in chips)
Seat 6: piscogay ($500 in chips)
spat93: posts small blind $2.50
jjisnoob: posts big blind $5
*** HOLE CARDS ***
CarlosW1973: raises $65.84 to $70.84 and is all-in
piscogay: folds
Rabarber77: folds
Obbis01: folds
spat93: calls $68.34
jjisnoob: folds
*** FLOP *** [6h 3s 8c]
*** TURN *** [6h 3s 8c] [Qs]
*** RIVER *** [6h 3s 8c Qs] [8s]
*** SHOW DOWN ***
spat93: shows [Td Ac] (a pair of Eights)
CarlosW1973: shows [Qh 9h] (two pair, Queens and Eights)
CarlosW1973 collected $143.68 from pot
*** SUMMARY ***
Total pot $146.68 | Rake $3
Board [6h 3s 8c Qs 8s]
Seat 1: Rabarber77 folded before Flop (didn't bet)
Seat 2: Obbis01 (button) folded before Flop (didn't bet)
Seat 3: spat93 (small blind) showed [Td Ac] and lost with a pair of Eights
Seat 4: jjisnoob (big blind) folded before Flop
Seat 5: CarlosW1973 showed [Qh 9h] and won ($143.68) with two pair, Queens and Eights
Seat 6: piscogay folded before Flop (didn't bet)


PokerStars Hand #222979477535:  Hold'em No Limit ($2.50/$5.00 USD) - 2021/01/23 19:16:42 ET
Table 'Aaltje II' 6-max Seat #4 is the button
Seat 1: Rabarber77 ($394.91 in chips)
Seat 2: Obbis01 ($676.92 in chips)
Seat 3: spat93 ($500 in chips)
Seat 4: jjisnoob ($505 in chips)
Seat 5: CarlosW1973 ($138.68 in chips)
Seat 6: piscogay ($500 in chips)
CarlosW1973: posts small blind $2.50
piscogay: posts big blind $5
*** HOLE CARDS ***
Rabarber77: raises $10 to $15
Obbis01: folds
spat93: folds
jjisnoob: folds
CarlosW1973: calls $12.50
piscogay: folds
*** FLOP *** [Jh 5d 6s]
CarlosW1973: checks
Rabarber77: bets $20
CarlosW1973: folds
Uncalled bet ($20) returned to Rabarber77
Rabarber77 collected $33.25 from pot
Rabarber77: doesn't show hand
*** SUMMARY ***
Total pot $35 | Rake $1.75
Board [Jh 5d 6s]
Seat 1: Rabarber77 collected ($33.25)
Seat 2: Obbis01 folded before Flop (didn't bet)
Seat 3: spat93 folded before Flop (didn't bet)
Seat 4: jjisnoob (button) folded before Flop (didn't bet)
Seat 5: CarlosW1973 (small blind) folded on the Flop
Seat 6: piscogay (big blind) folded before Flop


PokerStars Hand #222979462549:  Hold'em No Limit ($2.50/$5.00 USD) - 2021/01/23 19:16:15 ET
Table 'Aaltje II' 6-max Seat #3 is the button
Seat 1: Rabarber77 ($394.91 in chips)
Seat 2: Obbis01 ($676.92 in chips)
Seat 3: spat93 ($500 in chips)
Seat 4: jjisnoob ($500 in chips)
Seat 5: CarlosW1973 ($143.68 in chips)
Seat 6: piscogay ($500 in chips)
jjisnoob: posts small blind $2.50
CarlosW1973: posts big blind $5
*** HOLE CARDS ***
piscogay: folds
Rabarber77: folds
Obbis01: folds
spat93: folds
jjisnoob: raises $11.50 to $16.50
CarlosW1973: folds
Uncalled bet ($11.50) returned to jjisnoob
jjisnoob collected $10 from pot
jjisnoob: doesn't show hand
*** SUMMARY ***
Total pot $10 | Rake $0
Seat 1: Rabarber77 folded before Flop (didn't bet)
Seat 2: Obbis01 folded before Flop (didn't bet)
Seat 3: spat93 (button) folded before Flop (didn't bet)
Seat 4: jjisnoob (small blind) collected ($10)
Seat 5: CarlosW1973 (big blind) folded before Flop
Seat 6: piscogay folded before Flop (didn't bet)


PokerStars Hand #222979503798:  Hold'em No Limit ($2.50/$5.00 USD) - 2021/01/23 19:17:30 ET
Table 'Aaltje II' 6-max Seat #5 is the button
Seat 1: Rabarber77 ($413.16 in chips)
Seat 2: Obbis01 ($676.92 in chips)
Seat 3: spat93 ($500 in chips)
Seat 4: jjisnoob ($505 in chips)
Seat 5: CarlosW1973 ($123.68 in chips)
Seat 6: piscogay ($500 in chips)
piscogay: posts small blind $2.50
Rabarber77: posts big blind $5
*** HOLE CARDS ***
Obbis01: folds
spat93: folds
jjisnoob: folds
CarlosW1973: raises $12.50 to $17.50
piscogay: folds
Rabarber77: folds
Uncalled bet ($12.50) returned to CarlosW1973
CarlosW1973 collected $12.50 from pot
*** SUMMARY ***
Total pot $12.50 | Rake $0
Seat 1: Rabarber77 (big blind) folded before Flop
Seat 2: Obbis01 folded before Flop (didn't bet)
Seat 3: spat93 folded before Flop (didn't bet)
Seat 4: jjisnoob folded before Flop (didn't bet)
Seat 5: CarlosW1973 (button) collected ($12.50)
Seat 6: piscogay (small blind) folded before Flop


PokerStars Hand #222979519534:  Hold'em No Limit ($2.50/$5.00 USD) - 2021/01/23 19:17:59 ET
Table 'Aaltje II' 6-max Seat #6 is the button
Seat 1: Rabarber77 ($408.16 in chips)
Seat 2: Obbis01 ($676.92 in chips)
Seat 3: spat93 ($500 in chips)
Seat 4: jjisnoob ($505 in chips)
Seat 5: CarlosW1973 ($131.18 in chips)
Seat 6: piscogay ($500 in chips)
Rabarber77: posts small blind $2.50
Obbis01: posts big blind $5
*** HOLE CARDS ***
spat93: folds
jjisnoob: folds
CarlosW1973: folds
piscogay has timed out
piscogay: folds
Rabarber77: raises $5.01 to $10.01
Obbis01: folds
Uncalled bet ($5.01) returned to Rabarber77
Rabarber77 collected $10 from pot
Rabarber77: doesn't show hand
*** SUMMARY ***
Total pot $10 | Rake $0
Seat 1: Rabarber77 (small blind) collected ($10)
Seat 2: Obbis01 (big blind) folded before Flop
Seat 3: spat93 folded before Flop (didn't bet)
Seat 4: jjisnoob folded before Flop (didn't bet)
Seat 5: CarlosW1973 folded before Flop (didn't bet)
Seat 6: piscogay (button) folded before Flop (didn't bet)


PokerStars Hand #222979536351:  Hold'em No Limit ($2.50/$5.00 USD) - 2021/01/23 19:18:30 ET
Table 'Aaltje II' 6-max Seat #1 is the button
Seat 1: Rabarber77 ($413.16 in chips)
Seat 2: Obbis01 ($671.92 in chips)
Seat 3: spat93 ($500 in chips)
Seat 4: jjisnoob ($505 in chips)
Seat 5: CarlosW1973 ($131.18 in chips)
Obbis01: posts small blind $2.50
spat93: posts big blind $5
*** HOLE CARDS ***
jjisnoob: folds
CarlosW1973: raises $12.50 to $17.50
Rabarber77: folds
Obbis01: folds
spat93: folds
Uncalled bet ($12.50) returned to CarlosW1973
CarlosW1973 collected $12.50 from pot
*** SUMMARY ***
Total pot $12.50 | Rake $0
Seat 1: Rabarber77 (button) folded before Flop (didn't bet)
Seat 2: Obbis01 (small blind) folded before Flop
Seat 3: spat93 (big blind) folded before Flop
Seat 4: jjisnoob folded before Flop (didn't bet)
Seat 5: CarlosW1973 collected ($12.50)


PokerStars Hand #222979550000:  Hold'em No Limit ($2.50/$5.00 USD) - 2021/01/23 19:18:55 ET
Table 'Aaltje II' 6-max Seat #2 is the button
Seat 1: Rabarber77 ($413.16 in chips)
Seat 2: Obbis01 ($669.42 in chips)
Seat 3: spat93 ($500 in chips)
Seat 4: jjisnoob ($505 in chips)
Seat 5: CarlosW1973 ($138.68 in chips)
spat93: posts small blind $2.50
jjisnoob: posts big blind $5
*** HOLE CARDS ***
CarlosW1973: raises $12.50 to $17.50
Rabarber77: folds
Obbis01: folds
spat93: folds
jjisnoob: folds
Uncalled bet ($12.50) returned to CarlosW1973
CarlosW1973 collected $12.50 from pot
*** SUMMARY ***
Total pot $12.50 | Rake $0
Seat 1: Rabarber77 folded before Flop (didn't bet)
Seat 2: Obbis01 (button) folded before Flop (didn't bet)
Seat 3: spat93 (small blind) folded before Flop
Seat 4: jjisnoob (big blind) folded before Flop
Seat 5: CarlosW1973 collected ($12.50)


PokerStars Hand #222979561592:  Hold'em No Limit ($2.50/$5.00 USD) - 2021/01/23 19:19:17 ET
Table 'Aaltje II' 6-max Seat #3 is the button
Seat 1: Rabarber77 ($413.16 in chips)
Seat 2: Obbis01 ($669.42 in chips)
Seat 3: spat93 ($500 in chips)
Seat 4: jjisnoob ($500 in chips)
Seat 5: CarlosW1973 ($146.18 in chips)
jjisnoob: posts small blind $2.50
CarlosW1973: posts big blind $5
*** HOLE CARDS ***
Rabarber77: folds
Obbis01: calls $5
spat93: folds
jjisnoob: raises $22.50 to $27.50
CarlosW1973: folds
Obbis01: calls $22.50
*** FLOP *** [8h Td Qs]
jjisnoob: bets $15.96
Obbis01: calls $15.96
*** TURN *** [8h Td Qs] [4h]
jjisnoob: bets $70.25
Obbis01: calls $70.25
*** RIVER *** [8h Td Qs 4h] [Jc]
jjisnoob: checks
Obbis01: bets $150
jjisnoob: folds
Uncalled bet ($150) returned to Obbis01
Obbis01 collected $229.42 from pot
*** SUMMARY ***
Total pot $232.42 | Rake $3
Board [8h Td Qs 4h Jc]
Seat 1: Rabarber77 folded before Flop (didn't bet)
Seat 2: Obbis01 collected ($229.42)
Seat 3: spat93 (button) folded before Flop (didn't bet)
Seat 4: jjisnoob (small blind) folded on the River
Seat 5: CarlosW1973 (big blind) folded before Flop


PokerStars Hand #222979611511:  Hold'em No Limit ($2.50/$5.00 USD) - 2021/01/23 19:20:50 ET
Table 'Aaltje II' 6-max Seat #4 is the button
Seat 1: Rabarber77 ($413.16 in chips)
Seat 2: Obbis01 ($785.13 in chips)
Seat 3: spat93 ($500 in chips)
Seat 4: jjisnoob ($500 in chips)
Seat 5: CarlosW1973 ($141.18 in chips)
Seat 6: piscogay ($500 in chips)
CarlosW1973: posts small blind $2.50
piscogay: posts big blind $5
*** HOLE CARDS ***
Rabarber77: folds
Obbis01: folds
spat93: raises $7.50 to $12.50
jjisnoob: folds
CarlosW1973: calls $10
piscogay: calls $7.50
*** FLOP *** [6d Ks Js]
CarlosW1973: checks
piscogay: bets $23.75
spat93: calls $23.75
CarlosW1973: raises $104.93 to $128.68 and is all-in
piscogay: raises $104.93 to $233.61
spat93: raises $253.89 to $487.50 and is all-in
piscogay: calls $253.89 and is all-in
CarlosW1973 has timed out
*** TURN *** [6d Ks Js] [Qh]
*** RIVER *** [6d Ks Js Qh] [2c]
*** SHOW DOWN ***
piscogay: shows [Kh 6h] (two pair, Kings and Sixes)
spat93: shows [Qs Ts] (a pair of Queens)
piscogay collected $717.64 from side pot
CarlosW1973: shows [5s 6s] (a pair of Sixes)
piscogay collected $420.54 from main pot
*** SUMMARY ***
Total pot $1141.18 Main pot $420.54. Side pot $717.64. | Rake $3
Board [6d Ks Js Qh 2c]
Seat 1: Rabarber77 folded before Flop (didn't bet)
Seat 2: Obbis01 folded before Flop (didn't bet)
Seat 3: spat93 showed [Qs Ts] and lost with a pair of Queens
Seat 4: jjisnoob (button) folded before Flop (didn't bet)
Seat 5: CarlosW1973 (small blind) showed [5s 6s] and lost with a pair of Sixes
Seat 6: piscogay (big blind) showed [Kh 6h] and won ($1138.18) with two pair, Kings and Sixes


PokerStars Hand #222979646995:  Hold'em No Limit ($2.50/$5.00 USD) - 2021/01/23 19:21:57 ET
Table 'Aaltje II' 6-max Seat #6 is the button
Seat 1: Rabarber77 ($413.16 in chips)
Seat 2: Obbis01 ($785.13 in chips)
Seat 3: spat93 ($500 in chips)
Seat 4: jjisnoob ($500 in chips)
Seat 6: piscogay ($1138.18 in chips)
Rabarber77: posts small blind $2.50
Obbis01: posts big blind $5
*** HOLE CARDS ***
spat93: folds
jjisnoob: raises $6.25 to $11.25
CarlosW1973 leaves the table
piscogay: folds
sacachispa19 joins the table at seat #5
Rabarber77: calls $8.75
Obbis01: folds
*** FLOP *** [4h Ts 5s]
Rabarber77: checks
jjisnoob: bets $7.31
Rabarber77: calls $7.31
*** TURN *** [4h Ts 5s] [Tc]
Rabarber77: checks
jjisnoob: checks
*** RIVER *** [4h Ts 5s Tc] [7h]
Rabarber77: bets $20.01
jjisnoob: calls $20.01
*** SHOW DOWN ***
Rabarber77: shows [Ah 5d] (two pair, Tens and Fives)
jjisnoob: shows [6d 6s] (two pair, Tens and Sixes)
jjisnoob collected $79.14 from pot
*** SUMMARY ***
Total pot $82.14 | Rake $3
Board [4h Ts 5s Tc 7h]
Seat 1: Rabarber77 (small blind) showed [Ah 5d] and lost with two pair, Tens and Fives
Seat 2: Obbis01 (big blind) folded before Flop
Seat 3: spat93 folded before Flop (didn't bet)
Seat 4: jjisnoob showed [6d 6s] and won ($79.14) with two pair, Tens and Sixes
Seat 6: piscogay (button) folded before Flop (didn't bet)


PokerStars Hand #222979690088:  Hold'em No Limit ($2.50/$5.00 USD) - 2021/01/23 19:23:18 ET
Table 'Aaltje II' 6-max Seat #1 is the button
Seat 1: Rabarber77 ($374.59 in chips)
Seat 2: Obbis01 ($780.13 in chips)
Seat 3: spat93 ($500 in chips)
Seat 4: jjisnoob ($540.57 in chips)
Seat 6: piscogay ($1138.18 in chips)
Obbis01: posts small blind $2.50
spat93: posts big blind $5
sacachispa19: sits out
*** HOLE CARDS ***
jjisnoob: folds
piscogay: folds
Rabarber77: raises $7 to $12
Obbis01: folds
spat93: folds
Uncalled bet ($7) returned to Rabarber77
Rabarber77 collected $12.50 from pot
Rabarber77: doesn't show hand
*** SUMMARY ***
Total pot $12.50 | Rake $0
Seat 1: Rabarber77 (button) collected ($12.50)
Seat 2: Obbis01 (small blind) folded before Flop
Seat 3: spat93 (big blind) folded before Flop
Seat 4: jjisnoob folded before Flop (didn't bet)
Seat 6: piscogay folded before Flop (didn't bet)


PokerStars Hand #222979709396:  Hold'em No Limit ($2.50/$5.00 USD) - 2021/01/23 19:23:54 ET
Table 'Aaltje II' 6-max Seat #2 is the button
Seat 1: Rabarber77 ($382.09 in chips)
Seat 2: Obbis01 ($777.63 in chips)
Seat 3: spat93 ($500 in chips)
Seat 4: jjisnoob ($540.57 in chips)
Seat 6: piscogay ($1138.18 in chips)
spat93: posts small blind $2.50
jjisnoob: posts big blind $5
sacachispa19: sits out
*** HOLE CARDS ***
piscogay: folds
Rabarber77: folds
Obbis01: folds
spat93: raises $10 to $15
jjisnoob: calls $10
*** FLOP *** [Kh 8h 3c]
spat93: bets $9.50
jjisnoob: folds
Uncalled bet ($9.50) returned to spat93
spat93 collected $28.50 from pot
spat93: doesn't show hand
*** SUMMARY ***
Total pot $30 | Rake $1.50
Board [Kh 8h 3c]
Seat 1: Rabarber77 folded before Flop (didn't bet)
Seat 2: Obbis01 (button) folded before Flop (didn't bet)
Seat 3: spat93 (small blind) collected ($28.50)
Seat 4: jjisnoob (big blind) folded on the Flop
Seat 6: piscogay folded before Flop (didn't bet)


PokerStars Hand #222979734027:  Hold'em No Limit ($2.50/$5.00 USD) - 2021/01/23 19:24:41 ET
Table 'Aaltje II' 6-max Seat #3 is the button
Seat 1: Rabarber77 ($382.09 in chips)
Seat 2: Obbis01 ($777.63 in chips)
Seat 3: spat93 ($513.50 in chips)
Seat 4: jjisnoob ($525.57 in chips)
Seat 5: sacachispa19 ($500 in chips)
Seat 6: piscogay ($1138.18 in chips)
jjisnoob: posts small blind $2.50
sacachispa19: posts big blind $5
*** HOLE CARDS ***
piscogay: folds
Rabarber77: folds
Obbis01: folds
spat93: raises $7.50 to $12.50
jjisnoob: folds
sacachispa19: calls $7.50
*** FLOP *** [9d Kc Td]
sacachispa19: checks
spat93: bets $8.70
sacachispa19: folds
Uncalled bet ($8.70) returned to spat93
spat93 collected $26.12 from pot
spat93: doesn't show hand
*** SUMMARY ***
Total pot $27.50 | Rake $1.38
Board [9d Kc Td]
Seat 1: Rabarber77 folded before Flop (didn't bet)
Seat 2: Obbis01 folded before Flop (didn't bet)
Seat 3: spat93 (button) collected ($26.12)
Seat 4: jjisnoob (small blind) folded before Flop
Seat 5: sacachispa19 (big blind) folded on the Flop
Seat 6: piscogay folded before Flop (didn't bet)


PokerStars Hand #222979753584:  Hold'em No Limit ($2.50/$5.00 USD) - 2021/01/23 19:25:18 ET
Table 'Aaltje II' 6-max Seat #4 is the button
Seat 1: Rabarber77 ($382.09 in chips)
Seat 2: Obbis01 ($777.63 in chips)
Seat 3: spat93 ($527.12 in chips)
Seat 4: jjisnoob ($523.07 in chips)
Seat 5: sacachispa19 ($500 in chips)
Seat 6: piscogay ($1138.18 in chips)
sacachispa19: posts small blind $2.50
piscogay: posts big blind $5
*** HOLE CARDS ***
Rabarber77: folds
Obbis01: folds
spat93: raises $7.50 to $12.50
jjisnoob: folds
sacachispa19: folds
piscogay: calls $7.50
*** FLOP *** [5h 3s Qs]
piscogay: checks
spat93: bets $17.41
piscogay: folds
Uncalled bet ($17.41) returned to spat93
spat93 collected $26.12 from pot
spat93: doesn't show hand
*** SUMMARY ***
Total pot $27.50 | Rake $1.38
Board [5h 3s Qs]
Seat 1: Rabarber77 folded before Flop (didn't bet)
Seat 2: Obbis01 folded before Flop (didn't bet)
Seat 3: spat93 collected ($26.12)
Seat 4: jjisnoob (button) folded before Flop (didn't bet)
Seat 5: sacachispa19 (small blind) folded before Flop
Seat 6: piscogay (big blind) folded on the Flop


PokerStars Hand #222979770838:  Hold'em No Limit ($2.50/$5.00 USD) - 2021/01/23 19:25:50 ET
Table 'Aaltje II' 6-max Seat #5 is the button
Seat 1: Rabarber77 ($382.09 in chips)
Seat 2: Obbis01 ($777.63 in chips)
Seat 3: spat93 ($540.74 in chips)
Seat 4: jjisnoob ($523.07 in chips)
Seat 5: sacachispa19 ($500 in chips)
Seat 6: piscogay ($1125.68 in chips)
piscogay: posts small blind $2.50
Rabarber77: posts big blind $5
*** HOLE CARDS ***
Obbis01: folds
spat93: folds
jjisnoob: folds
sacachispa19: folds
piscogay: folds
Uncalled bet ($2.50) returned to Rabarber77
Rabarber77 collected $5 from pot
Rabarber77: doesn't show hand
*** SUMMARY ***
Total pot $5 | Rake $0
Seat 1: Rabarber77 (big blind) collected ($5)
Seat 2: Obbis01 folded before Flop (didn't bet)
Seat 3: spat93 folded before Flop (didn't bet)
Seat 4: jjisnoob folded before Flop (didn't bet)
Seat 5: sacachispa19 (button) folded before Flop (didn't bet)
Seat 6: piscogay (small blind) folded before Flop


PokerStars Hand #222979776389:  Hold'em No Limit ($2.50/$5.00 USD) - 2021/01/23 19:26:01 ET
Table 'Aaltje II' 6-max Seat #6 is the button
Seat 1: Rabarber77 ($384.59 in chips)
Seat 2: Obbis01 ($777.63 in chips)
Seat 3: spat93 ($540.74 in chips)
Seat 4: jjisnoob ($523.07 in chips)
Seat 5: sacachispa19 ($500 in chips)
Seat 6: piscogay ($1123.18 in chips)
Rabarber77: posts small blind $2.50
Obbis01: posts big blind $5
*** HOLE CARDS ***
spat93: raises $6 to $11
jjisnoob: folds
sacachispa19: folds
piscogay: folds
Rabarber77: folds
Obbis01: folds
Uncalled bet ($6) returned to spat93
spat93 collected $12.50 from pot
spat93: doesn't show hand
*** SUMMARY ***
Total pot $12.50 | Rake $0
Seat 1: Rabarber77 (small blind) folded before Flop
Seat 2: Obbis01 (big blind) folded before Flop
Seat 3: spat93 collected ($12.50)
Seat 4: jjisnoob folded before Flop (didn't bet)
Seat 5: sacachispa19 folded before Flop (didn't bet)
Seat 6: piscogay (button) folded before Flop (didn't bet)


PokerStars Hand #222979793070:  Hold'em No Limit ($2.50/$5.00 USD) - 2021/01/23 19:26:33 ET
Table 'Aaltje II' 6-max Seat #1 is the button
Seat 1: Rabarber77 ($382.09 in chips)
Seat 2: Obbis01 ($772.63 in chips)
Seat 3: spat93 ($548.24 in chips)
Seat 4: jjisnoob ($523.07 in chips)
Seat 5: sacachispa19 ($500 in chips)
Seat 6: piscogay ($1123.18 in chips)
Obbis01: posts small blind $2.50
spat93: posts big blind $5
*** HOLE CARDS ***
jjisnoob: folds
sacachispa19: folds
piscogay: folds
Rabarber77: raises $5 to $10
Obbis01: calls $7.50
spat93: folds
*** FLOP *** [7c 4d 7h]
Obbis01: checks
Rabarber77: bets $11.88
Obbis01: calls $11.88
*** TURN *** [7c 4d 7h] [8c]
Obbis01: checks
Rabarber77: bets $23.16
Obbis01: calls $23.16
*** RIVER *** [7c 4d 7h 8c] [Th]
Obbis01: checks
Rabarber77: bets $60
Obbis01: raises $100 to $160
Rabarber77: calls $100
*** SHOW DOWN ***
Obbis01: shows [3d 7d] (three of a kind, Sevens)
Rabarber77: mucks hand
Obbis01 collected $412.08 from pot
*** SUMMARY ***
Total pot $415.08 | Rake $3
Board [7c 4d 7h 8c Th]
Seat 1: Rabarber77 (button) mucked
Seat 2: Obbis01 (small blind) showed [3d 7d] and won ($412.08) with three of a kind, Sevens
Seat 3: spat93 (big blind) folded before Flop
Seat 4: jjisnoob folded before Flop (didn't bet)
Seat 5: sacachispa19 folded before Flop (didn't bet)
Seat 6: piscogay folded before Flop (didn't bet)


PokerStars Hand #222979840270:  Hold'em No Limit ($2.50/$5.00 USD) - 2021/01/23 19:27:57 ET
Table 'Aaltje II' 6-max Seat #2 is the button
Seat 1: Rabarber77 ($177.05 in chips)
Seat 2: Obbis01 ($979.67 in chips)
Seat 3: spat93 ($543.24 in chips)
Seat 4: jjisnoob ($523.07 in chips)
Seat 5: sacachispa19 ($500 in chips)
Seat 6: piscogay ($1123.18 in chips)
spat93: posts small blind $2.50
jjisnoob: posts big blind $5
*** HOLE CARDS ***
sacachispa19: folds
piscogay: folds
Rabarber77: folds
Obbis01: folds
spat93: raises $10 to $15
jjisnoob: folds
Uncalled bet ($10) returned to spat93
spat93 collected $10 from pot
spat93: doesn't show hand
*** SUMMARY ***
Total pot $10 | Rake $0
Seat 1: Rabarber77 folded before Flop (didn't bet)
Seat 2: Obbis01 (button) folded before Flop (didn't bet)
Seat 3: spat93 (small blind) collected ($10)
Seat 4: jjisnoob (big blind) folded before Flop
Seat 5: sacachispa19 folded before Flop (didn't bet)
Seat 6: piscogay folded before Flop (didn't bet)


PokerStars Hand #222979852642:  Hold'em No Limit ($2.50/$5.00 USD) - 2021/01/23 19:28:21 ET
Table 'Aaltje II' 6-max Seat #3 is the button
Seat 1: Rabarber77 ($177.05 in chips)
Seat 2: Obbis01 ($979.67 in chips)
Seat 3: spat93 ($548.24 in chips)
Seat 4: jjisnoob ($518.07 in chips)
Seat 5: sacachispa19 ($500 in chips)
Seat 6: piscogay ($1123.18 in chips)
jjisnoob: posts small blind $2.50
sacachispa19: posts big blind $5
*** HOLE CARDS ***
piscogay: raises $10 to $15
Rabarber77: folds
Obbis01: folds
spat93: folds
jjisnoob: folds
sacachispa19: folds
Uncalled bet ($10) returned to piscogay
piscogay collected $12.50 from pot
piscogay: doesn't show hand
*** SUMMARY ***
Total pot $12.50 | Rake $0
Seat 1: Rabarber77 folded before Flop (didn't bet)
Seat 2: Obbis01 folded before Flop (didn't bet)
Seat 3: spat93 (button) folded before Flop (didn't bet)
Seat 4: jjisnoob (small blind) folded before Flop
Seat 5: sacachispa19 (big blind) folded before Flop
Seat 6: piscogay collected ($12.50)


PokerStars Hand #222979864561:  Hold'em No Limit ($2.50/$5.00 USD) - 2021/01/23 19:28:44 ET
Table 'Aaltje II' 6-max Seat #4 is the button
Seat 1: Rabarber77 ($177.05 in chips)
Seat 2: Obbis01 ($979.67 in chips)
Seat 3: spat93 ($548.24 in chips)
Seat 4: jjisnoob ($515.57 in chips)
Seat 5: sacachispa19 ($500 in chips)
Seat 6: piscogay ($1130.68 in chips)
sacachispa19: posts small blind $2.50
piscogay: posts big blind $5
*** HOLE CARDS ***
Rabarber77: folds
Obbis01: raises $10 to $15
spat93: folds
jjisnoob: folds
sacachispa19: folds
piscogay: folds
Uncalled bet ($10) returned to Obbis01
Obbis01 collected $12.50 from pot
*** SUMMARY ***
Total pot $12.50 | Rake $0
Seat 1: Rabarber77 folded before Flop (didn't bet)
Seat 2: Obbis01 collected ($12.50)
Seat 3: spat93 folded before Flop (didn't bet)
Seat 4: jjisnoob (button) folded before Flop (didn't bet)
Seat 5: sacachispa19 (small blind) folded before Flop
Seat 6: piscogay (big blind) folded before Flop


PokerStars Hand #222979875580:  Hold'em No Limit ($2.50/$5.00 USD) - 2021/01/23 19:29:05 ET
Table 'Aaltje II' 6-max Seat #5 is the button
Seat 1: Rabarber77 ($177.05 in chips)
Seat 2: Obbis01 ($987.17 in chips)
Seat 3: spat93 ($548.24 in chips)
Seat 4: jjisnoob ($515.57 in chips)
Seat 5: sacachispa19 ($500 in chips)
Seat 6: piscogay ($1125.68 in chips)
piscogay: posts small blind $2.50
Rabarber77: posts big blind $5
*** HOLE CARDS ***
Obbis01: calls $5
spat93: folds
jjisnoob: folds
sacachispa19: folds
piscogay: folds
Rabarber77: checks
*** FLOP *** [7d Td 8c]
Rabarber77: checks
Obbis01: bets $11.88
Rabarber77: folds
Uncalled bet ($11.88) returned to Obbis01
Obbis01 collected $11.88 from pot
*** SUMMARY ***
Total pot $12.50 | Rake $0.62
Board [7d Td 8c]
Seat 1: Rabarber77 (big blind) folded on the Flop
Seat 2: Obbis01 collected ($11.88)
Seat 3: spat93 folded before Flop (didn't bet)
Seat 4: jjisnoob folded before Flop (didn't bet)
Seat 5: sacachispa19 (button) folded before Flop (didn't bet)
Seat 6: piscogay (small blind) folded before Flop


PokerStars Hand #222979888599:  Hold'em No Limit ($2.50/$5.00 USD) - 2021/01/23 19:29:30 ET
Table 'Aaltje II' 6-max Seat #6 is the button
Seat 1: Rabarber77 ($172.05 in chips)
Seat 2: Obbis01 ($994.05 in chips)
Seat 3: spat93 ($548.24 in chips)
Seat 4: jjisnoob ($515.57 in chips)
Seat 5: sacachispa19 ($500 in chips)
Seat 6: piscogay ($1123.18 in chips)
Rabarber77: posts small blind $2.50
Obbis01: posts big blind $5
*** HOLE CARDS ***
spat93: folds
jjisnoob: folds
sacachispa19: folds
piscogay: folds
Rabarber77: raises $10 to $15
Obbis01: folds
Uncalled bet ($10) returned to Rabarber77
Rabarber77 collected $10 from pot
Rabarber77: doesn't show hand
*** SUMMARY ***
Total pot $10 | Rake $0
Seat 1: Rabarber77 (small blind) collected ($10)
Seat 2: Obbis01 (big blind) folded before Flop
Seat 3: spat93 folded before Flop (didn't bet)
Seat 4: jjisnoob folded before Flop (didn't bet)
Seat 5: sacachispa19 folded before Flop (didn't bet)
Seat 6: piscogay (button) folded before Flop (didn't bet)


PokerStars Hand #222979895454:  Hold'em No Limit ($2.50/$5.00 USD) - 2021/01/23 19:29:43 ET
Table 'Aaltje II' 6-max Seat #1 is the button
Seat 1: Rabarber77 ($177.05 in chips)
Seat 2: Obbis01 ($989.05 in chips)
Seat 3: spat93 ($548.24 in chips)
Seat 4: jjisnoob ($515.57 in chips)
Seat 5: sacachispa19 ($500 in chips)
Seat 6: piscogay ($1123.18 in chips)
Obbis01: posts small blind $2.50
spat93: posts big blind $5
*** HOLE CARDS ***
jjisnoob: folds
sacachispa19: folds
piscogay: folds
Rabarber77: raises $5.01 to $10.01
Obbis01: folds
spat93: calls $5.01
*** FLOP *** [Ad 6h 9d]
spat93: checks
Rabarber77: bets $10.70
spat93: calls $10.70
*** TURN *** [Ad 6h 9d] [2h]
spat93: checks
Rabarber77: bets $25
spat93: calls $25
*** RIVER *** [Ad 6h 9d 2h] [8c]
spat93: checks
Rabarber77: checks
*** SHOW DOWN ***
spat93: shows [Qd 6d] (a pair of Sixes)
Rabarber77: mucks hand
spat93 collected $90.92 from pot
*** SUMMARY ***
Total pot $93.92 | Rake $3
Board [Ad 6h 9d 2h 8c]
Seat 1: Rabarber77 (button) mucked
Seat 2: Obbis01 (small blind) folded before Flop
Seat 3: spat93 (big blind) showed [Qd 6d] and won ($90.92) with a pair of Sixes
Seat 4: jjisnoob folded before Flop (didn't bet)
Seat 5: sacachispa19 folded before Flop (didn't bet)
Seat 6: piscogay folded before Flop (didn't bet)


PokerStars Hand #222979930387:  Hold'em No Limit ($2.50/$5.00 USD) - 2021/01/23 19:30:50 ET
Table 'Aaltje II' 6-max Seat #2 is the button
Seat 1: Rabarber77 ($131.34 in chips)
Seat 2: Obbis01 ($986.55 in chips)
Seat 3: spat93 ($593.45 in chips)
Seat 4: jjisnoob ($515.57 in chips)
Seat 5: sacachispa19 ($500 in chips)
Seat 6: piscogay ($1123.18 in chips)
spat93: posts small blind $2.50
jjisnoob: posts big blind $5
*** HOLE CARDS ***
sacachispa19: folds
piscogay: raises $10 to $15
Rabarber77: calls $15
Obbis01: folds
spat93: folds
jjisnoob: calls $10
*** FLOP *** [2d Qs 2h]
jjisnoob: checks
piscogay: checks
Rabarber77: bets $30
jjisnoob: folds
piscogay: folds
Uncalled bet ($30) returned to Rabarber77
Rabarber77 collected $45.12 from pot
Rabarber77: doesn't show hand
*** SUMMARY ***
Total pot $47.50 | Rake $2.38
Board [2d Qs 2h]
Seat 1: Rabarber77 collected ($45.12)
Seat 2: Obbis01 (button) folded before Flop (didn't bet)
Seat 3: spat93 (small blind) folded before Flop
Seat 4: jjisnoob (big blind) folded on the Flop
Seat 5: sacachispa19 folded before Flop (didn't bet)
Seat 6: piscogay folded on the Flop


PokerStars Hand #222979962399:  Hold'em No Limit ($2.50/$5.00 USD) - 2021/01/23 19:31:52 ET
Table 'Aaltje II' 6-max Seat #3 is the button
Seat 1: Rabarber77 ($161.46 in chips)
Seat 2: Obbis01 ($986.55 in chips)
Seat 3: spat93 ($590.95 in chips)
Seat 4: jjisnoob ($500.57 in chips)
Seat 5: sacachispa19 ($500 in chips)
Seat 6: piscogay ($1108.18 in chips)
jjisnoob: posts small blind $2.50
sacachispa19: posts big blind $5
*** HOLE CARDS ***
piscogay: folds
Rabarber77: raises $7 to $12
Obbis01: folds
spat93: folds
jjisnoob: folds
sacachispa19: calls $7
*** FLOP *** [6s 6d Js]
sacachispa19: checks
Rabarber77: bets $15
sacachispa19: folds
Uncalled bet ($15) returned to Rabarber77
Rabarber77 collected $25.18 from pot
Rabarber77: doesn't show hand
*** SUMMARY ***
Total pot $26.50 | Rake $1.32
Board [6s 6d Js]
Seat 1: Rabarber77 collected ($25.18)
Seat 2: Obbis01 folded before Flop (didn't bet)
Seat 3: spat93 (button) folded before Flop (didn't bet)
Seat 4: jjisnoob (small blind) folded before Flop
Seat 5: sacachispa19 (big blind) folded on the Flop
Seat 6: piscogay folded before Flop (didn't bet)


PokerStars Hand #222979993562:  Hold'em No Limit ($2.50/$5.00 USD) - 2021/01/23 19:32:37 ET
Table 'Aaltje II' 6-max Seat #4 is the button
Seat 1: Rabarber77 ($174.64 in chips)
Seat 2: Obbis01 ($986.55 in chips)
Seat 3: spat93 ($590.95 in chips)
Seat 4: jjisnoob ($500 in chips)
Seat 5: sacachispa19 ($500 in chips)
Seat 6: piscogay ($1108.18 in chips)
sacachispa19: posts small blind $2.50
piscogay: posts big blind $5
*** HOLE CARDS ***
Rabarber77: folds
Obbis01 has timed out
Obbis01: folds
spat93: folds
jjisnoob: raises $6.25 to $11.25
sacachispa19: folds
piscogay: folds
Uncalled bet ($6.25) returned to jjisnoob
jjisnoob collected $12.50 from pot
jjisnoob: doesn't show hand
*** SUMMARY ***
Total pot $12.50 | Rake $0
Seat 1: Rabarber77 folded before Flop (didn't bet)
Seat 2: Obbis01 folded before Flop (didn't bet)
Seat 3: spat93 folded before Flop (didn't bet)
Seat 4: jjisnoob (button) collected ($12.50)
Seat 5: sacachispa19 (small blind) folded before Flop
Seat 6: piscogay (big blind) folded before Flop


PokerStars Hand #222980007476:  Hold'em No Limit ($2.50/$5.00 USD) - 2021/01/23 19:33:04 ET
Table 'Aaltje II' 6-max Seat #5 is the button
Seat 1: Rabarber77 ($174.64 in chips)
Seat 2: Obbis01 ($986.55 in chips)
Seat 3: spat93 ($590.95 in chips)
Seat 4: jjisnoob ($507.50 in chips)
Seat 5: sacachispa19 ($500 in chips)
Seat 6: piscogay ($1103.18 in chips)
piscogay: posts small blind $2.50
Rabarber77: posts big blind $5
*** HOLE CARDS ***
Obbis01: folds
spat93: folds
jjisnoob: folds
sacachispa19: folds
piscogay: raises $5 to $10
Rabarber77: calls $5
*** FLOP *** [Ks Tc Jc]
piscogay: checks
Rabarber77: checks
*** TURN *** [Ks Tc Jc] [Kc]
piscogay: bets $52.50
Rabarber77: folds
Uncalled bet ($52.50) returned to piscogay
piscogay collected $19 from pot
piscogay: doesn't show hand
*** SUMMARY ***
Total pot $20 | Rake $1
Board [Ks Tc Jc Kc]
Seat 1: Rabarber77 (big blind) folded on the Turn
Seat 2: Obbis01 folded before Flop (didn't bet)
Seat 3: spat93 folded before Flop (didn't bet)
Seat 4: jjisnoob folded before Flop (didn't bet)
Seat 5: sacachispa19 (button) folded before Flop (didn't bet)
Seat 6: piscogay (small blind) collected ($19)


PokerStars Hand #222980032018:  Hold'em No Limit ($2.50/$5.00 USD) - 2021/01/23 19:33:52 ET
Table 'Aaltje II' 6-max Seat #6 is the button
Seat 1: Rabarber77 ($164.64 in chips)
Seat 2: Obbis01 ($986.55 in chips)
Seat 3: spat93 ($590.95 in chips)
Seat 4: jjisnoob ($507.50 in chips)
Seat 5: sacachispa19 ($500 in chips)
Seat 6: piscogay ($1112.18 in chips)
Rabarber77: posts small blind $2.50
Obbis01: posts big blind $5
*** HOLE CARDS ***
spat93: raises $6 to $11
jjisnoob: folds
sacachispa19: folds
piscogay: folds
Rabarber77: folds
Obbis01: calls $6
*** FLOP *** [2h Jc 7c]
Obbis01: checks
spat93: bets $7.75
Obbis01: raises $19.39 to $27.14
spat93: calls $19.39
*** TURN *** [2h Jc 7c] [Kh]
Obbis01: checks
spat93: checks
*** RIVER *** [2h Jc 7c Kh] [3s]
Obbis01: checks
spat93: checks
*** SHOW DOWN ***
Obbis01: shows [Td Jd] (a pair of Jacks)
spat93: mucks hand
Obbis01 collected $75.78 from pot
*** SUMMARY ***
Total pot $78.78 | Rake $3
Board [2h Jc 7c Kh 3s]
Seat 1: Rabarber77 (small blind) folded before Flop
Seat 2: Obbis01 (big blind) showed [Td Jd] and won ($75.78) with a pair of Jacks
Seat 3: spat93 mucked
Seat 4: jjisnoob folded before Flop (didn't bet)
Seat 5: sacachispa19 folded before Flop (didn't bet)
Seat 6: piscogay (button) folded before Flop (didn't bet)


PokerStars Hand #222980076335:  Hold'em No Limit ($2.50/$5.00 USD) - 2021/01/23 19:35:20 ET
Table 'Aaltje II' 6-max Seat #1 is the button
Seat 1: Rabarber77 ($162.14 in chips)
Seat 2: Obbis01 ($1024.19 in chips)
Seat 3: spat93 ($552.81 in chips)
Seat 4: jjisnoob ($507.50 in chips)
Seat 5: sacachispa19 ($500 in chips)
Seat 6: piscogay ($1112.18 in chips)
Obbis01: posts small blind $2.50
spat93: posts big blind $5
*** HOLE CARDS ***
jjisnoob: folds
sacachispa19: folds
piscogay: raises $7.50 to $12.50
Rabarber77: folds
Obbis01: folds
spat93: folds
Uncalled bet ($7.50) returned to piscogay
piscogay collected $12.50 from pot
piscogay: doesn't show hand
*** SUMMARY ***
Total pot $12.50 | Rake $0
Seat 1: Rabarber77 (button) folded before Flop (didn't bet)
Seat 2: Obbis01 (small blind) folded before Flop
Seat 3: spat93 (big blind) folded before Flop
Seat 4: jjisnoob folded before Flop (didn't bet)
Seat 5: sacachispa19 folded before Flop (didn't bet)
Seat 6: piscogay collected ($12.50)


PokerStars Hand #222980086070:  Hold'em No Limit ($2.50/$5.00 USD) - 2021/01/23 19:35:40 ET
Table 'Aaltje II' 6-max Seat #2 is the button
Seat 1: Rabarber77 ($162.14 in chips)
Seat 2: Obbis01 ($1021.69 in chips)
Seat 3: spat93 ($547.81 in chips)
Seat 4: jjisnoob ($507.50 in chips)
Seat 5: sacachispa19 ($500 in chips)
Seat 6: piscogay ($1119.68 in chips)
spat93: posts small blind $2.50
jjisnoob: posts big blind $5
*** HOLE CARDS ***
sacachispa19: folds
piscogay: folds
Rabarber77: folds
Obbis01: folds
spat93: folds
Uncalled bet ($2.50) returned to jjisnoob
jjisnoob collected $5 from pot
jjisnoob: doesn't show hand
*** SUMMARY ***
Total pot $5 | Rake $0
Seat 1: Rabarber77 folded before Flop (didn't bet)
Seat 2: Obbis01 (button) folded before Flop (didn't bet)
Seat 3: spat93 (small blind) folded before Flop
Seat 4: jjisnoob (big blind) collected ($5)
Seat 5: sacachispa19 folded before Flop (didn't bet)
Seat 6: piscogay folded before Flop (didn't bet)


PokerStars Hand #222980090464:  Hold'em No Limit ($2.50/$5.00 USD) - 2021/01/23 19:35:48 ET
Table 'Aaltje II' 6-max Seat #3 is the button
Seat 1: Rabarber77 ($162.14 in chips)
Seat 2: Obbis01 ($1021.69 in chips)
Seat 3: spat93 ($545.31 in chips)
Seat 4: jjisnoob ($510 in chips)
Seat 5: sacachispa19 ($500 in chips)
Seat 6: piscogay ($1119.68 in chips)
jjisnoob: posts small blind $2.50
sacachispa19: posts big blind $5
*** HOLE CARDS ***
piscogay: folds
Rabarber77: folds
Obbis01: folds
spat93: folds
jjisnoob: raises $11.50 to $16.50
sacachispa19: calls $11.50
*** FLOP *** [2c 9d 5s]
jjisnoob: bets $17.24
sacachispa19: calls $17.24
*** TURN *** [2c 9d 5s] [Kd]
jjisnoob: bets $50.94
sacachispa19: calls $50.94
*** RIVER *** [2c 9d 5s Kd] [6d]
jjisnoob: bets $54.90
sacachispa19: calls $54.90
*** SHOW DOWN ***
jjisnoob: shows [Jd 7d] (a flush, King high)
sacachispa19: mucks hand
jjisnoob collected $276.16 from pot
*** SUMMARY ***
Total pot $279.16 | Rake $3
Board [2c 9d 5s Kd 6d]
Seat 1: Rabarber77 folded before Flop (didn't bet)
Seat 2: Obbis01 folded before Flop (didn't bet)
Seat 3: spat93 (button) folded before Flop (didn't bet)
Seat 4: jjisnoob (small blind) showed [Jd 7d] and won ($276.16) with a flush, King high
Seat 5: sacachispa19 (big blind) mucked
Seat 6: piscogay folded before Flop (didn't bet)


PokerStars Hand #222980146087:  Hold'em No Limit ($2.50/$5.00 USD) - 2021/01/23 19:37:39 ET
Table 'Aaltje II' 6-max Seat #4 is the button
Seat 1: Rabarber77 ($162.14 in chips)
Seat 2: Obbis01 ($1021.69 in chips)
Seat 3: spat93 ($545.31 in chips)
Seat 4: jjisnoob ($646.58 in chips)
Seat 5: sacachispa19 ($500 in chips)
Seat 6: piscogay ($1119.68 in chips)
sacachispa19: posts small blind $2.50
piscogay: posts big blind $5
*** HOLE CARDS ***
Rabarber77: raises $7 to $12
Obbis01: folds
spat93: raises $25.50 to $37.50
jjisnoob: folds
sacachispa19: folds
piscogay: folds
Rabarber77: calls $25.50
*** FLOP *** [8d 6h 9c]
Rabarber77: checks
spat93: bets $53
Rabarber77: raises $71.64 to $124.64 and is all-in
spat93: calls $71.64
*** TURN *** [8d 6h 9c] [6d]
*** RIVER *** [8d 6h 9c 6d] [Kc]
*** SHOW DOWN ***
Rabarber77: shows [9s 8s] (two pair, Nines and Eights)
spat93: shows [Kh Ks] (a full house, Kings full of Sixes)
spat93 collected $328.78 from pot
*** SUMMARY ***
Total pot $331.78 | Rake $3
Board [8d 6h 9c 6d Kc]
Seat 1: Rabarber77 showed [9s 8s] and lost with two pair, Nines and Eights
Seat 2: Obbis01 folded before Flop (didn't bet)
Seat 3: spat93 showed [Kh Ks] and won ($328.78) with a full house, Kings full of Sixes
Seat 4: jjisnoob (button) folded before Flop (didn't bet)
Seat 5: sacachispa19 (small blind) folded before Flop
Seat 6: piscogay (big blind) folded before Flop


PokerStars Hand #222980169900:  Hold'em No Limit ($2.50/$5.00 USD) - 2021/01/23 19:38:26 ET
Table 'Aaltje II' 6-max Seat #5 is the button
Seat 2: Obbis01 ($1021.69 in chips)
Seat 3: spat93 ($711.95 in chips)
Seat 4: jjisnoob ($646.58 in chips)
Seat 5: sacachispa19 ($500 in chips)
Seat 6: piscogay ($1114.68 in chips)
piscogay: posts small blind $2.50
Obbis01: posts big blind $5
*** HOLE CARDS ***
spat93: folds
jjisnoob: raises $6.25 to $11.25
sacachispa19: folds
piscogay: folds
Obbis01: folds
Uncalled bet ($6.25) returned to jjisnoob
jjisnoob collected $12.50 from pot
jjisnoob: doesn't show hand
*** SUMMARY ***
Total pot $12.50 | Rake $0
Seat 2: Obbis01 (big blind) folded before Flop
Seat 3: spat93 folded before Flop (didn't bet)
Seat 4: jjisnoob collected ($12.50)
Seat 5: sacachispa19 (button) folded before Flop (didn't bet)
Seat 6: piscogay (small blind) folded before Flop


PokerStars Hand #222980179576:  Hold'em No Limit ($2.50/$5.00 USD) - 2021/01/23 19:38:45 ET
Table 'Aaltje II' 6-max Seat #6 is the button
Seat 2: Obbis01 ($1016.69 in chips)
Seat 3: spat93 ($711.95 in chips)
Seat 4: jjisnoob ($654.08 in chips)
Seat 5: sacachispa19 ($500 in chips)
Seat 6: piscogay ($1112.18 in chips)
Obbis01: posts small blind $2.50
spat93: posts big blind $5
*** HOLE CARDS ***
jjisnoob: raises $6.25 to $11.25
sacachispa19: folds
piscogay: folds
Obbis01: calls $8.75
spat93: folds
*** FLOP *** [6c 7s Js]
Obbis01: checks
jjisnoob: bets $10.19
Obbis01: calls $10.19
*** TURN *** [6c 7s Js] [4h]
Obbis01: checks
jjisnoob: bets $35.94
Obbis01: calls $35.94
*** RIVER *** [6c 7s Js 4h] [4s]
Obbis01: checks
jjisnoob: checks
*** SHOW DOWN ***
Obbis01: shows [Qs Jh] (two pair, Jacks and Fours)
jjisnoob: shows [As Ah] (two pair, Aces and Fours)
jjisnoob collected $116.76 from pot
*** SUMMARY ***
Total pot $119.76 | Rake $3
Board [6c 7s Js 4h 4s]
Seat 2: Obbis01 (small blind) showed [Qs Jh] and lost with two pair, Jacks and Fours
Seat 3: spat93 (big blind) folded before Flop
Seat 4: jjisnoob showed [As Ah] and won ($116.76) with two pair, Aces and Fours
Seat 5: sacachispa19 folded before Flop (didn't bet)
Seat 6: piscogay (button) folded before Flop (didn't bet)


PokerStars Hand #222980227208:  Hold'em No Limit ($2.50/$5.00 USD) - 2021/01/23 19:40:21 ET
Table 'Aaltje II' 6-max Seat #2 is the button
Seat 2: Obbis01 ($959.31 in chips)
Seat 3: spat93 ($706.95 in chips)
Seat 4: jjisnoob ($713.46 in chips)
Seat 5: sacachispa19 ($500 in chips)
Seat 6: piscogay ($1112.18 in chips)
spat93: posts small blind $2.50
jjisnoob: posts big blind $5
*** HOLE CARDS ***
sacachispa19: raises $7.50 to $12.50
piscogay: folds
Obbis01: folds
spat93: folds
jjisnoob: folds
Uncalled bet ($7.50) returned to sacachispa19
sacachispa19 collected $12.50 from pot
*** SUMMARY ***
Total pot $12.50 | Rake $0
Seat 2: Obbis01 (button) folded before Flop (didn't bet)
Seat 3: spat93 (small blind) folded before Flop
Seat 4: jjisnoob (big blind) folded before Flop
Seat 5: sacachispa19 collected ($12.50)
Seat 6: piscogay folded before Flop (didn't bet)


PokerStars Hand #222980239130:  Hold'em No Limit ($2.50/$5.00 USD) - 2021/01/23 19:40:45 ET
Table 'Aaltje II' 6-max Seat #3 is the button
Seat 2: Obbis01 ($959.31 in chips)
Seat 3: spat93 ($704.45 in chips)
Seat 4: jjisnoob ($708.46 in chips)
Seat 6: piscogay ($1112.18 in chips)
jjisnoob: posts small blind $2.50
sacachispa19 has timed out
sacachispa19: is sitting out
piscogay: posts big blind $5
*** HOLE CARDS ***
Obbis01 has timed out
Obbis01: folds
spat93: raises $7.50 to $12.50
jjisnoob: folds
piscogay: folds
Uncalled bet ($7.50) returned to spat93
spat93 collected $12.50 from pot
spat93: doesn't show hand
*** SUMMARY ***
Total pot $12.50 | Rake $0
Seat 2: Obbis01 folded before Flop (didn't bet)
Seat 3: spat93 (button) collected ($12.50)
Seat 4: jjisnoob (small blind) folded before Flop
Seat 6: piscogay (big blind) folded before Flop


PokerStars Hand #222980256668:  Hold'em No Limit ($2.50/$5.00 USD) - 2021/01/23 19:41:20 ET
Table 'Aaltje II' 6-max Seat #4 is the button
Seat 1: Rabarber77 ($400 in chips)
Seat 3: spat93 ($711.95 in chips)
Seat 4: jjisnoob ($705.96 in chips)
Seat 6: piscogay ($1107.18 in chips)
piscogay: posts small blind $2.50
Rabarber77: posts big blind $5
*** HOLE CARDS ***
spat93: raises $7.50 to $12.50
jjisnoob: folds
piscogay: folds
Rabarber77: calls $7.50
*** FLOP *** [5s Tc 6c]
Rabarber77: checks
spat93: bets $20
Rabarber77: calls $20
*** TURN *** [5s Tc 6c] [9d]
Rabarber77: checks
spat93: bets $55
Rabarber77: raises $312.50 to $367.50 and is all-in
spat93: folds
Uncalled bet ($312.50) returned to Rabarber77
Rabarber77 collected $176 from pot
Rabarber77: doesn't show hand
*** SUMMARY ***
Total pot $177.50 | Rake $1.50
Board [5s Tc 6c 9d]
Seat 1: Rabarber77 (big blind) collected ($176)
Seat 3: spat93 folded on the Turn
Seat 4: jjisnoob (button) folded before Flop (didn't bet)
Seat 6: piscogay (small blind) folded before Flop


PokerStars Hand #222980288771:  Hold'em No Limit ($2.50/$5.00 USD) - 2021/01/23 19:42:26 ET
Table 'Aaltje II' 6-max Seat #6 is the button
Seat 1: Rabarber77 ($488.50 in chips)
Seat 2: Obbis01 ($959.31 in chips)
Seat 3: spat93 ($624.45 in chips)
Seat 4: jjisnoob ($705.96 in chips)
Seat 6: piscogay ($1104.68 in chips)
Rabarber77: posts small blind $2.50
Obbis01: posts big blind $5
sacachispa19: sits out
*** HOLE CARDS ***
spat93: folds
jjisnoob: folds
piscogay: raises $7.50 to $12.50
Rabarber77: folds
Obbis01: folds
Uncalled bet ($7.50) returned to piscogay
piscogay collected $12.50 from pot
piscogay: doesn't show hand
*** SUMMARY ***
Total pot $12.50 | Rake $0
Seat 1: Rabarber77 (small blind) folded before Flop
Seat 2: Obbis01 (big blind) folded before Flop
Seat 3: spat93 folded before Flop (didn't bet)
Seat 4: jjisnoob folded before Flop (didn't bet)
Seat 6: piscogay (button) collected ($12.50)


PokerStars Hand #222980297453:  Hold'em No Limit ($2.50/$5.00 USD) - 2021/01/23 19:42:43 ET
Table 'Aaltje II' 6-max Seat #1 is the button
Seat 1: Rabarber77 ($486 in chips)
Seat 2: Obbis01 ($954.31 in chips)
Seat 3: spat93 ($624.45 in chips)
Seat 4: jjisnoob ($705.96 in chips)
Seat 6: piscogay ($1112.18 in chips)
Obbis01: posts small blind $2.50
spat93: posts big blind $5
sacachispa19: sits out
*** HOLE CARDS ***
jjisnoob: folds
piscogay: raises $7.50 to $12.50
Rabarber77: raises $12.50 to $25
Obbis01: folds
spat93: folds
piscogay: calls $12.50
*** FLOP *** [Td 6c 3s]
piscogay: checks
Rabarber77: bets $30
piscogay: calls $30
*** TURN *** [Td 6c 3s] [9c]
piscogay: checks
Rabarber77: checks
*** RIVER *** [Td 6c 3s 9c] [2d]
piscogay: bets $76.33
Rabarber77: calls $76.33
*** SHOW DOWN ***
piscogay: shows [Js Jc] (a pair of Jacks)
Rabarber77: mucks hand
piscogay collected $267.16 from pot
*** SUMMARY ***
Total pot $270.16 | Rake $3
Board [Td 6c 3s 9c 2d]
Seat 1: Rabarber77 (button) mucked
Seat 2: Obbis01 (small blind) folded before Flop
Seat 3: spat93 (big blind) folded before Flop
Seat 4: jjisnoob folded before Flop (didn't bet)
Seat 6: piscogay showed [Js Jc] and won ($267.16) with a pair of Jacks


PokerStars Hand #222980327720:  Hold'em No Limit ($2.50/$5.00 USD) - 2021/01/23 19:43:45 ET
Table 'Aaltje II' 6-max Seat #2 is the button
Seat 1: Rabarber77 ($354.67 in chips)
Seat 2: Obbis01 ($951.81 in chips)
Seat 3: spat93 ($619.45 in chips)
Seat 4: jjisnoob ($705.96 in chips)
Seat 6: piscogay ($1248.01 in chips)
spat93: posts small blind $2.50
jjisnoob: posts big blind $5
sacachispa19: sits out
*** HOLE CARDS ***
piscogay: folds
Rabarber77: raises $10 to $15
Obbis01: calls $15
spat93: folds
jjisnoob: folds
*** FLOP *** [8d Jd 3d]
Rabarber77: checks
Obbis01: bets $35.62
Rabarber77: folds
Uncalled bet ($35.62) returned to Obbis01
Obbis01 collected $35.62 from pot
*** SUMMARY ***
Total pot $37.50 | Rake $1.88
Board [8d Jd 3d]
Seat 1: Rabarber77 folded on the Flop
Seat 2: Obbis01 (button) collected ($35.62)
Seat 3: spat93 (small blind) folded before Flop
Seat 4: jjisnoob (big blind) folded before Flop
Seat 6: piscogay folded before Flop (didn't bet)


PokerStars Hand #222980345968:  Hold'em No Limit ($2.50/$5.00 USD) - 2021/01/23 19:44:22 ET
Table 'Aaltje II' 6-max Seat #3 is the button
Seat 1: Rabarber77 ($339.67 in chips)
Seat 2: Obbis01 ($972.43 in chips)
Seat 3: spat93 ($616.95 in chips)
Seat 4: jjisnoob ($700.96 in chips)
Seat 5: sacachispa19 ($507.50 in chips)
Seat 6: piscogay ($1248.01 in chips)
jjisnoob: posts small blind $2.50
sacachispa19: posts big blind $5
*** HOLE CARDS ***
piscogay: folds
Rabarber77: folds
Obbis01: folds
spat93: folds
jjisnoob: folds
Uncalled bet ($2.50) returned to sacachispa19
sacachispa19 collected $5 from pot
sacachispa19: doesn't show hand
*** SUMMARY ***
Total pot $5 | Rake $0
Seat 1: Rabarber77 folded before Flop (didn't bet)
Seat 2: Obbis01 folded before Flop (didn't bet)
Seat 3: spat93 (button) folded before Flop (didn't bet)
Seat 4: jjisnoob (small blind) folded before Flop
Seat 5: sacachispa19 (big blind) collected ($5)
Seat 6: piscogay folded before Flop (didn't bet)


PokerStars Hand #222980353856:  Hold'em No Limit ($2.50/$5.00 USD) - 2021/01/23 19:44:38 ET
Table 'Aaltje II' 6-max Seat #4 is the button
Seat 1: Rabarber77 ($339.67 in chips)
Seat 2: Obbis01 ($972.43 in chips)
Seat 3: spat93 ($616.95 in chips)
Seat 4: jjisnoob ($698.46 in chips)
Seat 5: sacachispa19 ($510 in chips)
Seat 6: piscogay ($1248.01 in chips)
sacachispa19: posts small blind $2.50
piscogay: posts big blind $5
*** HOLE CARDS ***
Rabarber77: folds
Obbis01: folds
spat93: folds
jjisnoob: folds
sacachispa19: raises $7.50 to $12.50
piscogay: calls $7.50
*** FLOP *** [3c 2s 2c]
sacachispa19: checks
piscogay: checks
*** TURN *** [3c 2s 2c] [Kh]
sacachispa19: bets $13.06
piscogay: folds
Uncalled bet ($13.06) returned to sacachispa19
sacachispa19 collected $23.75 from pot
sacachispa19: doesn't show hand
*** SUMMARY ***
Total pot $25 | Rake $1.25
Board [3c 2s 2c Kh]
Seat 1: Rabarber77 folded before Flop (didn't bet)
Seat 2: Obbis01 folded before Flop (didn't bet)
Seat 3: spat93 folded before Flop (didn't bet)
Seat 4: jjisnoob (button) folded before Flop (didn't bet)
Seat 5: sacachispa19 (small blind) collected ($23.75)
Seat 6: piscogay (big blind) folded on the Turn


PokerStars Hand #222980373975:  Hold'em No Limit ($2.50/$5.00 USD) - 2021/01/23 19:45:19 ET
Table 'Aaltje II' 6-max Seat #5 is the button
Seat 1: Rabarber77 ($339.67 in chips)
Seat 2: Obbis01 ($972.43 in chips)
Seat 3: spat93 ($616.95 in chips)
Seat 4: jjisnoob ($698.46 in chips)
Seat 5: sacachispa19 ($521.25 in chips)
Seat 6: piscogay ($1235.51 in chips)
piscogay: posts small blind $2.50
Rabarber77: posts big blind $5
*** HOLE CARDS ***
Obbis01: folds
spat93: folds
jjisnoob: folds
sacachispa19: folds
piscogay: folds
Uncalled bet ($2.50) returned to Rabarber77
Rabarber77 collected $5 from pot
Rabarber77: doesn't show hand
*** SUMMARY ***
Total pot $5 | Rake $0
Seat 1: Rabarber77 (big blind) collected ($5)
Seat 2: Obbis01 folded before Flop (didn't bet)
Seat 3: spat93 folded before Flop (didn't bet)
Seat 4: jjisnoob folded before Flop (didn't bet)
Seat 5: sacachispa19 (button) folded before Flop (didn't bet)
Seat 6: piscogay (small blind) folded before Flop


PokerStars Hand #222980382645:  Hold'em No Limit ($2.50/$5.00 USD) - 2021/01/23 19:45:37 ET
Table 'Aaltje II' 6-max Seat #6 is the button
Seat 1: Rabarber77 ($342.17 in chips)
Seat 2: Obbis01 ($972.43 in chips)
Seat 3: spat93 ($616.95 in chips)
Seat 4: jjisnoob ($698.46 in chips)
Seat 5: sacachispa19 ($521.25 in chips)
Seat 6: piscogay ($1233.01 in chips)
Rabarber77: posts small blind $2.50
Obbis01: posts big blind $5
*** HOLE CARDS ***
spat93: folds
jjisnoob: folds
sacachispa19: raises $7.50 to $12.50
piscogay: folds
Rabarber77: folds
Obbis01: raises $20.50 to $33
sacachispa19: calls $20.50
*** FLOP *** [Qc 2c 5h]
Obbis01: bets $40
sacachispa19: folds
Uncalled bet ($40) returned to Obbis01
Obbis01 collected $65.50 from pot
*** SUMMARY ***
Total pot $68.50 | Rake $3
Board [Qc 2c 5h]
Seat 1: Rabarber77 (small blind) folded before Flop
Seat 2: Obbis01 (big blind) collected ($65.50)
Seat 3: spat93 folded before Flop (didn't bet)
Seat 4: jjisnoob folded before Flop (didn't bet)
Seat 5: sacachispa19 folded on the Flop
Seat 6: piscogay (button) folded before Flop (didn't bet)


PokerStars Hand #222980405602:  Hold'em No Limit ($2.50/$5.00 USD) - 2021/01/23 19:46:24 ET
Table 'Aaltje II' 6-max Seat #1 is the button
Seat 1: Rabarber77 ($339.67 in chips)
Seat 2: Obbis01 ($1004.93 in chips)
Seat 3: spat93 ($616.95 in chips)
Seat 4: jjisnoob ($698.46 in chips)
Seat 5: sacachispa19 ($500 in chips)
Seat 6: piscogay ($1233.01 in chips)
Obbis01: posts small blind $2.50
spat93: posts big blind $5
*** HOLE CARDS ***
jjisnoob: folds
sacachispa19: folds
piscogay: folds
Rabarber77: folds
Obbis01: raises $10 to $15
spat93: folds
Uncalled bet ($10) returned to Obbis01
Obbis01 collected $10 from pot
*** SUMMARY ***
Total pot $10 | Rake $0
Seat 1: Rabarber77 (button) folded before Flop (didn't bet)
Seat 2: Obbis01 (small blind) collected ($10)
Seat 3: spat93 (big blind) folded before Flop
Seat 4: jjisnoob folded before Flop (didn't bet)
Seat 5: sacachispa19 folded before Flop (didn't bet)
Seat 6: piscogay folded before Flop (didn't bet)


PokerStars Hand #222980417313:  Hold'em No Limit ($2.50/$5.00 USD) - 2021/01/23 19:46:48 ET
Table 'Aaltje II' 6-max Seat #2 is the button
Seat 1: Rabarber77 ($339.67 in chips)
Seat 2: Obbis01 ($1009.93 in chips)
Seat 3: spat93 ($611.95 in chips)
Seat 4: jjisnoob ($698.46 in chips)
Seat 5: sacachispa19 ($500 in chips)
Seat 6: piscogay ($1233.01 in chips)
spat93: posts small blind $2.50
jjisnoob: posts big blind $5
*** HOLE CARDS ***
sacachispa19: folds
piscogay: folds
Rabarber77: raises $10 to $15
Obbis01: calls $15
spat93: folds
jjisnoob: folds
*** FLOP *** [As 9h 6s]
Rabarber77: bets $30
Obbis01: folds
Uncalled bet ($30) returned to Rabarber77
Rabarber77 collected $35.62 from pot
Rabarber77: doesn't show hand
*** SUMMARY ***
Total pot $37.50 | Rake $1.88
Board [As 9h 6s]
Seat 1: Rabarber77 collected ($35.62)
Seat 2: Obbis01 (button) folded on the Flop
Seat 3: spat93 (small blind) folded before Flop
Seat 4: jjisnoob (big blind) folded before Flop
Seat 5: sacachispa19 folded before Flop (didn't bet)
Seat 6: piscogay folded before Flop (didn't bet)


PokerStars Hand #222980440729:  Hold'em No Limit ($2.50/$5.00 USD) - 2021/01/23 19:47:14 ET
Table 'Aaltje II' 6-max Seat #3 is the button
Seat 1: Rabarber77 ($360.29 in chips)
Seat 2: Obbis01 ($994.93 in chips)
Seat 3: spat93 ($609.45 in chips)
Seat 4: jjisnoob ($693.46 in chips)
Seat 5: sacachispa19 ($500 in chips)
Seat 6: piscogay ($1233.01 in chips)
jjisnoob: posts small blind $2.50
sacachispa19: posts big blind $5
*** HOLE CARDS ***
piscogay: calls $5
Rabarber77: folds
Obbis01: calls $5
spat93: folds
jjisnoob: folds
sacachispa19: raises $30 to $35
piscogay: raises $80 to $115
Obbis01: folds
sacachispa19: calls $80
*** FLOP *** [7s 7c Qc]
sacachispa19: checks
piscogay: bets $77.39
sacachispa19: calls $77.39
*** TURN *** [7s 7c Qc] [3c]
sacachispa19: checks
piscogay: checks
*** RIVER *** [7s 7c Qc 3c] [As]
sacachispa19: checks
piscogay: bets $1040.62 and is all-in
sacachispa19: folds
Uncalled bet ($1040.62) returned to piscogay
piscogay collected $389.28 from pot
piscogay: doesn't show hand
*** SUMMARY ***
Total pot $392.28 | Rake $3
Board [7s 7c Qc 3c As]
Seat 1: Rabarber77 folded before Flop (didn't bet)
Seat 2: Obbis01 folded before Flop
Seat 3: spat93 (button) folded before Flop (didn't bet)
Seat 4: jjisnoob (small blind) folded before Flop
Seat 5: sacachispa19 (big blind) folded on the River
Seat 6: piscogay collected ($389.28)


PokerStars Hand #222980474470:  Hold'em No Limit ($2.50/$5.00 USD) - 2021/01/23 19:48:23 ET
Table 'Aaltje II' 6-max Seat #4 is the button
Seat 1: Rabarber77 ($360.29 in chips)
Seat 2: Obbis01 ($989.93 in chips)
Seat 3: spat93 ($609.45 in chips)
Seat 4: jjisnoob ($690.96 in chips)
Seat 5: sacachispa19 ($500 in chips)
Seat 6: piscogay ($1429.90 in chips)
sacachispa19: posts small blind $2.50
piscogay: posts big blind $5
*** HOLE CARDS ***
Rabarber77: raises $10 to $15
Obbis01: calls $15
spat93: calls $15
jjisnoob: folds
sacachispa19: folds
piscogay: calls $10
*** FLOP *** [Qd 2s 8c]
piscogay: checks
Rabarber77: checks
Obbis01: bets $39.50
spat93: folds
piscogay: folds
Rabarber77: folds
Uncalled bet ($39.50) returned to Obbis01
Obbis01 collected $59.50 from pot
*** SUMMARY ***
Total pot $62.50 | Rake $3
Board [Qd 2s 8c]
Seat 1: Rabarber77 folded on the Flop
Seat 2: Obbis01 collected ($59.50)
Seat 3: spat93 folded on the Flop
Seat 4: jjisnoob (button) folded before Flop (didn't bet)
Seat 5: sacachispa19 (small blind) folded before Flop
Seat 6: piscogay (big blind) folded on the Flop


PokerStars Hand #222980500343:  Hold'em No Limit ($2.50/$5.00 USD) - 2021/01/23 19:49:17 ET
Table 'Aaltje II' 6-max Seat #5 is the button
Seat 1: Rabarber77 ($345.29 in chips)
Seat 2: Obbis01 ($1034.43 in chips)
Seat 3: spat93 ($594.45 in chips)
Seat 4: jjisnoob ($690.96 in chips)
Seat 5: sacachispa19 ($500 in chips)
Seat 6: piscogay ($1414.90 in chips)
piscogay: posts small blind $2.50
Rabarber77: posts big blind $5
*** HOLE CARDS ***
Obbis01: folds
Obbis01 leaves the table
spat93: folds
jjisnoob: folds
sacachispa19: raises $7.50 to $12.50
piscogay: folds
Aprilz1stson joins the table at seat #2
Rabarber77: calls $7.50
*** FLOP *** [2d As 8c]
Rabarber77: checks
sacachispa19: bets $10
Rabarber77: calls $10
*** TURN *** [2d As 8c] [9s]
Rabarber77: checks
sacachispa19: bets $36.10
Rabarber77: calls $36.10
*** RIVER *** [2d As 8c 9s] [6d]
Rabarber77: checks
sacachispa19: bets $64.19
Rabarber77: folds
Uncalled bet ($64.19) returned to sacachispa19
sacachispa19 collected $116.70 from pot
sacachispa19: doesn't show hand
*** SUMMARY ***
Total pot $119.70 | Rake $3
Board [2d As 8c 9s 6d]
Seat 1: Rabarber77 (big blind) folded on the River
Seat 2: Obbis01 folded before Flop (didn't bet)
Seat 3: spat93 folded before Flop (didn't bet)
Seat 4: jjisnoob folded before Flop (didn't bet)
Seat 5: sacachispa19 (button) collected ($116.70)
Seat 6: piscogay (small blind) folded before Flop


PokerStars Hand #222980527692:  Hold'em No Limit ($2.50/$5.00 USD) - 2021/01/23 19:50:14 ET
Table 'Aaltje II' 6-max Seat #6 is the button
Seat 1: Rabarber77 ($286.69 in chips)
Seat 2: Aprilz1stson ($500 in chips)
Seat 3: spat93 ($594.45 in chips)
Seat 4: jjisnoob ($690.96 in chips)
Seat 5: sacachispa19 ($558.10 in chips)
Seat 6: piscogay ($1412.40 in chips)
Rabarber77: posts small blind $2.50
Aprilz1stson: posts big blind $5
*** HOLE CARDS ***
spat93: folds
jjisnoob: folds
sacachispa19: folds
piscogay: folds
Rabarber77: raises $5 to $10
Aprilz1stson: calls $5
*** FLOP *** [5c 9h Qd]
Rabarber77: bets $9.50
Aprilz1stson: calls $9.50
*** TURN *** [5c 9h Qd] [7h]
Rabarber77: bets $30
Aprilz1stson: folds
Uncalled bet ($30) returned to Rabarber77
Rabarber77 collected $37.05 from pot
Rabarber77: doesn't show hand
*** SUMMARY ***
Total pot $39 | Rake $1.95
Board [5c 9h Qd 7h]
Seat 1: Rabarber77 (small blind) collected ($37.05)
Seat 2: Aprilz1stson (big blind) folded on the Turn
Seat 3: spat93 folded before Flop (didn't bet)
Seat 4: jjisnoob folded before Flop (didn't bet)
Seat 5: sacachispa19 folded before Flop (didn't bet)
Seat 6: piscogay (button) folded before Flop (didn't bet)


PokerStars Hand #222980558526:  Hold'em No Limit ($2.50/$5.00 USD) - 2021/01/23 19:51:19 ET
Table 'Aaltje II' 6-max Seat #1 is the button
Seat 1: Rabarber77 ($304.24 in chips)
Seat 2: Aprilz1stson ($500 in chips)
Seat 4: jjisnoob ($690.96 in chips)
Seat 5: sacachispa19 ($558.10 in chips)
Seat 6: piscogay ($1412.40 in chips)
Aprilz1stson: posts small blind $2.50
spat93: is sitting out
jjisnoob: posts big blind $5
*** HOLE CARDS ***
spat93 leaves the table
sacachispa19: folds
piscogay: raises $7.50 to $12.50
Rabarber77: folds
Aprilz1stson: folds
jjisnoob: folds
Uncalled bet ($7.50) returned to piscogay
piscogay collected $12.50 from pot
piscogay: doesn't show hand
*** SUMMARY ***
Total pot $12.50 | Rake $0
Seat 1: Rabarber77 (button) folded before Flop (didn't bet)
Seat 2: Aprilz1stson (small blind) folded before Flop
Seat 4: jjisnoob (big blind) folded before Flop
Seat 5: sacachispa19 folded before Flop (didn't bet)
Seat 6: piscogay collected ($12.50)


PokerStars Hand #222980570392:  Hold'em No Limit ($2.50/$5.00 USD) - 2021/01/23 19:51:45 ET
Table 'Aaltje II' 6-max Seat #2 is the button
Seat 1: Rabarber77 ($304.24 in chips)
Seat 2: Aprilz1stson ($500 in chips)
Seat 4: jjisnoob ($685.96 in chips)
Seat 5: sacachispa19 ($558.10 in chips)
Seat 6: piscogay ($1419.90 in chips)
jjisnoob: posts small blind $2.50
sacachispa19: posts big blind $5
*** HOLE CARDS ***
piscogay: raises $7.50 to $12.50
Rabarber77: folds
Aprilz1stson: folds
evo.com joins the table at seat #3
jjisnoob: folds
sacachispa19: raises $32.50 to $45
piscogay: folds
Uncalled bet ($32.50) returned to sacachispa19
sacachispa19 collected $27.50 from pot
sacachispa19: doesn't show hand
*** SUMMARY ***
Total pot $27.50 | Rake $0
Seat 1: Rabarber77 folded before Flop (didn't bet)
Seat 2: Aprilz1stson (button) folded before Flop (didn't bet)
Seat 4: jjisnoob (small blind) folded before Flop
Seat 5: sacachispa19 (big blind) collected ($27.50)
Seat 6: piscogay folded before Flop


PokerStars Hand #222980590104:  Hold'em No Limit ($2.50/$5.00 USD) - 2021/01/23 19:52:26 ET
Table 'Aaltje II' 6-max Seat #4 is the button
Seat 1: Rabarber77 ($304.24 in chips)
Seat 2: Aprilz1stson ($500 in chips)
Seat 4: jjisnoob ($683.46 in chips)
Seat 5: sacachispa19 ($573.10 in chips)
Seat 6: piscogay ($1407.40 in chips)
sacachispa19: posts small blind $2.50
piscogay: posts big blind $5
evo.com: sits out
*** HOLE CARDS ***
Rabarber77: folds
Aprilz1stson: folds
jjisnoob: folds
sacachispa19: raises $7.50 to $12.50
piscogay: calls $7.50
*** FLOP *** [6h 6c 8s]
sacachispa19: bets $7.84
piscogay: folds
Uncalled bet ($7.84) returned to sacachispa19
sacachispa19 collected $23.75 from pot
sacachispa19: doesn't show hand
*** SUMMARY ***
Total pot $25 | Rake $1.25
Board [6h 6c 8s]
Seat 1: Rabarber77 folded before Flop (didn't bet)
Seat 2: Aprilz1stson folded before Flop (didn't bet)
Seat 4: jjisnoob (button) folded before Flop (didn't bet)
Seat 5: sacachispa19 (small blind) collected ($23.75)
Seat 6: piscogay (big blind) folded on the Flop


PokerStars Hand #222980605092:  Hold'em No Limit ($2.50/$5.00 USD) - 2021/01/23 19:52:58 ET
Table 'Aaltje II' 6-max Seat #5 is the button
Seat 1: Rabarber77 ($304.24 in chips)
Seat 2: Aprilz1stson ($500 in chips)
Seat 4: jjisnoob ($683.46 in chips)
Seat 5: sacachispa19 ($584.35 in chips)
Seat 6: piscogay ($1394.90 in chips)
piscogay: posts small blind $2.50
Rabarber77: posts big blind $5
evo.com: sits out
*** HOLE CARDS ***
Aprilz1stson: folds
jjisnoob: folds
sacachispa19: folds
piscogay: raises $7.50 to $12.50
Rabarber77: calls $7.50
*** FLOP *** [3c Td Qd]
piscogay: bets $7.50
Rabarber77: raises $12.50 to $20
piscogay: calls $12.50
*** TURN *** [3c Td Qd] [5h]
piscogay: checks
Aprilz1stson leaves the table
Rabarber77: bets $45
piscogay: folds
Uncalled bet ($45) returned to Rabarber77
Rabarber77 collected $62 from pot
Rabarber77: doesn't show hand
*** SUMMARY ***
Total pot $65 | Rake $3
Board [3c Td Qd 5h]
Seat 1: Rabarber77 (big blind) collected ($62)
Seat 2: Aprilz1stson folded before Flop (didn't bet)
Seat 4: jjisnoob folded before Flop (didn't bet)
Seat 5: sacachispa19 (button) folded before Flop (didn't bet)
Seat 6: piscogay (small blind) folded on the Turn


PokerStars Hand #222980626367:  Hold'em No Limit ($2.50/$5.00 USD) - 2021/01/23 19:53:43 ET
Table 'Aaltje II' 6-max Seat #6 is the button
Seat 1: Rabarber77 ($333.74 in chips)
Seat 3: evo.com ($500 in chips)
Seat 4: jjisnoob ($683.46 in chips)
Seat 5: sacachispa19 ($584.35 in chips)
Seat 6: piscogay ($1362.40 in chips)
Rabarber77: posts small blind $2.50
evo.com: posts big blind $5
*** HOLE CARDS ***
jjisnoob: folds
sacachispa19: raises $7.50 to $12.50
piscogay: folds
Rabarber77: calls $10
evo.com: folds
*** FLOP *** [Jd 5c 9d]
Rabarber77: checks
sacachispa19: checks
*** TURN *** [Jd 5c 9d] [2h]
Rabarber77: bets $14.25
sacachispa19: calls $14.25
*** RIVER *** [Jd 5c 9d 2h] [6h]
Rabarber77: bets $27.79
sacachispa19: calls $27.79
*** SHOW DOWN ***
Rabarber77: shows [8d 8s] (a pair of Eights)
sacachispa19: mucks hand
Rabarber77 collected $111.08 from pot
*** SUMMARY ***
Total pot $114.08 | Rake $3
Board [Jd 5c 9d 2h 6h]
Seat 1: Rabarber77 (small blind) showed [8d 8s] and won ($111.08) with a pair of Eights
Seat 3: evo.com (big blind) folded before Flop
Seat 4: jjisnoob folded before Flop (didn't bet)
Seat 5: sacachispa19 mucked
Seat 6: piscogay (button) folded before Flop (didn't bet)


PokerStars Hand #222980653148:  Hold'em No Limit ($2.50/$5.00 USD) - 2021/01/23 19:54:41 ET
Table 'Aaltje II' 6-max Seat #1 is the button
Seat 1: Rabarber77 ($390.28 in chips)
Seat 3: evo.com ($500 in chips)
Seat 4: jjisnoob ($683.46 in chips)
Seat 5: sacachispa19 ($529.81 in chips)
Seat 6: piscogay ($1362.40 in chips)
evo.com: posts small blind $2.50
jjisnoob: posts big blind $5
*** HOLE CARDS ***
BG10141974 joins the table at seat #2
sacachispa19: raises $7.50 to $12.50
piscogay: folds
Rabarber77: folds
evo.com: folds
jjisnoob: folds
Uncalled bet ($7.50) returned to sacachispa19
sacachispa19 collected $12.50 from pot
sacachispa19: doesn't show hand
*** SUMMARY ***
Total pot $12.50 | Rake $0
Seat 1: Rabarber77 (button) folded before Flop (didn't bet)
Seat 3: evo.com (small blind) folded before Flop
Seat 4: jjisnoob (big blind) folded before Flop
Seat 5: sacachispa19 collected ($12.50)
Seat 6: piscogay folded before Flop (didn't bet)


PokerStars Hand #222980667817:  Hold'em No Limit ($2.50/$5.00 USD) - 2021/01/23 19:55:13 ET
Table 'Aaltje II' 6-max Seat #3 is the button
Seat 1: Rabarber77 ($390.28 in chips)
Seat 2: BG10141974 ($485 in chips)
Seat 3: evo.com ($500 in chips)
Seat 4: jjisnoob ($678.46 in chips)
Seat 5: sacachispa19 ($537.31 in chips)
Seat 6: piscogay ($1362.40 in chips)
jjisnoob: posts small blind $2.50
sacachispa19: posts big blind $5
BG10141974: posts big blind $5
*** HOLE CARDS ***
piscogay: raises $7.50 to $12.50
Rabarber77: folds
BG10141974: folds
evo.com: folds
jjisnoob: folds
sacachispa19: calls $7.50
*** FLOP *** [Ts 4d Ah]
sacachispa19: checks
piscogay: bets $15.44
sacachispa19: calls $15.44
*** TURN *** [Ts 4d Ah] [8c]
sacachispa19: checks
piscogay: checks
*** RIVER *** [Ts 4d Ah 8c] [3c]
sacachispa19: bets $90
piscogay: folds
Uncalled bet ($90) returned to sacachispa19
sacachispa19 collected $60.38 from pot
sacachispa19: doesn't show hand
*** SUMMARY ***
Total pot $63.38 | Rake $3
Board [Ts 4d Ah 8c 3c]
Seat 1: Rabarber77 folded before Flop (didn't bet)
Seat 2: BG10141974 folded before Flop (didn't bet)
Seat 3: evo.com (button) folded before Flop (didn't bet)
Seat 4: jjisnoob (small blind) folded before Flop
Seat 5: sacachispa19 (big blind) collected ($60.38)
Seat 6: piscogay folded on the River


PokerStars Hand #222980687949:  Hold'em No Limit ($2.50/$5.00 USD) - 2021/01/23 19:56:09 ET
Table 'Aaltje II' 6-max Seat #4 is the button
Seat 1: Rabarber77 ($390.28 in chips)
Seat 2: BG10141974 ($480 in chips)
Seat 3: evo.com ($500 in chips)
Seat 4: jjisnoob ($675.96 in chips)
Seat 5: sacachispa19 ($569.75 in chips)
Seat 6: piscogay ($1334.46 in chips)
sacachispa19: posts small blind $2.50
piscogay: posts big blind $5
*** HOLE CARDS ***
Rabarber77: raises $10 to $15
BG10141974: calls $15
evo.com: folds
jjisnoob: folds
sacachispa19: raises $50 to $65
piscogay: folds
Rabarber77: folds
BG10141974: folds
Uncalled bet ($50) returned to sacachispa19
sacachispa19 collected $50 from pot
sacachispa19: doesn't show hand
*** SUMMARY ***
Total pot $50 | Rake $0
Seat 1: Rabarber77 folded before Flop
Seat 2: BG10141974 folded before Flop
Seat 3: evo.com folded before Flop (didn't bet)
Seat 4: jjisnoob (button) folded before Flop (didn't bet)
Seat 5: sacachispa19 (small blind) collected ($50)
Seat 6: piscogay (big blind) folded before Flop


PokerStars Hand #222980699053:  Hold'em No Limit ($2.50/$5.00 USD) - 2021/01/23 19:56:39 ET
Table 'Aaltje II' 6-max Seat #5 is the button
Seat 1: Rabarber77 ($375.28 in chips)
Seat 2: BG10141974 ($465 in chips)
Seat 3: evo.com ($500 in chips)
Seat 4: jjisnoob ($675.96 in chips)
Seat 5: sacachispa19 ($604.75 in chips)
Seat 6: piscogay ($1329.46 in chips)
piscogay: posts small blind $2.50
Rabarber77: posts big blind $5
*** HOLE CARDS ***
BG10141974: raises $7.50 to $12.50
evo.com: raises $25 to $37.50
jjisnoob: folds
sacachispa19: folds
piscogay: folds
Rabarber77: folds
BG10141974: calls $25
*** FLOP *** [3h 3c 6c]
BG10141974: checks
evo.com: bets $45
BG10141974: folds
Uncalled bet ($45) returned to evo.com
evo.com collected $79.50 from pot
*** SUMMARY ***
Total pot $82.50 | Rake $3
Board [3h 3c 6c]
Seat 1: Rabarber77 (big blind) folded before Flop
Seat 2: BG10141974 folded on the Flop
Seat 3: evo.com collected ($79.50)
Seat 4: jjisnoob folded before Flop (didn't bet)
Seat 5: sacachispa19 (button) folded before Flop (didn't bet)
Seat 6: piscogay (small blind) folded before Flop


PokerStars Hand #222980712366:  Hold'em No Limit ($2.50/$5.00 USD) - 2021/01/23 19:57:16 ET
Table 'Aaltje II' 6-max Seat #6 is the button
Seat 1: Rabarber77 ($370.28 in chips)
Seat 2: BG10141974 ($427.50 in chips)
Seat 3: evo.com ($542 in chips)
Seat 4: jjisnoob ($675.96 in chips)
Seat 5: sacachispa19 ($604.75 in chips)
Seat 6: piscogay ($1326.96 in chips)
Rabarber77: posts small blind $2.50
BG10141974: posts big blind $5
*** HOLE CARDS ***
evo.com: folds
jjisnoob: raises $6.25 to $11.25
sacachispa19: folds
piscogay: folds
Rabarber77: raises $16.25 to $27.50
BG10141974: folds
jjisnoob: calls $16.25
*** FLOP *** [3h Jh 8c]
Rabarber77: bets $40
jjisnoob: folds
Uncalled bet ($40) returned to Rabarber77
Rabarber77 collected $57 from pot
Rabarber77: doesn't show hand
*** SUMMARY ***
Total pot $60 | Rake $3
Board [3h Jh 8c]
Seat 1: Rabarber77 (small blind) collected ($57)
Seat 2: BG10141974 (big blind) folded before Flop
Seat 3: evo.com folded before Flop (didn't bet)
Seat 4: jjisnoob folded on the Flop
Seat 5: sacachispa19 folded before Flop (didn't bet)
Seat 6: piscogay (button) folded before Flop (didn't bet)


PokerStars Hand #222980728117:  Hold'em No Limit ($2.50/$5.00 USD) - 2021/01/23 19:58:00 ET
Table 'Aaltje II' 6-max Seat #1 is the button
Seat 1: Rabarber77 ($399.78 in chips)
Seat 2: BG10141974 ($422.50 in chips)
Seat 3: evo.com ($542 in chips)
Seat 4: jjisnoob ($648.46 in chips)
Seat 5: sacachispa19 ($604.75 in chips)
Seat 6: piscogay ($1326.96 in chips)
BG10141974: posts small blind $2.50
evo.com: posts big blind $5
*** HOLE CARDS ***
jjisnoob: folds
sacachispa19: folds
piscogay: raises $7.50 to $12.50
Rabarber77: folds
BG10141974: folds
evo.com: folds
Uncalled bet ($7.50) returned to piscogay
piscogay collected $12.50 from pot
piscogay: doesn't show hand
*** SUMMARY ***
Total pot $12.50 | Rake $0
Seat 1: Rabarber77 (button) folded before Flop (didn't bet)
Seat 2: BG10141974 (small blind) folded before Flop
Seat 3: evo.com (big blind) folded before Flop
Seat 4: jjisnoob folded before Flop (didn't bet)
Seat 5: sacachispa19 folded before Flop (didn't bet)
Seat 6: piscogay collected ($12.50)


PokerStars Hand #222980733875:  Hold'em No Limit ($2.50/$5.00 USD) - 2021/01/23 19:58:16 ET
Table 'Aaltje II' 6-max Seat #2 is the button
Seat 1: Rabarber77 ($399.78 in chips)
Seat 2: BG10141974 ($420 in chips)
Seat 3: evo.com ($537 in chips)
Seat 4: jjisnoob ($648.46 in chips)
Seat 5: sacachispa19 ($604.75 in chips)
Seat 6: piscogay ($1334.46 in chips)
evo.com: posts small blind $2.50
jjisnoob: posts big blind $5
*** HOLE CARDS ***
sacachispa19: folds
piscogay: folds
Rabarber77: folds
BG10141974: raises $7.50 to $12.50
evo.com: folds
jjisnoob: raises $41.25 to $53.75
BG10141974: folds
Uncalled bet ($41.25) returned to jjisnoob
jjisnoob collected $27.50 from pot
jjisnoob: doesn't show hand
*** SUMMARY ***
Total pot $27.50 | Rake $0
Seat 1: Rabarber77 folded before Flop (didn't bet)
Seat 2: BG10141974 (button) folded before Flop
Seat 3: evo.com (small blind) folded before Flop
Seat 4: jjisnoob (big blind) collected ($27.50)
Seat 5: sacachispa19 folded before Flop (didn't bet)
Seat 6: piscogay folded before Flop (didn't bet)


PokerStars Hand #222980743035:  Hold'em No Limit ($2.50/$5.00 USD) - 2021/01/23 19:58:41 ET
Table 'Aaltje II' 6-max Seat #3 is the button
Seat 1: Rabarber77 ($399.78 in chips)
Seat 2: BG10141974 ($407.50 in chips)
Seat 3: evo.com ($534.50 in chips)
Seat 4: jjisnoob ($663.46 in chips)
Seat 5: sacachispa19 ($604.75 in chips)
Seat 6: piscogay ($1334.46 in chips)
jjisnoob: posts small blind $2.50
sacachispa19: posts big blind $5
*** HOLE CARDS ***
piscogay: folds
Rabarber77: raises $10 to $15
BG10141974: folds
evo.com: folds
jjisnoob: folds
sacachispa19: folds
Uncalled bet ($10) returned to Rabarber77
Rabarber77 collected $12.50 from pot
Rabarber77: doesn't show hand
*** SUMMARY ***
Total pot $12.50 | Rake $0
Seat 1: Rabarber77 collected ($12.50)
Seat 2: BG10141974 folded before Flop (didn't bet)
Seat 3: evo.com (button) folded before Flop (didn't bet)
Seat 4: jjisnoob (small blind) folded before Flop
Seat 5: sacachispa19 (big blind) folded before Flop
Seat 6: piscogay folded before Flop (didn't bet)


PokerStars Hand #222980752366:  Hold'em No Limit ($2.50/$5.00 USD) - 2021/01/23 19:59:07 ET
Table 'Aaltje II' 6-max Seat #4 is the button
Seat 1: Rabarber77 ($407.28 in chips)
Seat 2: BG10141974 ($407.50 in chips)
Seat 3: evo.com ($534.50 in chips)
Seat 4: jjisnoob ($660.96 in chips)
Seat 5: sacachispa19 ($599.75 in chips)
Seat 6: piscogay ($1334.46 in chips)
sacachispa19: posts small blind $2.50
piscogay: posts big blind $5
*** HOLE CARDS ***
Rabarber77: folds
BG10141974: folds
evo.com: folds
jjisnoob: folds
sacachispa19: folds
Uncalled bet ($2.50) returned to piscogay
piscogay collected $5 from pot
piscogay: doesn't show hand
*** SUMMARY ***
Total pot $5 | Rake $0
Seat 1: Rabarber77 folded before Flop (didn't bet)
Seat 2: BG10141974 folded before Flop (didn't bet)
Seat 3: evo.com folded before Flop (didn't bet)
Seat 4: jjisnoob (button) folded before Flop (didn't bet)
Seat 5: sacachispa19 (small blind) folded before Flop
Seat 6: piscogay (big blind) collected ($5)


PokerStars Hand #222980760664:  Hold'em No Limit ($2.50/$5.00 USD) - 2021/01/23 19:59:30 ET
Table 'Aaltje II' 6-max Seat #5 is the button
Seat 1: Rabarber77 ($407.28 in chips)
Seat 2: BG10141974 ($407.50 in chips)
Seat 3: evo.com ($534.50 in chips)
Seat 4: jjisnoob ($660.96 in chips)
Seat 5: sacachispa19 ($597.25 in chips)
Seat 6: piscogay ($1336.96 in chips)
piscogay: posts small blind $2.50
Rabarber77: posts big blind $5
*** HOLE CARDS ***
BG10141974: folds
evo.com: folds
jjisnoob: folds
sacachispa19: folds
piscogay: folds
Uncalled bet ($2.50) returned to Rabarber77
Rabarber77 collected $5 from pot
Rabarber77: doesn't show hand
*** SUMMARY ***
Total pot $5 | Rake $0
Seat 1: Rabarber77 (big blind) collected ($5)
Seat 2: BG10141974 folded before Flop (didn't bet)
Seat 3: evo.com folded before Flop (didn't bet)
Seat 4: jjisnoob folded before Flop (didn't bet)
Seat 5: sacachispa19 (button) folded before Flop (didn't bet)
Seat 6: piscogay (small blind) folded before Flop


PokerStars Hand #222980765653:  Hold'em No Limit ($2.50/$5.00 USD) - 2021/01/23 19:59:43 ET
Table 'Aaltje II' 6-max Seat #6 is the button
Seat 1: Rabarber77 ($409.78 in chips)
Seat 2: BG10141974 ($407.50 in chips)
Seat 3: evo.com ($534.50 in chips)
Seat 4: jjisnoob ($660.96 in chips)
Seat 5: sacachispa19 ($597.25 in chips)
Seat 6: piscogay ($1334.46 in chips)
Rabarber77: posts small blind $2.50
BG10141974: posts big blind $5
*** HOLE CARDS ***
evo.com: folds
jjisnoob: folds
sacachispa19: folds
piscogay: raises $7.50 to $12.50
Rabarber77: folds
BG10141974: calls $7.50
*** FLOP *** [5d 8c Ah]
BG10141974: checks
piscogay: bets $13.06
BG10141974: folds
Uncalled bet ($13.06) returned to piscogay
piscogay collected $26.12 from pot
piscogay: doesn't show hand
*** SUMMARY ***
Total pot $27.50 | Rake $1.38
Board [5d 8c Ah]
Seat 1: Rabarber77 (small blind) folded before Flop
Seat 2: BG10141974 (big blind) folded on the Flop
Seat 3: evo.com folded before Flop (didn't bet)
Seat 4: jjisnoob folded before Flop (didn't bet)
Seat 5: sacachispa19 folded before Flop (didn't bet)
Seat 6: piscogay (button) collected ($26.12)


PokerStars Hand #222980775720:  Hold'em No Limit ($2.50/$5.00 USD) - 2021/01/23 20:00:10 ET
Table 'Aaltje II' 6-max Seat #1 is the button
Seat 1: Rabarber77 ($407.28 in chips)
Seat 2: BG10141974 ($395 in chips)
Seat 3: evo.com ($534.50 in chips)
Seat 4: jjisnoob ($660.96 in chips)
Seat 5: sacachispa19 ($597.25 in chips)
Seat 6: piscogay ($1348.08 in chips)
BG10141974: posts small blind $2.50
evo.com: posts big blind $5
*** HOLE CARDS ***
jjisnoob: folds
sacachispa19: folds
piscogay: folds
Rabarber77: folds
BG10141974: calls $2.50
evo.com: checks
*** FLOP *** [4h Qd Ac]
BG10141974: checks
evo.com: checks
*** TURN *** [4h Qd Ac] [5h]
BG10141974: checks
evo.com: bets $6.65
BG10141974: folds
Uncalled bet ($6.65) returned to evo.com
evo.com collected $9.50 from pot
*** SUMMARY ***
Total pot $10 | Rake $0.50
Board [4h Qd Ac 5h]
Seat 1: Rabarber77 (button) folded before Flop (didn't bet)
Seat 2: BG10141974 (small blind) folded on the Turn
Seat 3: evo.com (big blind) collected ($9.50)
Seat 4: jjisnoob folded before Flop (didn't bet)
Seat 5: sacachispa19 folded before Flop (didn't bet)
Seat 6: piscogay folded before Flop (didn't bet)


PokerStars Hand #222980794177:  Hold'em No Limit ($2.50/$5.00 USD) - 2021/01/23 20:00:55 ET
Table 'Aaltje II' 6-max Seat #2 is the button
Seat 1: Rabarber77 ($407.28 in chips)
Seat 2: BG10141974 ($390 in chips)
Seat 3: evo.com ($539 in chips)
Seat 4: jjisnoob ($660.96 in chips)
Seat 5: sacachispa19 ($597.25 in chips)
Seat 6: piscogay ($1348.08 in chips)
evo.com: posts small blind $2.50
jjisnoob: posts big blind $5
*** HOLE CARDS ***
sacachispa19: folds
piscogay: folds
Rabarber77: folds
BG10141974: raises $7.50 to $12.50
evo.com: folds
jjisnoob: calls $7.50
*** FLOP *** [Th Qd 8c]
jjisnoob: checks
BG10141974: bets $13.06
jjisnoob: calls $13.06
*** TURN *** [Th Qd 8c] [6c]
jjisnoob: checks
BG10141974: checks
*** RIVER *** [Th Qd 8c 6c] [Qs]
jjisnoob: checks
BG10141974: checks
*** SHOW DOWN ***
jjisnoob: shows [As 9c] (a pair of Queens)
BG10141974: mucks hand
jjisnoob collected $50.94 from pot
*** SUMMARY ***
Total pot $53.62 | Rake $2.68
Board [Th Qd 8c 6c Qs]
Seat 1: Rabarber77 folded before Flop (didn't bet)
Seat 2: BG10141974 (button) mucked
Seat 3: evo.com (small blind) folded before Flop
Seat 4: jjisnoob (big blind) showed [As 9c] and won ($50.94) with a pair of Queens
Seat 5: sacachispa19 folded before Flop (didn't bet)
Seat 6: piscogay folded before Flop (didn't bet)


PokerStars Hand #222980821423:  Hold'em No Limit ($2.50/$5.00 USD) - 2021/01/23 20:01:57 ET
Table 'Aaltje II' 6-max Seat #3 is the button
Seat 1: Rabarber77 ($407.28 in chips)
Seat 2: BG10141974 ($364.44 in chips)
Seat 3: evo.com ($536.50 in chips)
Seat 4: jjisnoob ($686.34 in chips)
Seat 5: sacachispa19 ($597.25 in chips)
Seat 6: piscogay ($1348.08 in chips)
jjisnoob: posts small blind $2.50
sacachispa19: posts big blind $5
*** HOLE CARDS ***
piscogay: folds
Rabarber77: folds
BG10141974: folds
BG10141974 leaves the table
evo.com: folds
jjisnoob: raises $11.50 to $16.50
sacachispa19: folds
Uncalled bet ($11.50) returned to jjisnoob
jjisnoob collected $10 from pot
jjisnoob: doesn't show hand
*** SUMMARY ***
Total pot $10 | Rake $0
Seat 1: Rabarber77 folded before Flop (didn't bet)
Seat 2: BG10141974 folded before Flop (didn't bet)
Seat 3: evo.com (button) folded before Flop (didn't bet)
Seat 4: jjisnoob (small blind) collected ($10)
Seat 5: sacachispa19 (big blind) folded before Flop
Seat 6: piscogay folded before Flop (didn't bet)


PokerStars Hand #222980829380:  Hold'em No Limit ($2.50/$5.00 USD) - 2021/01/23 20:02:14 ET
Table 'Aaltje II' 6-max Seat #4 is the button
Seat 1: Rabarber77 ($407.28 in chips)
Seat 3: evo.com ($536.50 in chips)
Seat 4: jjisnoob ($691.34 in chips)
Seat 5: sacachispa19 ($592.25 in chips)
Seat 6: piscogay ($1348.08 in chips)
sacachispa19: posts small blind $2.50
piscogay: posts big blind $5
*** HOLE CARDS ***
Rabarber77: folds
evo.com: raises $6 to $11
jjisnoob: folds
sacachispa19: folds
piscogay: folds
Uncalled bet ($6) returned to evo.com
evo.com collected $12.50 from pot
*** SUMMARY ***
Total pot $12.50 | Rake $0
Seat 1: Rabarber77 folded before Flop (didn't bet)
Seat 3: evo.com collected ($12.50)
Seat 4: jjisnoob (button) folded before Flop (didn't bet)
Seat 5: sacachispa19 (small blind) folded before Flop
Seat 6: piscogay (big blind) folded before Flop


PokerStars Hand #222980837191:  Hold'em No Limit ($2.50/$5.00 USD) - 2021/01/23 20:02:31 ET
Table 'Aaltje II' 6-max Seat #5 is the button
Seat 1: Rabarber77 ($407.28 in chips)
Seat 3: evo.com ($544 in chips)
Seat 4: jjisnoob ($691.34 in chips)
Seat 5: sacachispa19 ($589.75 in chips)
Seat 6: piscogay ($1343.08 in chips)
piscogay: posts small blind $2.50
Rabarber77: posts big blind $5
*** HOLE CARDS ***
evo.com: raises $6 to $11
jjisnoob: folds
sacachispa19: folds
piscogay: calls $8.50
Rabarber77: calls $6
*** FLOP *** [8c 4s 4d]
piscogay: checks
LongdonLarry joins the table at seat #2
Rabarber77: bets $25
evo.com: folds
piscogay: folds
Uncalled bet ($25) returned to Rabarber77
Rabarber77 collected $31.35 from pot
Rabarber77: doesn't show hand
*** SUMMARY ***
Total pot $33 | Rake $1.65
Board [8c 4s 4d]
Seat 1: Rabarber77 (big blind) collected ($31.35)
Seat 3: evo.com folded on the Flop
Seat 4: jjisnoob folded before Flop (didn't bet)
Seat 5: sacachispa19 (button) folded before Flop (didn't bet)
Seat 6: piscogay (small blind) folded on the Flop


PokerStars Hand #222980854488:  Hold'em No Limit ($2.50/$5.00 USD) - 2021/01/23 20:03:09 ET
Table 'Aaltje II' 6-max Seat #6 is the button
Seat 1: Rabarber77 ($427.63 in chips)
Seat 2: LongdonLarry ($200 in chips)
Seat 3: evo.com ($533 in chips)
Seat 4: jjisnoob ($691.34 in chips)
Seat 5: sacachispa19 ($589.75 in chips)
Seat 6: piscogay ($1332.08 in chips)
Rabarber77: posts small blind $2.50
LongdonLarry: posts big blind $5
*** HOLE CARDS ***
evo.com: folds
jjisnoob: folds
sacachispa19: folds
piscogay: raises $7.50 to $12.50
Rabarber77: folds
LongdonLarry: folds
Uncalled bet ($7.50) returned to piscogay
piscogay collected $12.50 from pot
piscogay: doesn't show hand
*** SUMMARY ***
Total pot $12.50 | Rake $0
Seat 1: Rabarber77 (small blind) folded before Flop
Seat 2: LongdonLarry (big blind) folded before Flop
Seat 3: evo.com folded before Flop (didn't bet)
Seat 4: jjisnoob folded before Flop (didn't bet)
Seat 5: sacachispa19 folded before Flop (didn't bet)
Seat 6: piscogay (button) collected ($12.50)


PokerStars Hand #222980867065:  Hold'em No Limit ($2.50/$5.00 USD) - 2021/01/23 20:03:29 ET
Table 'Aaltje II' 6-max Seat #1 is the button
Seat 1: Rabarber77 ($425.13 in chips)
Seat 2: LongdonLarry ($200 in chips)
Seat 3: evo.com ($533 in chips)
Seat 4: jjisnoob ($691.34 in chips)
Seat 5: sacachispa19 ($589.75 in chips)
Seat 6: piscogay ($1339.58 in chips)
LongdonLarry: posts small blind $2.50
evo.com: posts big blind $5
*** HOLE CARDS ***
jjisnoob: folds
sacachispa19: raises $7.50 to $12.50
piscogay: calls $12.50
Rabarber77: folds
LongdonLarry: folds
evo.com: raises $52.50 to $65
sacachispa19: folds
piscogay: folds
Uncalled bet ($52.50) returned to evo.com
evo.com collected $40 from pot
*** SUMMARY ***
Total pot $40 | Rake $0
Seat 1: Rabarber77 (button) folded before Flop (didn't bet)
Seat 2: LongdonLarry (small blind) folded before Flop
Seat 3: evo.com (big blind) collected ($40)
Seat 4: jjisnoob folded before Flop (didn't bet)
Seat 5: sacachispa19 folded before Flop
Seat 6: piscogay folded before Flop


PokerStars Hand #222980882541:  Hold'em No Limit ($2.50/$5.00 USD) - 2021/01/23 20:04:03 ET
Table 'Aaltje II' 6-max Seat #2 is the button
Seat 1: Rabarber77 ($425.13 in chips)
Seat 2: LongdonLarry ($200 in chips)
Seat 3: evo.com ($560.50 in chips)
Seat 4: jjisnoob ($691.34 in chips)
Seat 5: sacachispa19 ($577.25 in chips)
Seat 6: piscogay ($1327.08 in chips)
evo.com: posts small blind $2.50
jjisnoob: posts big blind $5
*** HOLE CARDS ***
sacachispa19: folds
piscogay: folds
Rabarber77: raises $10 to $15
LongdonLarry: folds
evo.com: folds
jjisnoob: calls $10
*** FLOP *** [8s 2d 5d]
jjisnoob: checks
Rabarber77: bets $20
jjisnoob: folds
Uncalled bet ($20) returned to Rabarber77
Rabarber77 collected $30.88 from pot
Rabarber77: doesn't show hand
*** SUMMARY ***
Total pot $32.50 | Rake $1.62
Board [8s 2d 5d]
Seat 1: Rabarber77 collected ($30.88)
Seat 2: LongdonLarry (button) folded before Flop (didn't bet)
Seat 3: evo.com (small blind) folded before Flop
Seat 4: jjisnoob (big blind) folded on the Flop
Seat 5: sacachispa19 folded before Flop (didn't bet)
Seat 6: piscogay folded before Flop (didn't bet)


PokerStars Hand #222980921644:  Hold'em No Limit ($2.50/$5.00 USD) - 2021/01/23 20:05:14 ET
Table 'Aaltje II' 6-max Seat #3 is the button
Seat 1: Rabarber77 ($441.01 in chips)
Seat 2: LongdonLarry ($200 in chips)
Seat 3: evo.com ($558 in chips)
Seat 4: jjisnoob ($676.34 in chips)
Seat 6: piscogay ($1327.08 in chips)
jjisnoob: posts small blind $2.50
piscogay: posts big blind $5
*** HOLE CARDS ***
Rabarber77: folds
LongdonLarry: folds
evo.com: folds
jjisnoob: folds
Uncalled bet ($2.50) returned to piscogay
piscogay collected $5 from pot
piscogay: doesn't show hand
*** SUMMARY ***
Total pot $5 | Rake $0
Seat 1: Rabarber77 folded before Flop (didn't bet)
Seat 2: LongdonLarry folded before Flop (didn't bet)
Seat 3: evo.com (button) folded before Flop (didn't bet)
Seat 4: jjisnoob (small blind) folded before Flop
Seat 6: piscogay (big blind) collected ($5)


PokerStars Hand #222980925649:  Hold'em No Limit ($2.50/$5.00 USD) - 2021/01/23 20:05:22 ET
Table 'Aaltje II' 6-max Seat #4 is the button
Seat 1: Rabarber77 ($441.01 in chips)
Seat 2: LongdonLarry ($200 in chips)
Seat 3: evo.com ($558 in chips)
Seat 4: jjisnoob ($673.84 in chips)
Seat 6: piscogay ($1329.58 in chips)
piscogay: posts small blind $2.50
Rabarber77: posts big blind $5
*** HOLE CARDS ***
LongdonLarry: folds
evo.com: folds
jjisnoob: folds
piscogay: folds
Uncalled bet ($2.50) returned to Rabarber77
Rabarber77 collected $5 from pot
Rabarber77: doesn't show hand
*** SUMMARY ***
Total pot $5 | Rake $0
Seat 1: Rabarber77 (big blind) collected ($5)
Seat 2: LongdonLarry folded before Flop (didn't bet)
Seat 3: evo.com folded before Flop (didn't bet)
Seat 4: jjisnoob (button) folded before Flop (didn't bet)
Seat 6: piscogay (small blind) folded before Flop


PokerStars Hand #222980930853:  Hold'em No Limit ($2.50/$5.00 USD) - 2021/01/23 20:05:34 ET
Table 'Aaltje II' 6-max Seat #6 is the button
Seat 1: Rabarber77 ($443.51 in chips)
Seat 2: LongdonLarry ($200 in chips)
Seat 3: evo.com ($558 in chips)
Seat 4: jjisnoob ($673.84 in chips)
Seat 6: piscogay ($1327.08 in chips)
Rabarber77: posts small blind $2.50
LongdonLarry: posts big blind $5
*** HOLE CARDS ***
evo.com: folds
jjisnoob: folds
piscogay: raises $7.50 to $12.50
Rabarber77: calls $10
LongdonLarry: calls $7.50
*** FLOP *** [Ad Ts 6c]
Rabarber77: checks
LongdonLarry: checks
piscogay: checks
*** TURN *** [Ad Ts 6c] [5c]
Rabarber77: bets $25
LongdonLarry: folds
piscogay: calls $25
*** RIVER *** [Ad Ts 6c 5c] [Qh]
Rabarber77: bets $65
piscogay: calls $65
*** SHOW DOWN ***
Rabarber77: shows [Td Qs] (two pair, Queens and Tens)
piscogay: mucks hand
Rabarber77 collected $214.50 from pot
*** SUMMARY ***
Total pot $217.50 | Rake $3
Board [Ad Ts 6c 5c Qh]
Seat 1: Rabarber77 (small blind) showed [Td Qs] and won ($214.50) with two pair, Queens and Tens
Seat 2: LongdonLarry (big blind) folded on the Turn
Seat 3: evo.com folded before Flop (didn't bet)
Seat 4: jjisnoob folded before Flop (didn't bet)
Seat 6: piscogay (button) mucked


PokerStars Hand #222980960717:  Hold'em No Limit ($2.50/$5.00 USD) - 2021/01/23 20:06:38 ET
Table 'Aaltje II' 6-max Seat #1 is the button
Seat 1: Rabarber77 ($555.51 in chips)
Seat 2: LongdonLarry ($200 in chips)
Seat 3: evo.com ($558 in chips)
Seat 4: jjisnoob ($673.84 in chips)
Seat 6: piscogay ($1224.58 in chips)
LongdonLarry: posts small blind $2.50
evo.com: posts big blind $5
*** HOLE CARDS ***
jjisnoob: folds
piscogay: folds
Rabarber77: raises $5 to $10
LongdonLarry: folds
evo.com: calls $5
*** FLOP *** [Ts 8d As]
evo.com: checks
Rabarber77: bets $10
evo.com: folds
Uncalled bet ($10) returned to Rabarber77
Rabarber77 collected $21.38 from pot
Rabarber77: doesn't show hand
*** SUMMARY ***
Total pot $22.50 | Rake $1.12
Board [Ts 8d As]
Seat 1: Rabarber77 (button) collected ($21.38)
Seat 2: LongdonLarry (small blind) folded before Flop
Seat 3: evo.com (big blind) folded on the Flop
Seat 4: jjisnoob folded before Flop (didn't bet)
Seat 6: piscogay folded before Flop (didn't bet)


PokerStars Hand #222980980404:  Hold'em No Limit ($2.50/$5.00 USD) - 2021/01/23 20:07:20 ET
Table 'Aaltje II' 6-max Seat #2 is the button
Seat 1: Rabarber77 ($566.89 in chips)
Seat 2: LongdonLarry ($200 in chips)
Seat 3: evo.com ($548 in chips)
Seat 4: jjisnoob ($673.84 in chips)
Seat 6: piscogay ($1224.58 in chips)
evo.com: posts small blind $2.50
jjisnoob: posts big blind $5
*** HOLE CARDS ***
piscogay: raises $7.50 to $12.50
Rabarber77: folds
LongdonLarry: folds
evo.com: folds
jjisnoob: folds
Uncalled bet ($7.50) returned to piscogay
piscogay collected $12.50 from pot
piscogay: doesn't show hand
*** SUMMARY ***
Total pot $12.50 | Rake $0
Seat 1: Rabarber77 folded before Flop (didn't bet)
Seat 2: LongdonLarry (button) folded before Flop (didn't bet)
Seat 3: evo.com (small blind) folded before Flop
Seat 4: jjisnoob (big blind) folded before Flop
Seat 6: piscogay collected ($12.50)


PokerStars Hand #222980990949:  Hold'em No Limit ($2.50/$5.00 USD) - 2021/01/23 20:07:43 ET
Table 'Aaltje II' 6-max Seat #3 is the button
Seat 1: Rabarber77 ($566.89 in chips)
Seat 2: LongdonLarry ($200 in chips)
Seat 3: evo.com ($545.50 in chips)
Seat 4: jjisnoob ($668.84 in chips)
Seat 6: piscogay ($1232.08 in chips)
jjisnoob: posts small blind $2.50
piscogay: posts big blind $5
*** HOLE CARDS ***
Rabarber77: folds
LongdonLarry: folds
evo.com: folds
jjisnoob: folds
Uncalled bet ($2.50) returned to piscogay
piscogay collected $5 from pot
piscogay: doesn't show hand
*** SUMMARY ***
Total pot $5 | Rake $0
Seat 1: Rabarber77 folded before Flop (didn't bet)
Seat 2: LongdonLarry folded before Flop (didn't bet)
Seat 3: evo.com (button) folded before Flop (didn't bet)
Seat 4: jjisnoob (small blind) folded before Flop
Seat 6: piscogay (big blind) collected ($5)


PokerStars Hand #222981000650:  Hold'em No Limit ($2.50/$5.00 USD) - 2021/01/23 20:08:04 ET
Table 'Aaltje II' 6-max Seat #4 is the button
Seat 1: Rabarber77 ($566.89 in chips)
Seat 2: LongdonLarry ($200 in chips)
Seat 3: evo.com ($545.50 in chips)
Seat 4: jjisnoob ($666.34 in chips)
Seat 6: piscogay ($1234.58 in chips)
piscogay: posts small blind $2.50
Rabarber77: posts big blind $5
*** HOLE CARDS ***
LongdonLarry: folds
evo.com: folds
jjisnoob: folds
piscogay: folds
Uncalled bet ($2.50) returned to Rabarber77
Rabarber77 collected $5 from pot
Rabarber77: doesn't show hand
*** SUMMARY ***
Total pot $5 | Rake $0
Seat 1: Rabarber77 (big blind) collected ($5)
Seat 2: LongdonLarry folded before Flop (didn't bet)
Seat 3: evo.com folded before Flop (didn't bet)
Seat 4: jjisnoob (button) folded before Flop (didn't bet)
Seat 6: piscogay (small blind) folded before Flop


PokerStars Hand #222981006678:  Hold'em No Limit ($2.50/$5.00 USD) - 2021/01/23 20:08:18 ET
Table 'Aaltje II' 6-max Seat #6 is the button
Seat 1: Rabarber77 ($569.39 in chips)
Seat 2: LongdonLarry ($200 in chips)
Seat 3: evo.com ($545.50 in chips)
Seat 4: jjisnoob ($666.34 in chips)
Seat 6: piscogay ($1232.08 in chips)
Rabarber77: posts small blind $2.50
LongdonLarry: posts big blind $5
*** HOLE CARDS ***
evo.com: folds
jjisnoob: folds
piscogay: folds
Rabarber77: calls $2.50
LongdonLarry: raises $15 to $20
Rabarber77: calls $15
*** FLOP *** [As Qs 2c]
Rabarber77: checks
LongdonLarry: bets $19
Rabarber77: calls $19
*** TURN *** [As Qs 2c] [2h]
Rabarber77: checks
LongdonLarry: bets $37.50
Rabarber77: folds
Uncalled bet ($37.50) returned to LongdonLarry
LongdonLarry collected $75 from pot
LongdonLarry: doesn't show hand
*** SUMMARY ***
Total pot $78 | Rake $3
Board [As Qs 2c 2h]
Seat 1: Rabarber77 (small blind) folded on the Turn
Seat 2: LongdonLarry (big blind) collected ($75)
Seat 3: evo.com folded before Flop (didn't bet)
Seat 4: jjisnoob folded before Flop (didn't bet)
Seat 6: piscogay (button) folded before Flop (didn't bet)


PokerStars Hand #222981056001:  Hold'em No Limit ($2.50/$5.00 USD) - 2021/01/23 20:09:45 ET
Table 'Aaltje II' 6-max Seat #1 is the button
Seat 1: Rabarber77 ($530.39 in chips)
Seat 2: LongdonLarry ($236 in chips)
Seat 3: evo.com ($545.50 in chips)
Seat 4: jjisnoob ($666.34 in chips)
Seat 6: piscogay ($1232.08 in chips)
LongdonLarry: posts small blind $2.50
evo.com: posts big blind $5
*** HOLE CARDS ***
jjisnoob: folds
piscogay: folds
Rabarber77: folds
LongdonLarry: folds
Uncalled bet ($2.50) returned to evo.com
evo.com collected $5 from pot
*** SUMMARY ***
Total pot $5 | Rake $0
Seat 1: Rabarber77 (button) folded before Flop (didn't bet)
Seat 2: LongdonLarry (small blind) folded before Flop
Seat 3: evo.com (big blind) collected ($5)
Seat 4: jjisnoob folded before Flop (didn't bet)
Seat 6: piscogay folded before Flop (didn't bet)


PokerStars Hand #222981077819:  Hold'em No Limit ($2.50/$5.00 USD) - 2021/01/23 20:10:33 ET
Table 'Aaltje II' 6-max Seat #3 is the button
Seat 1: Rabarber77 ($537.89 in chips)
Seat 2: LongdonLarry ($233.50 in chips)
Seat 3: evo.com ($545.50 in chips)
Seat 4: jjisnoob ($661.34 in chips)
Seat 6: piscogay ($1232.08 in chips)
jjisnoob: posts small blind $2.50
piscogay: posts big blind $5
*** HOLE CARDS ***
Rabarber77: folds
LongdonLarry: folds
evo.com: raises $6 to $11
jjisnoob: calls $8.50
piscogay: calls $6
*** FLOP *** [6s Ks 7d]
jjisnoob: checks
piscogay: checks
evo.com: checks
*** TURN *** [6s Ks 7d] [8h]
jjisnoob: checks
piscogay: bets $20.90
evo.com: folds
jjisnoob: folds
Uncalled bet ($20.90) returned to piscogay
piscogay collected $31.35 from pot
piscogay: doesn't show hand
*** SUMMARY ***
Total pot $33 | Rake $1.65
Board [6s Ks 7d 8h]
Seat 1: Rabarber77 folded before Flop (didn't bet)
Seat 2: LongdonLarry folded before Flop (didn't bet)
Seat 3: evo.com (button) folded on the Turn
Seat 4: jjisnoob (small blind) folded on the Turn
Seat 6: piscogay (big blind) collected ($31.35)


PokerStars Hand #222981116254:  Hold'em No Limit ($2.50/$5.00 USD) - 2021/01/23 20:11:58 ET
Table 'Aaltje II' 6-max Seat #4 is the button
Seat 1: Rabarber77 ($537.89 in chips)
Seat 2: LongdonLarry ($233.50 in chips)
Seat 3: evo.com ($534.50 in chips)
Seat 4: jjisnoob ($650.34 in chips)
Seat 6: piscogay ($1252.43 in chips)
piscogay: posts small blind $2.50
Rabarber77: posts big blind $5
*** HOLE CARDS ***
LongdonLarry: folds
evo.com: folds
jjisnoob: raises $6.25 to $11.25
piscogay: folds
Rabarber77: folds
Uncalled bet ($6.25) returned to jjisnoob
jjisnoob collected $12.50 from pot
jjisnoob: doesn't show hand
*** SUMMARY ***
Total pot $12.50 | Rake $0
Seat 1: Rabarber77 (big blind) folded before Flop
Seat 2: LongdonLarry folded before Flop (didn't bet)
Seat 3: evo.com folded before Flop (didn't bet)
Seat 4: jjisnoob (button) collected ($12.50)
Seat 6: piscogay (small blind) folded before Flop


PokerStars Hand #222981121235:  Hold'em No Limit ($2.50/$5.00 USD) - 2021/01/23 20:12:09 ET
Table 'Aaltje II' 6-max Seat #6 is the button
Seat 1: Rabarber77 ($532.89 in chips)
Seat 2: LongdonLarry ($233.50 in chips)
Seat 3: evo.com ($534.50 in chips)
Seat 4: jjisnoob ($657.84 in chips)
Seat 6: piscogay ($1249.93 in chips)
Rabarber77: posts small blind $2.50
LongdonLarry: posts big blind $5
*** HOLE CARDS ***
evo.com: folds
jjisnoob: folds
piscogay: raises $7.50 to $12.50
Rabarber77: folds
LongdonLarry: raises $32.50 to $45
piscogay: folds
Uncalled bet ($32.50) returned to LongdonLarry
LongdonLarry collected $27.50 from pot
LongdonLarry: doesn't show hand
*** SUMMARY ***
Total pot $27.50 | Rake $0
Seat 1: Rabarber77 (small blind) folded before Flop
Seat 2: LongdonLarry (big blind) collected ($27.50)
Seat 3: evo.com folded before Flop (didn't bet)
Seat 4: jjisnoob folded before Flop (didn't bet)
Seat 6: piscogay (button) folded before Flop


PokerStars Hand #222981133309:  Hold'em No Limit ($2.50/$5.00 USD) - 2021/01/23 20:12:36 ET
Table 'Aaltje II' 6-max Seat #1 is the button
Seat 1: Rabarber77 ($530.39 in chips)
Seat 2: LongdonLarry ($248.50 in chips)
Seat 3: evo.com ($534.50 in chips)
Seat 4: jjisnoob ($657.84 in chips)
Seat 6: piscogay ($1237.43 in chips)
LongdonLarry: posts small blind $2.50
evo.com: posts big blind $5
*** HOLE CARDS ***
jjisnoob: folds
piscogay: raises $7.50 to $12.50
Rabarber77: folds
LongdonLarry: folds
evo.com: folds
Uncalled bet ($7.50) returned to piscogay
piscogay collected $12.50 from pot
piscogay: doesn't show hand
*** SUMMARY ***
Total pot $12.50 | Rake $0
Seat 1: Rabarber77 (button) folded before Flop (didn't bet)
Seat 2: LongdonLarry (small blind) folded before Flop
Seat 3: evo.com (big blind) folded before Flop
Seat 4: jjisnoob folded before Flop (didn't bet)
Seat 6: piscogay collected ($12.50)


PokerStars Hand #222981144899:  Hold'em No Limit ($2.50/$5.00 USD) - 2021/01/23 20:13:02 ET
Table 'Aaltje II' 6-max Seat #2 is the button
Seat 1: Rabarber77 ($530.39 in chips)
Seat 2: LongdonLarry ($246 in chips)
Seat 3: evo.com ($529.50 in chips)
Seat 4: jjisnoob ($657.84 in chips)
Seat 6: piscogay ($1244.93 in chips)
evo.com: posts small blind $2.50
jjisnoob: posts big blind $5
*** HOLE CARDS ***
piscogay: folds
Rabarber77: raises $10 to $15
LongdonLarry: folds
evo.com: folds
jjisnoob: folds
Uncalled bet ($10) returned to Rabarber77
Rabarber77 collected $12.50 from pot
Rabarber77: doesn't show hand
*** SUMMARY ***
Total pot $12.50 | Rake $0
Seat 1: Rabarber77 collected ($12.50)
Seat 2: LongdonLarry (button) folded before Flop (didn't bet)
Seat 3: evo.com (small blind) folded before Flop
Seat 4: jjisnoob (big blind) folded before Flop
Seat 6: piscogay folded before Flop (didn't bet)


PokerStars Hand #222981151736:  Hold'em No Limit ($2.50/$5.00 USD) - 2021/01/23 20:13:17 ET
Table 'Aaltje II' 6-max Seat #3 is the button
Seat 1: Rabarber77 ($537.89 in chips)
Seat 2: LongdonLarry ($246 in chips)
Seat 3: evo.com ($527 in chips)
Seat 4: jjisnoob ($652.84 in chips)
Seat 6: piscogay ($1244.93 in chips)
jjisnoob: posts small blind $2.50
piscogay: posts big blind $5
*** HOLE CARDS ***
Rabarber77: folds
LongdonLarry: folds
evo.com: folds
jjisnoob: raises $11.50 to $16.50
piscogay: calls $11.50
*** FLOP *** [3h Qd Ts]
jjisnoob: bets $8.78
piscogay: folds
Uncalled bet ($8.78) returned to jjisnoob
jjisnoob collected $31.35 from pot
sacachispa19 was removed from the table for failing to post
sacachispa19 leaves the table
jjisnoob: doesn't show hand
*** SUMMARY ***
Total pot $33 | Rake $1.65
Board [3h Qd Ts]
Seat 1: Rabarber77 folded before Flop (didn't bet)
Seat 2: LongdonLarry folded before Flop (didn't bet)
Seat 3: evo.com (button) folded before Flop (didn't bet)
Seat 4: jjisnoob (small blind) collected ($31.35)
Seat 6: piscogay (big blind) folded on the Flop


PokerStars Hand #222981166745:  Hold'em No Limit ($2.50/$5.00 USD) - 2021/01/23 20:13:51 ET
Table 'Aaltje II' 6-max Seat #4 is the button
Seat 1: Rabarber77 ($537.89 in chips)
Seat 2: LongdonLarry ($246 in chips)
Seat 3: evo.com ($527 in chips)
Seat 4: jjisnoob ($667.69 in chips)
Seat 6: piscogay ($1228.43 in chips)
piscogay: posts small blind $2.50
Rabarber77: posts big blind $5
*** HOLE CARDS ***
LongdonLarry: folds
LongdonLarry leaves the table
evo.com: raises $6 to $11
jjisnoob: folds
piscogay: folds
Rabarber77: calls $6
*** FLOP *** [4c Qd 7d]
Rabarber77: checks
evo.com: checks
*** TURN *** [4c Qd 7d] [Ts]
Rabarber77: bets $11.64
ltlnerdoflin joins the table at seat #2
777Koresh777 joins the table at seat #5
evo.com: calls $11.64
*** RIVER *** [4c Qd 7d Ts] [2h]
Rabarber77: checks
evo.com: bets $35
Rabarber77: calls $35
*** SHOW DOWN ***
evo.com: shows [Jd Qh] (a pair of Queens)
Rabarber77: mucks hand
evo.com collected $114.78 from pot
*** SUMMARY ***
Total pot $117.78 | Rake $3
Board [4c Qd 7d Ts 2h]
Seat 1: Rabarber77 (big blind) mucked
Seat 2: LongdonLarry folded before Flop (didn't bet)
Seat 3: evo.com showed [Jd Qh] and won ($114.78) with a pair of Queens
Seat 4: jjisnoob (button) folded before Flop (didn't bet)
Seat 6: piscogay (small blind) folded before Flop


PokerStars Hand #222981199061:  Hold'em No Limit ($2.50/$5.00 USD) - 2021/01/23 20:15:03 ET
Table 'Aaltje II' 6-max Seat #6 is the button
Seat 1: Rabarber77 ($480.25 in chips)
Seat 2: ltlnerdoflin ($247.84 in chips)
Seat 3: evo.com ($584.14 in chips)
Seat 4: jjisnoob ($667.69 in chips)
Seat 6: piscogay ($1225.93 in chips)
Rabarber77: posts small blind $2.50
ltlnerdoflin: posts big blind $5
777Koresh777: sits out
*** HOLE CARDS ***
evo.com: folds
jjisnoob: raises $6.25 to $11.25
piscogay: folds
Rabarber77: folds
ltlnerdoflin: folds
Uncalled bet ($6.25) returned to jjisnoob
jjisnoob collected $12.50 from pot
jjisnoob: doesn't show hand
*** SUMMARY ***
Total pot $12.50 | Rake $0
Seat 1: Rabarber77 (small blind) folded before Flop
Seat 2: ltlnerdoflin (big blind) folded before Flop
Seat 3: evo.com folded before Flop (didn't bet)
Seat 4: jjisnoob collected ($12.50)
Seat 6: piscogay (button) folded before Flop (didn't bet)


PokerStars Hand #222981208063:  Hold'em No Limit ($2.50/$5.00 USD) - 2021/01/23 20:15:23 ET
Table 'Aaltje II' 6-max Seat #1 is the button
Seat 1: Rabarber77 ($477.75 in chips)
Seat 2: ltlnerdoflin ($242.84 in chips)
Seat 3: evo.com ($584.14 in chips)
Seat 4: jjisnoob ($675.19 in chips)
Seat 6: piscogay ($1225.93 in chips)
ltlnerdoflin: posts small blind $2.50
evo.com: posts big blind $5
777Koresh777: sits out
*** HOLE CARDS ***
jjisnoob: raises $6.25 to $11.25
piscogay: calls $11.25
Rabarber77: calls $11.25
ltlnerdoflin: folds
evo.com: folds
*** FLOP *** [5h 6h Ah]
jjisnoob: checks
piscogay: checks
Rabarber77: bets $20
jjisnoob: folds
piscogay: folds
Uncalled bet ($20) returned to Rabarber77
Rabarber77 collected $39.19 from pot
Rabarber77: doesn't show hand
*** SUMMARY ***
Total pot $41.25 | Rake $2.06
Board [5h 6h Ah]
Seat 1: Rabarber77 (button) collected ($39.19)
Seat 2: ltlnerdoflin (small blind) folded before Flop
Seat 3: evo.com (big blind) folded before Flop
Seat 4: jjisnoob folded on the Flop
Seat 6: piscogay folded on the Flop


PokerStars Hand #222981232406:  Hold'em No Limit ($2.50/$5.00 USD) - 2021/01/23 20:16:18 ET
Table 'Aaltje II' 6-max Seat #2 is the button
Seat 1: Rabarber77 ($505.69 in chips)
Seat 2: ltlnerdoflin ($240.34 in chips)
Seat 3: evo.com ($579.14 in chips)
Seat 4: jjisnoob ($663.94 in chips)
Seat 6: piscogay ($1214.68 in chips)
evo.com: posts small blind $2.50
jjisnoob: posts big blind $5
777Koresh777: sits out
*** HOLE CARDS ***
piscogay: folds
Rabarber77: folds
ltlnerdoflin: raises $5 to $10
evo.com: folds
jjisnoob: calls $5
*** FLOP *** [3s Js 6c]
jjisnoob: checks
ltlnerdoflin: bets $7.06
jjisnoob: raises $22.37 to $29.43
ltlnerdoflin: calls $22.37
*** TURN *** [3s Js 6c] [Kh]
jjisnoob: bets $49.37
ltlnerdoflin: calls $49.37
*** RIVER *** [3s Js 6c Kh] [7d]
jjisnoob: bets $575.14 and is all-in
ltlnerdoflin: calls $151.54 and is all-in
Uncalled bet ($423.60) returned to jjisnoob
*** SHOW DOWN ***
jjisnoob: shows [5s 4s] (a straight, Three to Seven)
ltlnerdoflin: shows [Kc 3c] (two pair, Kings and Threes)
jjisnoob collected $480.18 from pot
*** SUMMARY ***
Total pot $483.18 | Rake $3
Board [3s Js 6c Kh 7d]
Seat 1: Rabarber77 folded before Flop (didn't bet)
Seat 2: ltlnerdoflin (button) showed [Kc 3c] and lost with two pair, Kings and Threes
Seat 3: evo.com (small blind) folded before Flop
Seat 4: jjisnoob (big blind) showed [5s 4s] and won ($480.18) with a straight, Three to Seven
Seat 6: piscogay folded before Flop (didn't bet)


PokerStars Hand #222981286664:  Hold'em No Limit ($2.50/$5.00 USD) - 2021/01/23 20:18:21 ET
Table 'Aaltje II' 6-max Seat #3 is the button
Seat 1: Rabarber77 ($505.69 in chips)
Seat 2: ltlnerdoflin ($200 in chips)
Seat 3: evo.com ($576.64 in chips)
Seat 4: jjisnoob ($903.78 in chips)
Seat 5: 777Koresh777 ($535.23 in chips)
Seat 6: piscogay ($1214.68 in chips)
jjisnoob: posts small blind $2.50
777Koresh777: posts big blind $5
*** HOLE CARDS ***
piscogay: folds
Rabarber77: folds
ltlnerdoflin: folds
evo.com: folds
ltlnerdoflin said, "^^"
jjisnoob: folds
Uncalled bet ($2.50) returned to 777Koresh777
777Koresh777 collected $5 from pot
777Koresh777: doesn't show hand
*** SUMMARY ***
Total pot $5 | Rake $0
Seat 1: Rabarber77 folded before Flop (didn't bet)
Seat 2: ltlnerdoflin folded before Flop (didn't bet)
Seat 3: evo.com (button) folded before Flop (didn't bet)
Seat 4: jjisnoob (small blind) folded before Flop
Seat 5: 777Koresh777 (big blind) collected ($5)
Seat 6: piscogay folded before Flop (didn't bet)


PokerStars Hand #222981294979:  Hold'em No Limit ($2.50/$5.00 USD) - 2021/01/23 20:18:40 ET
Table 'Aaltje II' 6-max Seat #4 is the button
Seat 1: Rabarber77 ($505.69 in chips)
Seat 2: ltlnerdoflin ($200 in chips)
Seat 3: evo.com ($576.64 in chips)
Seat 4: jjisnoob ($901.28 in chips)
Seat 5: 777Koresh777 ($537.73 in chips)
Seat 6: piscogay ($1214.68 in chips)
777Koresh777: posts small blind $2.50
piscogay: posts big blind $5
*** HOLE CARDS ***
Rabarber77: folds
ltlnerdoflin: raises $5 to $10
evo.com: folds
jjisnoob: folds
777Koresh777: folds
piscogay: folds
Uncalled bet ($5) returned to ltlnerdoflin
ltlnerdoflin collected $12.50 from pot
ltlnerdoflin: doesn't show hand
*** SUMMARY ***
Total pot $12.50 | Rake $0
Seat 1: Rabarber77 folded before Flop (didn't bet)
Seat 2: ltlnerdoflin collected ($12.50)
Seat 3: evo.com folded before Flop (didn't bet)
Seat 4: jjisnoob (button) folded before Flop (didn't bet)
Seat 5: 777Koresh777 (small blind) folded before Flop
Seat 6: piscogay (big blind) folded before Flop


PokerStars Hand #222981301696:  Hold'em No Limit ($2.50/$5.00 USD) - 2021/01/23 20:18:55 ET
Table 'Aaltje II' 6-max Seat #5 is the button
Seat 1: Rabarber77 ($505.69 in chips)
Seat 2: ltlnerdoflin ($207.50 in chips)
Seat 3: evo.com ($576.64 in chips)
Seat 4: jjisnoob ($901.28 in chips)
Seat 5: 777Koresh777 ($535.23 in chips)
Seat 6: piscogay ($1209.68 in chips)
piscogay: posts small blind $2.50
Rabarber77: posts big blind $5
*** HOLE CARDS ***
ltlnerdoflin: folds
evo.com: folds
jjisnoob: folds
777Koresh777: folds
piscogay: raises $7.50 to $12.50
Rabarber77: folds
Uncalled bet ($7.50) returned to piscogay
piscogay collected $10 from pot
piscogay: doesn't show hand
*** SUMMARY ***
Total pot $10 | Rake $0
Seat 1: Rabarber77 (big blind) folded before Flop
Seat 2: ltlnerdoflin folded before Flop (didn't bet)
Seat 3: evo.com folded before Flop (didn't bet)
Seat 4: jjisnoob folded before Flop (didn't bet)
Seat 5: 777Koresh777 (button) folded before Flop (didn't bet)
Seat 6: piscogay (small blind) collected ($10)


PokerStars Hand #222981310351:  Hold'em No Limit ($2.50/$5.00 USD) - 2021/01/23 20:19:15 ET
Table 'Aaltje II' 6-max Seat #6 is the button
Seat 1: Rabarber77 ($500.69 in chips)
Seat 2: ltlnerdoflin ($207.50 in chips)
Seat 3: evo.com ($576.64 in chips)
Seat 4: jjisnoob ($901.28 in chips)
Seat 5: 777Koresh777 ($535.23 in chips)
Seat 6: piscogay ($1214.68 in chips)
Rabarber77: posts small blind $2.50
ltlnerdoflin: posts big blind $5
*** HOLE CARDS ***
evo.com: folds
jjisnoob: folds
777Koresh777: folds
piscogay: folds
Rabarber77: folds
Uncalled bet ($2.50) returned to ltlnerdoflin
ltlnerdoflin collected $5 from pot
ltlnerdoflin: doesn't show hand
*** SUMMARY ***
Total pot $5 | Rake $0
Seat 1: Rabarber77 (small blind) folded before Flop
Seat 2: ltlnerdoflin (big blind) collected ($5)
Seat 3: evo.com folded before Flop (didn't bet)
Seat 4: jjisnoob folded before Flop (didn't bet)
Seat 5: 777Koresh777 folded before Flop (didn't bet)
Seat 6: piscogay (button) folded before Flop (didn't bet)


PokerStars Hand #222981316518:  Hold'em No Limit ($2.50/$5.00 USD) - 2021/01/23 20:19:29 ET
Table 'Aaltje II' 6-max Seat #1 is the button
Seat 1: Rabarber77 ($498.19 in chips)
Seat 2: ltlnerdoflin ($210 in chips)
Seat 3: evo.com ($576.64 in chips)
Seat 4: jjisnoob ($901.28 in chips)
Seat 5: 777Koresh777 ($535.23 in chips)
Seat 6: piscogay ($1214.68 in chips)
ltlnerdoflin: posts small blind $2.50
evo.com: posts big blind $5
*** HOLE CARDS ***
jjisnoob: folds
777Koresh777: folds
piscogay: folds
Rabarber77: folds
ltlnerdoflin: raises $7.50 to $12.50
evo.com: folds
Uncalled bet ($7.50) returned to ltlnerdoflin
ltlnerdoflin collected $10 from pot
ltlnerdoflin: doesn't show hand
*** SUMMARY ***
Total pot $10 | Rake $0
Seat 1: Rabarber77 (button) folded before Flop (didn't bet)
Seat 2: ltlnerdoflin (small blind) collected ($10)
Seat 3: evo.com (big blind) folded before Flop
Seat 4: jjisnoob folded before Flop (didn't bet)
Seat 5: 777Koresh777 folded before Flop (didn't bet)
Seat 6: piscogay folded before Flop (didn't bet)


PokerStars Hand #222981322520:  Hold'em No Limit ($2.50/$5.00 USD) - 2021/01/23 20:19:43 ET
Table 'Aaltje II' 6-max Seat #2 is the button
Seat 1: Rabarber77 ($498.19 in chips)
Seat 2: ltlnerdoflin ($215 in chips)
Seat 3: evo.com ($571.64 in chips)
Seat 4: jjisnoob ($901.28 in chips)
Seat 5: 777Koresh777 ($535.23 in chips)
Seat 6: piscogay ($1214.68 in chips)
evo.com: posts small blind $2.50
jjisnoob: posts big blind $5
*** HOLE CARDS ***
777Koresh777: raises $7.20 to $12.20
piscogay: folds
Rabarber77: folds
ltlnerdoflin: raises $31.90 to $44.10
evo.com: raises $60.90 to $105
jjisnoob: folds
777Koresh777: folds
ltlnerdoflin: folds
Uncalled bet ($60.90) returned to evo.com
evo.com collected $105.40 from pot
*** SUMMARY ***
Total pot $105.40 | Rake $0
Seat 1: Rabarber77 folded before Flop (didn't bet)
Seat 2: ltlnerdoflin (button) folded before Flop
Seat 3: evo.com (small blind) collected ($105.40)
Seat 4: jjisnoob (big blind) folded before Flop
Seat 5: 777Koresh777 folded before Flop
Seat 6: piscogay folded before Flop (didn't bet)


PokerStars Hand #222981337975:  Hold'em No Limit ($2.50/$5.00 USD) - 2021/01/23 20:20:19 ET
Table 'Aaltje II' 6-max Seat #3 is the button
Seat 1: Rabarber77 ($498.19 in chips)
Seat 2: ltlnerdoflin ($170.90 in chips)
Seat 3: evo.com ($632.94 in chips)
Seat 4: jjisnoob ($896.28 in chips)
Seat 6: piscogay ($1214.68 in chips)
jjisnoob: posts small blind $2.50
777Koresh777: is sitting out
piscogay: posts big blind $5
*** HOLE CARDS ***
Rabarber77: folds
ltlnerdoflin: folds
evo.com: raises $6 to $11
jjisnoob: folds
piscogay: folds
Uncalled bet ($6) returned to evo.com
evo.com collected $12.50 from pot
*** SUMMARY ***
Total pot $12.50 | Rake $0
Seat 1: Rabarber77 folded before Flop (didn't bet)
Seat 2: ltlnerdoflin folded before Flop (didn't bet)
Seat 3: evo.com (button) collected ($12.50)
Seat 4: jjisnoob (small blind) folded before Flop
Seat 6: piscogay (big blind) folded before Flop


PokerStars Hand #222981345790:  Hold'em No Limit ($2.50/$5.00 USD) - 2021/01/23 20:20:36 ET
Table 'Aaltje II' 6-max Seat #4 is the button
Seat 1: Rabarber77 ($498.19 in chips)
Seat 2: ltlnerdoflin ($170.90 in chips)
Seat 3: evo.com ($640.44 in chips)
Seat 4: jjisnoob ($893.78 in chips)
Seat 6: piscogay ($1209.68 in chips)
piscogay: posts small blind $2.50
Rabarber77: posts big blind $5
*** HOLE CARDS ***
ltlnerdoflin: folds
evo.com: raises $6 to $11
jjisnoob: folds
piscogay: calls $8.50
Rabarber77: calls $6
*** FLOP *** [Tc 6h 2s]
piscogay: checks
Rabarber77: checks
evo.com: checks
*** TURN *** [Tc 6h 2s] [Kc]
piscogay: checks
Rabarber77: checks
evo.com: checks
*** RIVER *** [Tc 6h 2s Kc] [Jc]
piscogay: checks
Rabarber77: checks
evo.com: bets $9.41
piscogay: folds
Rabarber77: folds
Uncalled bet ($9.41) returned to evo.com
evo.com collected $31.35 from pot
*** SUMMARY ***
Total pot $33 | Rake $1.65
Board [Tc 6h 2s Kc Jc]
Seat 1: Rabarber77 (big blind) folded on the River
Seat 2: ltlnerdoflin folded before Flop (didn't bet)
Seat 3: evo.com collected ($31.35)
Seat 4: jjisnoob (button) folded before Flop (didn't bet)
Seat 6: piscogay (small blind) folded on the River


PokerStars Hand #222981371405:  Hold'em No Limit ($2.50/$5.00 USD) - 2021/01/23 20:21:35 ET
Table 'Aaltje II' 6-max Seat #6 is the button
Seat 1: Rabarber77 ($487.19 in chips)
Seat 2: ltlnerdoflin ($170.90 in chips)
Seat 3: evo.com ($660.79 in chips)
Seat 4: jjisnoob ($893.78 in chips)
Seat 6: piscogay ($1198.68 in chips)
Rabarber77: posts small blind $2.50
ltlnerdoflin: posts big blind $5
*** HOLE CARDS ***
evo.com: folds
jjisnoob: folds
piscogay: folds
Rabarber77: folds
Uncalled bet ($2.50) returned to ltlnerdoflin
ltlnerdoflin collected $5 from pot
ltlnerdoflin: doesn't show hand
*** SUMMARY ***
Total pot $5 | Rake $0
Seat 1: Rabarber77 (small blind) folded before Flop
Seat 2: ltlnerdoflin (big blind) collected ($5)
Seat 3: evo.com folded before Flop (didn't bet)
Seat 4: jjisnoob folded before Flop (didn't bet)
Seat 6: piscogay (button) folded before Flop (didn't bet)


PokerStars Hand #222981378455:  Hold'em No Limit ($2.50/$5.00 USD) - 2021/01/23 20:21:51 ET
Table 'Aaltje II' 6-max Seat #1 is the button
Seat 1: Rabarber77 ($484.69 in chips)
Seat 2: ltlnerdoflin ($173.40 in chips)
Seat 3: evo.com ($660.79 in chips)
Seat 4: jjisnoob ($893.78 in chips)
Seat 6: piscogay ($1198.68 in chips)
ltlnerdoflin: posts small blind $2.50
evo.com: posts big blind $5
*** HOLE CARDS ***
jjisnoob: folds
piscogay: raises $7.50 to $12.50
Rabarber77: folds
ltlnerdoflin: raises $160.90 to $173.40 and is all-in
evo.com: folds
piscogay: folds
Uncalled bet ($160.90) returned to ltlnerdoflin
ltlnerdoflin collected $30 from pot
ltlnerdoflin: doesn't show hand
*** SUMMARY ***
Total pot $30 | Rake $0
Seat 1: Rabarber77 (button) folded before Flop (didn't bet)
Seat 2: ltlnerdoflin (small blind) collected ($30)
Seat 3: evo.com (big blind) folded before Flop
Seat 4: jjisnoob folded before Flop (didn't bet)
Seat 6: piscogay folded before Flop


PokerStars Hand #222981393062:  Hold'em No Limit ($2.50/$5.00 USD) - 2021/01/23 20:22:25 ET
Table 'Aaltje II' 6-max Seat #2 is the button
Seat 1: Rabarber77 ($484.69 in chips)
Seat 2: ltlnerdoflin ($190.90 in chips)
Seat 3: evo.com ($655.79 in chips)
Seat 4: jjisnoob ($893.78 in chips)
Seat 6: piscogay ($1186.18 in chips)
evo.com: posts small blind $2.50
jjisnoob: posts big blind $5
*** HOLE CARDS ***
piscogay: raises $7.50 to $12.50
Rabarber77: folds
ltlnerdoflin: folds
evo.com: folds
jjisnoob: folds
Uncalled bet ($7.50) returned to piscogay
piscogay collected $12.50 from pot
piscogay: doesn't show hand
*** SUMMARY ***
Total pot $12.50 | Rake $0
Seat 1: Rabarber77 folded before Flop (didn't bet)
Seat 2: ltlnerdoflin (button) folded before Flop (didn't bet)
Seat 3: evo.com (small blind) folded before Flop
Seat 4: jjisnoob (big blind) folded before Flop
Seat 6: piscogay collected ($12.50)


PokerStars Hand #222981398917:  Hold'em No Limit ($2.50/$5.00 USD) - 2021/01/23 20:22:38 ET
Table 'Aaltje II' 6-max Seat #3 is the button
Seat 1: Rabarber77 ($484.69 in chips)
Seat 2: ltlnerdoflin ($190.90 in chips)
Seat 3: evo.com ($653.29 in chips)
Seat 4: jjisnoob ($888.78 in chips)
Seat 6: piscogay ($1193.68 in chips)
jjisnoob: posts small blind $2.50
piscogay: posts big blind $5
*** HOLE CARDS ***
Rabarber77: raises $10 to $15
ltlnerdoflin: folds
evo.com: folds
jjisnoob: raises $50 to $65
piscogay: folds
Rabarber77: calls $50
*** FLOP *** [Th Qc 6s]
jjisnoob: bets $36.96
Rabarber77: calls $36.96
*** TURN *** [Th Qc 6s] [9d]
jjisnoob: checks
Rabarber77: bets $102.96
jjisnoob: folds
Uncalled bet ($102.96) returned to Rabarber77
Rabarber77 collected $205.92 from pot
Rabarber77: doesn't show hand
*** SUMMARY ***
Total pot $208.92 | Rake $3
Board [Th Qc 6s 9d]
Seat 1: Rabarber77 collected ($205.92)
Seat 2: ltlnerdoflin folded before Flop (didn't bet)
Seat 3: evo.com (button) folded before Flop (didn't bet)
Seat 4: jjisnoob (small blind) folded on the Turn
Seat 6: piscogay (big blind) folded before Flop


PokerStars Hand #222981437670:  Hold'em No Limit ($2.50/$5.00 USD) - 2021/01/23 20:24:01 ET
Table 'Aaltje II' 6-max Seat #4 is the button
Seat 1: Rabarber77 ($588.65 in chips)
Seat 2: ltlnerdoflin ($190.90 in chips)
Seat 3: evo.com ($653.29 in chips)
Seat 4: jjisnoob ($786.82 in chips)
Seat 6: piscogay ($1188.68 in chips)
piscogay: posts small blind $2.50
Rabarber77: posts big blind $5
*** HOLE CARDS ***
ltlnerdoflin: raises $5 to $10
evo.com: folds
jjisnoob: folds
piscogay: calls $7.50
Rabarber77: folds
*** FLOP *** [6h 6d Kh]
piscogay: checks
ltlnerdoflin: bets $7.84
piscogay: folds
Uncalled bet ($7.84) returned to ltlnerdoflin
ltlnerdoflin collected $23.75 from pot
ltlnerdoflin: doesn't show hand
*** SUMMARY ***
Total pot $25 | Rake $1.25
Board [6h 6d Kh]
Seat 1: Rabarber77 (big blind) folded before Flop
Seat 2: ltlnerdoflin collected ($23.75)
Seat 3: evo.com folded before Flop (didn't bet)
Seat 4: jjisnoob (button) folded before Flop (didn't bet)
Seat 6: piscogay (small blind) folded on the Flop


PokerStars Hand #222981452918:  Hold'em No Limit ($2.50/$5.00 USD) - 2021/01/23 20:24:36 ET
Table 'Aaltje II' 6-max Seat #6 is the button
Seat 1: Rabarber77 ($583.65 in chips)
Seat 3: evo.com ($653.29 in chips)
Seat 4: jjisnoob ($786.82 in chips)
Seat 6: piscogay ($1178.68 in chips)
Rabarber77: posts small blind $2.50
ltlnerdoflin: is sitting out
evo.com: posts big blind $5
*** HOLE CARDS ***
jjisnoob: folds
piscogay: folds
Rabarber77: calls $2.50
evo.com: checks
*** FLOP *** [Kc 5c Ah]
ltlnerdoflin leaves the table
Rabarber77: bets $5
evo.com: folds
Uncalled bet ($5) returned to Rabarber77
Rabarber77 collected $9.50 from pot
Rabarber77: doesn't show hand
*** SUMMARY ***
Total pot $10 | Rake $0.50
Board [Kc 5c Ah]
Seat 1: Rabarber77 (small blind) collected ($9.50)
Seat 3: evo.com (big blind) folded on the Flop
Seat 4: jjisnoob folded before Flop (didn't bet)
Seat 6: piscogay (button) folded before Flop (didn't bet)


PokerStars Hand #222981462474:  Hold'em No Limit ($2.50/$5.00 USD) - 2021/01/23 20:24:57 ET
Table 'Aaltje II' 6-max Seat #1 is the button
Seat 1: Rabarber77 ($588.15 in chips)
Seat 3: evo.com ($648.29 in chips)
Seat 4: jjisnoob ($786.82 in chips)
Seat 6: piscogay ($1178.68 in chips)
evo.com: posts small blind $2.50
jjisnoob: posts big blind $5
*** HOLE CARDS ***
piscogay: folds
Rabarber77: folds
evo.com: folds
Uncalled bet ($2.50) returned to jjisnoob
jjisnoob collected $5 from pot
jjisnoob: doesn't show hand
*** SUMMARY ***
Total pot $5 | Rake $0
Seat 1: Rabarber77 (button) folded before Flop (didn't bet)
Seat 3: evo.com (small blind) folded before Flop
Seat 4: jjisnoob (big blind) collected ($5)
Seat 6: piscogay folded before Flop (didn't bet)


PokerStars Hand #222981465756:  Hold'em No Limit ($2.50/$5.00 USD) - 2021/01/23 20:25:05 ET
Table 'Aaltje II' 6-max Seat #3 is the button
Seat 1: Rabarber77 ($588.15 in chips)
Seat 3: evo.com ($645.79 in chips)
Seat 4: jjisnoob ($789.32 in chips)
Seat 6: piscogay ($1178.68 in chips)
jjisnoob: posts small blind $2.50
piscogay: posts big blind $5
*** HOLE CARDS ***
Rabarber77: raises $5 to $10
evo.com: folds
Nutsfit joins the table at seat #2
jjisnoob: folds
piscogay: raises $50 to $60
Rabarber77: folds
Uncalled bet ($50) returned to piscogay
piscogay collected $22.50 from pot
piscogay: doesn't show hand
*** SUMMARY ***
Total pot $22.50 | Rake $0
Seat 1: Rabarber77 folded before Flop
Seat 3: evo.com (button) folded before Flop (didn't bet)
Seat 4: jjisnoob (small blind) folded before Flop
Seat 6: piscogay (big blind) collected ($22.50)


PokerStars Hand #222981478333:  Hold'em No Limit ($2.50/$5.00 USD) - 2021/01/23 20:25:33 ET
Table 'Aaltje II' 6-max Seat #4 is the button
Seat 1: Rabarber77 ($578.15 in chips)
Seat 3: evo.com ($645.79 in chips)
Seat 4: jjisnoob ($786.82 in chips)
Seat 6: piscogay ($1191.18 in chips)
piscogay: posts small blind $2.50
Rabarber77: posts big blind $5
Nutsfit: sits out
*** HOLE CARDS ***
evo.com: raises $6 to $11
jjisnoob: folds
piscogay: calls $8.50
Rabarber77: folds
*** FLOP *** [4d 3c 6s]
piscogay: checks
evo.com: checks
*** TURN *** [4d 3c 6s] [Tc]
piscogay: bets $17.10
evo.com: calls $17.10
*** RIVER *** [4d 3c 6s Tc] [5c]
piscogay: bets $57.50
evo.com: folds
Uncalled bet ($57.50) returned to piscogay
piscogay collected $59.70 from pot
piscogay: doesn't show hand
*** SUMMARY ***
Total pot $61.20 | Rake $1.50
Board [4d 3c 6s Tc 5c]
Seat 1: Rabarber77 (big blind) folded before Flop
Seat 3: evo.com folded on the River
Seat 4: jjisnoob (button) folded before Flop (didn't bet)
Seat 6: piscogay (small blind) collected ($59.70)


PokerStars Hand #222981500712:  Hold'em No Limit ($2.50/$5.00 USD) - 2021/01/23 20:26:24 ET
Table 'Aaltje II' 6-max Seat #6 is the button
Seat 1: Rabarber77 ($573.15 in chips)
Seat 2: Nutsfit ($500 in chips)
Seat 3: evo.com ($617.69 in chips)
Seat 4: jjisnoob ($786.82 in chips)
Seat 6: piscogay ($1222.78 in chips)
Rabarber77: posts small blind $2.50
Nutsfit: posts big blind $5
*** HOLE CARDS ***
evo.com: folds
jjisnoob: folds
piscogay: raises $7.50 to $12.50
Rabarber77: folds
Nutsfit: folds
Uncalled bet ($7.50) returned to piscogay
piscogay collected $12.50 from pot
piscogay: doesn't show hand
*** SUMMARY ***
Total pot $12.50 | Rake $0
Seat 1: Rabarber77 (small blind) folded before Flop
Seat 2: Nutsfit (big blind) folded before Flop
Seat 3: evo.com folded before Flop (didn't bet)
Seat 4: jjisnoob folded before Flop (didn't bet)
Seat 6: piscogay (button) collected ($12.50)


PokerStars Hand #222981506847:  Hold'em No Limit ($2.50/$5.00 USD) - 2021/01/23 20:26:38 ET
Table 'Aaltje II' 6-max Seat #1 is the button
Seat 1: Rabarber77 ($570.65 in chips)
Seat 2: Nutsfit ($500 in chips)
Seat 3: evo.com ($617.69 in chips)
Seat 4: jjisnoob ($786.82 in chips)
Seat 6: piscogay ($1230.28 in chips)
Nutsfit: posts small blind $2.50
evo.com: posts big blind $5
*** HOLE CARDS ***
jjisnoob: folds
piscogay: folds
Rabarber77: folds
Nutsfit: folds
Uncalled bet ($2.50) returned to evo.com
evo.com collected $5 from pot
*** SUMMARY ***
Total pot $5 | Rake $0
Seat 1: Rabarber77 (button) folded before Flop (didn't bet)
Seat 2: Nutsfit (small blind) folded before Flop
Seat 3: evo.com (big blind) collected ($5)
Seat 4: jjisnoob folded before Flop (didn't bet)
Seat 6: piscogay folded before Flop (didn't bet)


PokerStars Hand #222981524679:  Hold'em No Limit ($2.50/$5.00 USD) - 2021/01/23 20:27:02 ET
Table 'Aaltje II' 6-max Seat #2 is the button
Seat 1: Rabarber77 ($570.65 in chips)
Seat 2: Nutsfit ($500 in chips)
Seat 3: evo.com ($620.19 in chips)
Seat 4: jjisnoob ($786.82 in chips)
Seat 6: piscogay ($1230.28 in chips)
evo.com: posts small blind $2.50
jjisnoob: posts big blind $5
*** HOLE CARDS ***
piscogay: folds
Rabarber77: folds
piscogay leaves the table
Nutsfit: raises $7.50 to $12.50
evo.com: raises $35 to $47.50
jjisnoob: folds
Nutsfit: folds
Uncalled bet ($35) returned to evo.com
evo.com collected $30 from pot
z4muz joins the table at seat #6
*** SUMMARY ***
Total pot $30 | Rake $0
Seat 1: Rabarber77 folded before Flop (didn't bet)
Seat 2: Nutsfit (button) folded before Flop
Seat 3: evo.com (small blind) collected ($30)
Seat 4: jjisnoob (big blind) folded before Flop
Seat 6: piscogay folded before Flop (didn't bet)


PokerStars Hand #222981537160:  Hold'em No Limit ($2.50/$5.00 USD) - 2021/01/23 20:27:31 ET
Table 'Aaltje II' 6-max Seat #3 is the button
Seat 1: Rabarber77 ($570.65 in chips)
Seat 2: Nutsfit ($500 in chips)
Seat 3: evo.com ($637.69 in chips)
Seat 4: jjisnoob ($781.82 in chips)
Seat 6: z4muz ($500 in chips)
jjisnoob: posts small blind $2.50
z4muz: posts big blind $5
*** HOLE CARDS ***
Rabarber77: folds
Nutsfit: folds
evo.com: folds
777Koresh777 leaves the table
jjisnoob: folds
Uncalled bet ($2.50) returned to z4muz
z4muz collected $5 from pot
z4muz: doesn't show hand
*** SUMMARY ***
Total pot $5 | Rake $0
Seat 1: Rabarber77 folded before Flop (didn't bet)
Seat 2: Nutsfit folded before Flop (didn't bet)
Seat 3: evo.com (button) folded before Flop (didn't bet)
Seat 4: jjisnoob (small blind) folded before Flop
Seat 6: z4muz (big blind) collected ($5)


PokerStars Hand #222981547865:  Hold'em No Limit ($2.50/$5.00 USD) - 2021/01/23 20:27:56 ET
Table 'Aaltje II' 6-max Seat #4 is the button
Seat 1: Rabarber77 ($570.65 in chips)
Seat 2: Nutsfit ($500 in chips)
Seat 3: evo.com ($637.69 in chips)
Seat 4: jjisnoob ($779.32 in chips)
Seat 6: z4muz ($502.50 in chips)
z4muz: posts small blind $2.50
Rabarber77: posts big blind $5
*** HOLE CARDS ***
Nutsfit: folds
evo.com: folds
jjisnoob: raises $6.25 to $11.25
z4muz: calls $8.75
Rabarber77: calls $6.25
*** FLOP *** [2c Ah Jc]
z4muz: checks
Rabarber77: checks
ST£4LTH joins the table at seat #5
jjisnoob: bets $25.33
z4muz: calls $25.33
Rabarber77: folds
*** TURN *** [2c Ah Jc] [4d]
z4muz: checks
jjisnoob: checks
*** RIVER *** [2c Ah Jc 4d] [4c]
z4muz: bets $25.24
jjisnoob: raises $83.09 to $108.33
z4muz: folds
Uncalled bet ($83.09) returned to jjisnoob
jjisnoob collected $131.89 from pot
jjisnoob: doesn't show hand
*** SUMMARY ***
Total pot $134.89 | Rake $3
Board [2c Ah Jc 4d 4c]
Seat 1: Rabarber77 (big blind) folded on the Flop
Seat 2: Nutsfit folded before Flop (didn't bet)
Seat 3: evo.com folded before Flop (didn't bet)
Seat 4: jjisnoob (button) collected ($131.89)
Seat 6: z4muz (small blind) folded on the River


PokerStars Hand #222981585900:  Hold'em No Limit ($2.50/$5.00 USD) - 2021/01/23 20:29:25 ET
Table 'Aaltje II' 6-max Seat #6 is the button
Seat 1: Rabarber77 ($559.40 in chips)
Seat 2: Nutsfit ($500 in chips)
Seat 3: evo.com ($637.69 in chips)
Seat 4: jjisnoob ($849.39 in chips)
Seat 6: z4muz ($500 in chips)
Rabarber77: posts small blind $2.50
Nutsfit: posts big blind $5
ST£4LTH: sits out
*** HOLE CARDS ***
evo.com: folds
jjisnoob: folds
z4muz: folds
Rabarber77: folds
Uncalled bet ($2.50) returned to Nutsfit
Nutsfit collected $5 from pot
Nutsfit: doesn't show hand
*** SUMMARY ***
Total pot $5 | Rake $0
Seat 1: Rabarber77 (small blind) folded before Flop
Seat 2: Nutsfit (big blind) collected ($5)
Seat 3: evo.com folded before Flop (didn't bet)
Seat 4: jjisnoob folded before Flop (didn't bet)
Seat 6: z4muz (button) folded before Flop (didn't bet)


PokerStars Hand #222981589227:  Hold'em No Limit ($2.50/$5.00 USD) - 2021/01/23 20:29:33 ET
Table 'Aaltje II' 6-max Seat #1 is the button
Seat 1: Rabarber77 ($556.90 in chips)
Seat 2: Nutsfit ($502.50 in chips)
Seat 3: evo.com ($637.69 in chips)
Seat 4: jjisnoob ($849.39 in chips)
Seat 6: z4muz ($500 in chips)
Nutsfit: posts small blind $2.50
evo.com: posts big blind $5
ST£4LTH: sits out
*** HOLE CARDS ***
jjisnoob: raises $6.25 to $11.25
z4muz: folds
Rabarber77: folds
Nutsfit: raises $38.75 to $50
evo.com: folds
jjisnoob: calls $38.75
*** FLOP *** [3h 8c Qc]
Nutsfit: bets $52.02
jjisnoob: folds
Uncalled bet ($52.02) returned to Nutsfit
Nutsfit collected $102 from pot
Nutsfit: doesn't show hand
*** SUMMARY ***
Total pot $105 | Rake $3
Board [3h 8c Qc]
Seat 1: Rabarber77 (button) folded before Flop (didn't bet)
Seat 2: Nutsfit (small blind) collected ($102)
Seat 3: evo.com (big blind) folded before Flop
Seat 4: jjisnoob folded on the Flop
Seat 6: z4muz folded before Flop (didn't bet)


PokerStars Hand #222981603053:  Hold'em No Limit ($2.50/$5.00 USD) - 2021/01/23 20:30:05 ET
Table 'Aaltje II' 6-max Seat #2 is the button
Seat 1: Rabarber77 ($556.90 in chips)
Seat 2: Nutsfit ($554.50 in chips)
Seat 3: evo.com ($632.69 in chips)
Seat 4: jjisnoob ($799.39 in chips)
Seat 6: z4muz ($500 in chips)
evo.com: posts small blind $2.50
jjisnoob: posts big blind $5
ST£4LTH: sits out
*** HOLE CARDS ***
ST£4LTH leaves the table
z4muz: folds
Rabarber77: raises $10 to $15
EHJOOJOO6543 joins the table at seat #5
Nutsfit: folds
evo.com: folds
jjisnoob: folds
Uncalled bet ($10) returned to Rabarber77
Rabarber77 collected $12.50 from pot
Rabarber77: doesn't show hand
*** SUMMARY ***
Total pot $12.50 | Rake $0
Seat 1: Rabarber77 collected ($12.50)
Seat 2: Nutsfit (button) folded before Flop (didn't bet)
Seat 3: evo.com (small blind) folded before Flop
Seat 4: jjisnoob (big blind) folded before Flop
Seat 6: z4muz folded before Flop (didn't bet)


PokerStars Hand #222981614914:  Hold'em No Limit ($2.50/$5.00 USD) - 2021/01/23 20:30:32 ET
Table 'Aaltje II' 6-max Seat #3 is the button
Seat 1: Rabarber77 ($564.40 in chips)
Seat 2: Nutsfit ($554.50 in chips)
Seat 3: evo.com ($630.19 in chips)
Seat 4: jjisnoob ($794.39 in chips)
Seat 5: EHJOOJOO6543 ($500 in chips)
Seat 6: z4muz ($500 in chips)
jjisnoob: posts small blind $2.50
EHJOOJOO6543: posts big blind $5
*** HOLE CARDS ***
z4muz: raises $6 to $11
Rabarber77: folds
Nutsfit: folds
evo.com: folds
jjisnoob: raises $40.50 to $51.50
EHJOOJOO6543: folds
z4muz: calls $40.50
*** FLOP *** [4d Qc Jd]
jjisnoob: bets $89.25
z4muz: folds
Uncalled bet ($89.25) returned to jjisnoob
jjisnoob collected $105 from pot
jjisnoob: doesn't show hand
*** SUMMARY ***
Total pot $108 | Rake $3
Board [4d Qc Jd]
Seat 1: Rabarber77 folded before Flop (didn't bet)
Seat 2: Nutsfit folded before Flop (didn't bet)
Seat 3: evo.com (button) folded before Flop (didn't bet)
Seat 4: jjisnoob (small blind) collected ($105)
Seat 5: EHJOOJOO6543 (big blind) folded before Flop
Seat 6: z4muz folded on the Flop


PokerStars Hand #222981638686:  Hold'em No Limit ($2.50/$5.00 USD) - 2021/01/23 20:31:27 ET
Table 'Aaltje II' 6-max Seat #4 is the button
Seat 1: Rabarber77 ($564.40 in chips)
Seat 2: Nutsfit ($554.50 in chips)
Seat 3: evo.com ($630.19 in chips)
Seat 4: jjisnoob ($847.89 in chips)
Seat 5: EHJOOJOO6543 ($500 in chips)
Seat 6: z4muz ($500 in chips)
EHJOOJOO6543: posts small blind $2.50
z4muz: posts big blind $5
*** HOLE CARDS ***
Rabarber77: folds
Nutsfit: folds
evo.com: folds
jjisnoob: raises $6.25 to $11.25
EHJOOJOO6543: folds
z4muz: calls $6.25
*** FLOP *** [9s Kc Ac]
z4muz: checks
jjisnoob: bets $23.04
z4muz: folds
Uncalled bet ($23.04) returned to jjisnoob
jjisnoob collected $23.75 from pot
jjisnoob: doesn't show hand
*** SUMMARY ***
Total pot $25 | Rake $1.25
Board [9s Kc Ac]
Seat 1: Rabarber77 folded before Flop (didn't bet)
Seat 2: Nutsfit folded before Flop (didn't bet)
Seat 3: evo.com folded before Flop (didn't bet)
Seat 4: jjisnoob (button) collected ($23.75)
Seat 5: EHJOOJOO6543 (small blind) folded before Flop
Seat 6: z4muz (big blind) folded on the Flop


PokerStars Hand #222981649656:  Hold'em No Limit ($2.50/$5.00 USD) - 2021/01/23 20:31:53 ET
Table 'Aaltje II' 6-max Seat #5 is the button
Seat 1: Rabarber77 ($564.40 in chips)
Seat 2: Nutsfit ($554.50 in chips)
Seat 3: evo.com ($630.19 in chips)
Seat 4: jjisnoob ($860.39 in chips)
Seat 5: EHJOOJOO6543 ($500 in chips)
Seat 6: z4muz ($500 in chips)
z4muz: posts small blind $2.50
Rabarber77: posts big blind $5
*** HOLE CARDS ***
Nutsfit: folds
evo.com: raises $6 to $11
jjisnoob: folds
EHJOOJOO6543: folds
z4muz: folds
Rabarber77: calls $6
*** FLOP *** [3d Jd Ah]
Rabarber77: checks
evo.com: bets $25
Rabarber77: folds
Uncalled bet ($25) returned to evo.com
evo.com collected $23.28 from pot
*** SUMMARY ***
Total pot $24.50 | Rake $1.22
Board [3d Jd Ah]
Seat 1: Rabarber77 (big blind) folded on the Flop
Seat 2: Nutsfit folded before Flop (didn't bet)
Seat 3: evo.com collected ($23.28)
Seat 4: jjisnoob folded before Flop (didn't bet)
Seat 5: EHJOOJOO6543 (button) folded before Flop (didn't bet)
Seat 6: z4muz (small blind) folded before Flop


PokerStars Hand #222981670424:  Hold'em No Limit ($2.50/$5.00 USD) - 2021/01/23 20:32:41 ET
Table 'Aaltje II' 6-max Seat #6 is the button
Seat 1: Rabarber77 ($553.40 in chips)
Seat 2: Nutsfit ($554.50 in chips)
Seat 3: evo.com ($642.47 in chips)
Seat 4: jjisnoob ($860.39 in chips)
Seat 5: EHJOOJOO6543 ($500 in chips)
Seat 6: z4muz ($500 in chips)
Rabarber77: posts small blind $2.50
Nutsfit: posts big blind $5
*** HOLE CARDS ***
evo.com: folds
jjisnoob: folds
EHJOOJOO6543: raises $7.50 to $12.50
z4muz: calls $12.50
Rabarber77: raises $42.50 to $55
Nutsfit: folds
EHJOOJOO6543: folds
z4muz: calls $42.50
*** FLOP *** [Qs 8h 5s]
Rabarber77: bets $65
z4muz: folds
Uncalled bet ($65) returned to Rabarber77
Rabarber77 collected $124.50 from pot
Rabarber77: doesn't show hand
*** SUMMARY ***
Total pot $127.50 | Rake $3
Board [Qs 8h 5s]
Seat 1: Rabarber77 (small blind) collected ($124.50)
Seat 2: Nutsfit (big blind) folded before Flop
Seat 3: evo.com folded before Flop (didn't bet)
Seat 4: jjisnoob folded before Flop (didn't bet)
Seat 5: EHJOOJOO6543 folded before Flop
Seat 6: z4muz (button) folded on the Flop


PokerStars Hand #222981692275:  Hold'em No Limit ($2.50/$5.00 USD) - 2021/01/23 20:33:31 ET
Table 'Aaltje II' 6-max Seat #1 is the button
Seat 1: Rabarber77 ($622.90 in chips)
Seat 2: Nutsfit ($549.50 in chips)
Seat 3: evo.com ($642.47 in chips)
Seat 4: jjisnoob ($860.39 in chips)
Seat 5: EHJOOJOO6543 ($500 in chips)
Seat 6: z4muz ($500 in chips)
Nutsfit: posts small blind $2.50
evo.com: posts big blind $5
*** HOLE CARDS ***
jjisnoob: folds
EHJOOJOO6543: folds
z4muz: raises $6 to $11
Rabarber77: folds
Nutsfit: folds
evo.com: folds
Uncalled bet ($6) returned to z4muz
z4muz collected $12.50 from pot
z4muz: doesn't show hand
*** SUMMARY ***
Total pot $12.50 | Rake $0
Seat 1: Rabarber77 (button) folded before Flop (didn't bet)
Seat 2: Nutsfit (small blind) folded before Flop
Seat 3: evo.com (big blind) folded before Flop
Seat 4: jjisnoob folded before Flop (didn't bet)
Seat 5: EHJOOJOO6543 folded before Flop (didn't bet)
Seat 6: z4muz collected ($12.50)


PokerStars Hand #222981699609:  Hold'em No Limit ($2.50/$5.00 USD) - 2021/01/23 20:33:48 ET
Table 'Aaltje II' 6-max Seat #2 is the button
Seat 1: Rabarber77 ($622.90 in chips)
Seat 2: Nutsfit ($547 in chips)
Seat 3: evo.com ($637.47 in chips)
Seat 4: jjisnoob ($860.39 in chips)
Seat 5: EHJOOJOO6543 ($500 in chips)
Seat 6: z4muz ($507.50 in chips)
evo.com: posts small blind $2.50
jjisnoob: posts big blind $5
*** HOLE CARDS ***
EHJOOJOO6543: folds
z4muz: raises $6 to $11
Rabarber77: folds
Nutsfit: folds
evo.com: calls $8.50
jjisnoob: folds
*** FLOP *** [Ts 2d 2c]
evo.com: checks
z4muz: bets $16.93
evo.com: calls $16.93
*** TURN *** [Ts 2d 2c] [5c]
evo.com: checks
z4muz: checks
*** RIVER *** [Ts 2d 2c 5c] [9d]
evo.com: checks
z4muz: bets $30.09
evo.com: folds
Uncalled bet ($30.09) returned to z4muz
z4muz collected $57.86 from pot
z4muz: doesn't show hand
*** SUMMARY ***
Total pot $60.86 | Rake $3
Board [Ts 2d 2c 5c 9d]
Seat 1: Rabarber77 folded before Flop (didn't bet)
Seat 2: Nutsfit (button) folded before Flop (didn't bet)
Seat 3: evo.com (small blind) folded on the River
Seat 4: jjisnoob (big blind) folded before Flop
Seat 5: EHJOOJOO6543 folded before Flop (didn't bet)
Seat 6: z4muz collected ($57.86)


PokerStars Hand #222981744095:  Hold'em No Limit ($2.50/$5.00 USD) - 2021/01/23 20:35:26 ET
Table 'Aaltje II' 6-max Seat #3 is the button
Seat 1: Rabarber77 ($622.90 in chips)
Seat 2: Nutsfit ($547 in chips)
Seat 3: evo.com ($609.54 in chips)
Seat 4: jjisnoob ($855.39 in chips)
Seat 5: EHJOOJOO6543 ($500 in chips)
Seat 6: z4muz ($537.43 in chips)
jjisnoob: posts small blind $2.50
EHJOOJOO6543: posts big blind $5
*** HOLE CARDS ***
z4muz: folds
Rabarber77: raises $10 to $15
Nutsfit: folds
evo.com: folds
jjisnoob: folds
EHJOOJOO6543: folds
Uncalled bet ($10) returned to Rabarber77
Rabarber77 collected $12.50 from pot
Rabarber77: doesn't show hand
*** SUMMARY ***
Total pot $12.50 | Rake $0
Seat 1: Rabarber77 collected ($12.50)
Seat 2: Nutsfit folded before Flop (didn't bet)
Seat 3: evo.com (button) folded before Flop (didn't bet)
Seat 4: jjisnoob (small blind) folded before Flop
Seat 5: EHJOOJOO6543 (big blind) folded before Flop
Seat 6: z4muz folded before Flop (didn't bet)


PokerStars Hand #222981753637:  Hold'em No Limit ($2.50/$5.00 USD) - 2021/01/23 20:35:48 ET
Table 'Aaltje II' 6-max Seat #4 is the button
Seat 1: Rabarber77 ($630.40 in chips)
Seat 2: Nutsfit ($547 in chips)
Seat 3: evo.com ($609.54 in chips)
Seat 4: jjisnoob ($852.89 in chips)
Seat 5: EHJOOJOO6543 ($500 in chips)
Seat 6: z4muz ($537.43 in chips)
EHJOOJOO6543: posts small blind $2.50
z4muz: posts big blind $5
*** HOLE CARDS ***
Rabarber77: folds
Nutsfit: raises $5.90 to $10.90
evo.com: folds
jjisnoob: folds
EHJOOJOO6543: raises $34.10 to $45
z4muz: folds
Nutsfit: folds
Uncalled bet ($34.10) returned to EHJOOJOO6543
EHJOOJOO6543 collected $26.80 from pot
EHJOOJOO6543: doesn't show hand
*** SUMMARY ***
Total pot $26.80 | Rake $0
Seat 1: Rabarber77 folded before Flop (didn't bet)
Seat 2: Nutsfit folded before Flop
Seat 3: evo.com folded before Flop (didn't bet)
Seat 4: jjisnoob (button) folded before Flop (didn't bet)
Seat 5: EHJOOJOO6543 (small blind) collected ($26.80)
Seat 6: z4muz (big blind) folded before Flop


PokerStars Hand #222981767843:  Hold'em No Limit ($2.50/$5.00 USD) - 2021/01/23 20:36:22 ET
Table 'Aaltje II' 6-max Seat #5 is the button
Seat 1: Rabarber77 ($630.40 in chips)
Seat 2: Nutsfit ($536.10 in chips)
Seat 3: evo.com ($609.54 in chips)
Seat 4: jjisnoob ($852.89 in chips)
Seat 5: EHJOOJOO6543 ($515.90 in chips)
Seat 6: z4muz ($532.43 in chips)
z4muz: posts small blind $2.50
Rabarber77: posts big blind $5
*** HOLE CARDS ***
Nutsfit: folds
evo.com: folds
jjisnoob: folds
EHJOOJOO6543: raises $7.50 to $12.50
z4muz: raises $42.50 to $55
Rabarber77: folds
EHJOOJOO6543: raises $72.50 to $127.50
z4muz: folds
Uncalled bet ($72.50) returned to EHJOOJOO6543
EHJOOJOO6543 collected $115 from pot
EHJOOJOO6543: doesn't show hand
*** SUMMARY ***
Total pot $115 | Rake $0
Seat 1: Rabarber77 (big blind) folded before Flop
Seat 2: Nutsfit folded before Flop (didn't bet)
Seat 3: evo.com folded before Flop (didn't bet)
Seat 4: jjisnoob folded before Flop (didn't bet)
Seat 5: EHJOOJOO6543 (button) collected ($115)
Seat 6: z4muz (small blind) folded before Flop


PokerStars Hand #222981782317:  Hold'em No Limit ($2.50/$5.00 USD) - 2021/01/23 20:36:56 ET
Table 'Aaltje II' 6-max Seat #6 is the button
Seat 1: Rabarber77 ($625.40 in chips)
Seat 2: Nutsfit ($536.10 in chips)
Seat 3: evo.com ($609.54 in chips)
Seat 4: jjisnoob ($852.89 in chips)
Seat 5: EHJOOJOO6543 ($575.90 in chips)
Seat 6: z4muz ($500 in chips)
Rabarber77: posts small blind $2.50
Nutsfit: posts big blind $5
*** HOLE CARDS ***
evo.com: folds
jjisnoob: folds
EHJOOJOO6543: folds
z4muz: folds
Rabarber77: raises $5 to $10
Nutsfit: calls $5
*** FLOP *** [2d 6c Qc]
Rabarber77: bets $9.50
Nutsfit: folds
Uncalled bet ($9.50) returned to Rabarber77
Rabarber77 collected $19 from pot
Rabarber77: doesn't show hand
*** SUMMARY ***
Total pot $20 | Rake $1
Board [2d 6c Qc]
Seat 1: Rabarber77 (small blind) collected ($19)
Seat 2: Nutsfit (big blind) folded on the Flop
Seat 3: evo.com folded before Flop (didn't bet)
Seat 4: jjisnoob folded before Flop (didn't bet)
Seat 5: EHJOOJOO6543 folded before Flop (didn't bet)
Seat 6: z4muz (button) folded before Flop (didn't bet)


PokerStars Hand #222981801765:  Hold'em No Limit ($2.50/$5.00 USD) - 2021/01/23 20:37:42 ET
Table 'Aaltje II' 6-max Seat #1 is the button
Seat 1: Rabarber77 ($634.40 in chips)
Seat 2: Nutsfit ($526.10 in chips)
Seat 3: evo.com ($609.54 in chips)
Seat 4: jjisnoob ($852.89 in chips)
Seat 5: EHJOOJOO6543 ($575.90 in chips)
Seat 6: z4muz ($500 in chips)
Nutsfit: posts small blind $2.50
evo.com: posts big blind $5
*** HOLE CARDS ***
jjisnoob: folds
EHJOOJOO6543: raises $7.50 to $12.50
z4muz: folds
Rabarber77: folds
Nutsfit: folds
evo.com: calls $7.50
*** FLOP *** [7d 9d 5s]
evo.com: checks
EHJOOJOO6543: bets $6.53
evo.com: folds
Uncalled bet ($6.53) returned to EHJOOJOO6543
EHJOOJOO6543 collected $26.12 from pot
EHJOOJOO6543: doesn't show hand
*** SUMMARY ***
Total pot $27.50 | Rake $1.38
Board [7d 9d 5s]
Seat 1: Rabarber77 (button) folded before Flop (didn't bet)
Seat 2: Nutsfit (small blind) folded before Flop
Seat 3: evo.com (big blind) folded on the Flop
Seat 4: jjisnoob folded before Flop (didn't bet)
Seat 5: EHJOOJOO6543 collected ($26.12)
Seat 6: z4muz folded before Flop (didn't bet)


PokerStars Hand #222981836476:  Hold'em No Limit ($2.50/$5.00 USD) - 2021/01/23 20:38:57 ET
Table 'Aaltje II' 6-max Seat #2 is the button
Seat 1: Rabarber77 ($634.40 in chips)
Seat 2: Nutsfit ($523.60 in chips)
Seat 3: evo.com ($597.04 in chips)
Seat 4: jjisnoob ($852.89 in chips)
Seat 5: EHJOOJOO6543 ($589.52 in chips)
Seat 6: z4muz ($500 in chips)
evo.com: posts small blind $2.50
jjisnoob: posts big blind $5
*** HOLE CARDS ***
EHJOOJOO6543: folds
z4muz: folds
Rabarber77: folds
Nutsfit: raises $7.50 to $12.50
evo.com: folds
jjisnoob: folds
Uncalled bet ($7.50) returned to Nutsfit
Nutsfit collected $12.50 from pot
Nutsfit: doesn't show hand
*** SUMMARY ***
Total pot $12.50 | Rake $0
Seat 1: Rabarber77 folded before Flop (didn't bet)
Seat 2: Nutsfit (button) collected ($12.50)
Seat 3: evo.com (small blind) folded before Flop
Seat 4: jjisnoob (big blind) folded before Flop
Seat 5: EHJOOJOO6543 folded before Flop (didn't bet)
Seat 6: z4muz folded before Flop (didn't bet)


PokerStars Hand #222981848810:  Hold'em No Limit ($2.50/$5.00 USD) - 2021/01/23 20:39:26 ET
Table 'Aaltje II' 6-max Seat #3 is the button
Seat 1: Rabarber77 ($634.40 in chips)
Seat 2: Nutsfit ($531.10 in chips)
Seat 3: evo.com ($594.54 in chips)
Seat 4: jjisnoob ($847.89 in chips)
Seat 5: EHJOOJOO6543 ($589.52 in chips)
Seat 6: z4muz ($500 in chips)
jjisnoob: posts small blind $2.50
EHJOOJOO6543: posts big blind $5
*** HOLE CARDS ***
z4muz: raises $6 to $11
Rabarber77: calls $11
Nutsfit: folds
evo.com: folds
jjisnoob: folds
EHJOOJOO6543: folds
*** FLOP *** [Jd Ad As]
z4muz: checks
Rabarber77: bets $14.01
z4muz: calls $14.01
*** TURN *** [Jd Ad As] [Td]
z4muz: checks
Rabarber77: checks
*** RIVER *** [Jd Ad As Td] [8s]
z4muz: bets $36.06
Rabarber77: folds
Uncalled bet ($36.06) returned to z4muz
z4muz collected $54.64 from pot
z4muz: doesn't show hand
*** SUMMARY ***
Total pot $57.52 | Rake $2.88
Board [Jd Ad As Td 8s]
Seat 1: Rabarber77 folded on the River
Seat 2: Nutsfit folded before Flop (didn't bet)
Seat 3: evo.com (button) folded before Flop (didn't bet)
Seat 4: jjisnoob (small blind) folded before Flop
Seat 5: EHJOOJOO6543 (big blind) folded before Flop
Seat 6: z4muz collected ($54.64)


PokerStars Hand #222981867598:  Hold'em No Limit ($2.50/$5.00 USD) - 2021/01/23 20:40:11 ET
Table 'Aaltje II' 6-max Seat #4 is the button
Seat 1: Rabarber77 ($609.39 in chips)
Seat 2: Nutsfit ($531.10 in chips)
Seat 3: evo.com ($594.54 in chips)
Seat 4: jjisnoob ($845.39 in chips)
Seat 5: EHJOOJOO6543 ($584.52 in chips)
Seat 6: z4muz ($529.63 in chips)
EHJOOJOO6543: posts small blind $2.50
z4muz: posts big blind $5
*** HOLE CARDS ***
Rabarber77: folds
Nutsfit: folds
evo.com: folds
jjisnoob: folds
EHJOOJOO6543: folds
Uncalled bet ($2.50) returned to z4muz
z4muz collected $5 from pot
z4muz: doesn't show hand
*** SUMMARY ***
Total pot $5 | Rake $0
Seat 1: Rabarber77 folded before Flop (didn't bet)
Seat 2: Nutsfit folded before Flop (didn't bet)
Seat 3: evo.com folded before Flop (didn't bet)
Seat 4: jjisnoob (button) folded before Flop (didn't bet)
Seat 5: EHJOOJOO6543 (small blind) folded before Flop
Seat 6: z4muz (big blind) collected ($5)


PokerStars Hand #222981877816:  Hold'em No Limit ($2.50/$5.00 USD) - 2021/01/23 20:40:35 ET
Table 'Aaltje II' 6-max Seat #5 is the button
Seat 1: Rabarber77 ($609.39 in chips)
Seat 2: Nutsfit ($531.10 in chips)
Seat 3: evo.com ($594.54 in chips)
Seat 4: jjisnoob ($845.39 in chips)
Seat 5: EHJOOJOO6543 ($582.02 in chips)
Seat 6: z4muz ($532.13 in chips)
z4muz: posts small blind $2.50
Rabarber77: posts big blind $5
*** HOLE CARDS ***
Nutsfit: raises $5.90 to $10.90
evo.com: folds
jjisnoob: folds
EHJOOJOO6543: folds
z4muz: folds
Rabarber77: folds
Uncalled bet ($5.90) returned to Nutsfit
Nutsfit collected $12.50 from pot
Nutsfit: doesn't show hand
*** SUMMARY ***
Total pot $12.50 | Rake $0
Seat 1: Rabarber77 (big blind) folded before Flop
Seat 2: Nutsfit collected ($12.50)
Seat 3: evo.com folded before Flop (didn't bet)
Seat 4: jjisnoob folded before Flop (didn't bet)
Seat 5: EHJOOJOO6543 (button) folded before Flop (didn't bet)
Seat 6: z4muz (small blind) folded before Flop


PokerStars Hand #222981885647:  Hold'em No Limit ($2.50/$5.00 USD) - 2021/01/23 20:40:54 ET
Table 'Aaltje II' 6-max Seat #6 is the button
Seat 1: Rabarber77 ($604.39 in chips)
Seat 2: Nutsfit ($538.60 in chips)
Seat 3: evo.com ($594.54 in chips)
Seat 4: jjisnoob ($845.39 in chips)
Seat 5: EHJOOJOO6543 ($582.02 in chips)
Seat 6: z4muz ($529.63 in chips)
Rabarber77: posts small blind $2.50
Nutsfit: posts big blind $5
*** HOLE CARDS ***
evo.com: folds
jjisnoob: raises $6.25 to $11.25
EHJOOJOO6543: folds
z4muz: folds
Rabarber77: raises $23.75 to $35
Nutsfit: folds
jjisnoob: folds
Uncalled bet ($23.75) returned to Rabarber77
Rabarber77 collected $27.50 from pot
Rabarber77: doesn't show hand
*** SUMMARY ***
Total pot $27.50 | Rake $0
Seat 1: Rabarber77 (small blind) collected ($27.50)
Seat 2: Nutsfit (big blind) folded before Flop
Seat 3: evo.com folded before Flop (didn't bet)
Seat 4: jjisnoob folded before Flop
Seat 5: EHJOOJOO6543 folded before Flop (didn't bet)
Seat 6: z4muz (button) folded before Flop (didn't bet)


PokerStars Hand #222981896372:  Hold'em No Limit ($2.50/$5.00 USD) - 2021/01/23 20:41:19 ET
Table 'Aaltje II' 6-max Seat #1 is the button
Seat 1: Rabarber77 ($620.64 in chips)
Seat 2: Nutsfit ($533.60 in chips)
Seat 3: evo.com ($594.54 in chips)
Seat 4: jjisnoob ($834.14 in chips)
Seat 5: EHJOOJOO6543 ($582.02 in chips)
Seat 6: z4muz ($529.63 in chips)
Nutsfit: posts small blind $2.50
evo.com: posts big blind $5
*** HOLE CARDS ***
jjisnoob: raises $6.25 to $11.25
EHJOOJOO6543: folds
z4muz: folds
Rabarber77: folds
Nutsfit: folds
evo.com: folds
Uncalled bet ($6.25) returned to jjisnoob
jjisnoob collected $12.50 from pot
jjisnoob: doesn't show hand
*** SUMMARY ***
Total pot $12.50 | Rake $0
Seat 1: Rabarber77 (button) folded before Flop (didn't bet)
Seat 2: Nutsfit (small blind) folded before Flop
Seat 3: evo.com (big blind) folded before Flop
Seat 4: jjisnoob collected ($12.50)
Seat 5: EHJOOJOO6543 folded before Flop (didn't bet)
Seat 6: z4muz folded before Flop (didn't bet)


PokerStars Hand #222981904316:  Hold'em No Limit ($2.50/$5.00 USD) - 2021/01/23 20:41:38 ET
Table 'Aaltje II' 6-max Seat #2 is the button
Seat 1: Rabarber77 ($620.64 in chips)
Seat 2: Nutsfit ($531.10 in chips)
Seat 3: evo.com ($589.54 in chips)
Seat 4: jjisnoob ($841.64 in chips)
Seat 5: EHJOOJOO6543 ($582.02 in chips)
Seat 6: z4muz ($529.63 in chips)
evo.com: posts small blind $2.50
jjisnoob: posts big blind $5
*** HOLE CARDS ***
EHJOOJOO6543: folds
z4muz: folds
Rabarber77: folds
Nutsfit: folds
evo.com: folds
Uncalled bet ($2.50) returned to jjisnoob
jjisnoob collected $5 from pot
jjisnoob: doesn't show hand
*** SUMMARY ***
Total pot $5 | Rake $0
Seat 1: Rabarber77 folded before Flop (didn't bet)
Seat 2: Nutsfit (button) folded before Flop (didn't bet)
Seat 3: evo.com (small blind) folded before Flop
Seat 4: jjisnoob (big blind) collected ($5)
Seat 5: EHJOOJOO6543 folded before Flop (didn't bet)
Seat 6: z4muz folded before Flop (didn't bet)


PokerStars Hand #222981911132:  Hold'em No Limit ($2.50/$5.00 USD) - 2021/01/23 20:41:54 ET
Table 'Aaltje II' 6-max Seat #3 is the button
Seat 1: Rabarber77 ($620.64 in chips)
Seat 2: Nutsfit ($531.10 in chips)
Seat 3: evo.com ($587.04 in chips)
Seat 4: jjisnoob ($844.14 in chips)
Seat 5: EHJOOJOO6543 ($582.02 in chips)
Seat 6: z4muz ($529.63 in chips)
jjisnoob: posts small blind $2.50
EHJOOJOO6543: posts big blind $5
*** HOLE CARDS ***
z4muz: folds
Rabarber77: folds
Nutsfit: folds
evo.com: folds
jjisnoob: raises $11.50 to $16.50
EHJOOJOO6543: folds
Uncalled bet ($11.50) returned to jjisnoob
jjisnoob collected $10 from pot
jjisnoob: doesn't show hand
*** SUMMARY ***
Total pot $10 | Rake $0
Seat 1: Rabarber77 folded before Flop (didn't bet)
Seat 2: Nutsfit folded before Flop (didn't bet)
Seat 3: evo.com (button) folded before Flop (didn't bet)
Seat 4: jjisnoob (small blind) collected ($10)
Seat 5: EHJOOJOO6543 (big blind) folded before Flop
Seat 6: z4muz folded before Flop (didn't bet)


PokerStars Hand #222981922936:  Hold'em No Limit ($2.50/$5.00 USD) - 2021/01/23 20:42:22 ET
Table 'Aaltje II' 6-max Seat #4 is the button
Seat 1: Rabarber77 ($620.64 in chips)
Seat 2: Nutsfit ($531.10 in chips)
Seat 3: evo.com ($587.04 in chips)
Seat 4: jjisnoob ($849.14 in chips)
Seat 5: EHJOOJOO6543 ($577.02 in chips)
Seat 6: z4muz ($529.63 in chips)
EHJOOJOO6543: posts small blind $2.50
z4muz: posts big blind $5
*** HOLE CARDS ***
Rabarber77: folds
Nutsfit: folds
evo.com: raises $6 to $11
jjisnoob: folds
EHJOOJOO6543: raises $34 to $45
z4muz: folds
evo.com: calls $34
*** FLOP *** [4d 2h 7s]
EHJOOJOO6543: checks
evo.com: bets $27.60
EHJOOJOO6543: raises $67.40 to $95
evo.com: folds
Uncalled bet ($67.40) returned to EHJOOJOO6543
EHJOOJOO6543 collected $147.20 from pot
EHJOOJOO6543: doesn't show hand
*** SUMMARY ***
Total pot $150.20 | Rake $3
Board [4d 2h 7s]
Seat 1: Rabarber77 folded before Flop (didn't bet)
Seat 2: Nutsfit folded before Flop (didn't bet)
Seat 3: evo.com folded on the Flop
Seat 4: jjisnoob (button) folded before Flop (didn't bet)
Seat 5: EHJOOJOO6543 (small blind) collected ($147.20)
Seat 6: z4muz (big blind) folded before Flop


PokerStars Hand #222981958402:  Hold'em No Limit ($2.50/$5.00 USD) - 2021/01/23 20:43:28 ET
Table 'Aaltje II' 6-max Seat #5 is the button
Seat 1: Rabarber77 ($620.64 in chips)
Seat 2: Nutsfit ($531.10 in chips)
Seat 3: evo.com ($514.44 in chips)
Seat 4: jjisnoob ($849.14 in chips)
Seat 5: EHJOOJOO6543 ($651.62 in chips)
Seat 6: z4muz ($524.63 in chips)
z4muz: posts small blind $2.50
Rabarber77: posts big blind $5
*** HOLE CARDS ***
Nutsfit: folds
evo.com: folds
jjisnoob: folds
EHJOOJOO6543: folds
z4muz: folds
Uncalled bet ($2.50) returned to Rabarber77
Rabarber77 collected $5 from pot
Rabarber77: doesn't show hand
*** SUMMARY ***
Total pot $5 | Rake $0
Seat 1: Rabarber77 (big blind) collected ($5)
Seat 2: Nutsfit folded before Flop (didn't bet)
Seat 3: evo.com folded before Flop (didn't bet)
Seat 4: jjisnoob folded before Flop (didn't bet)
Seat 5: EHJOOJOO6543 (button) folded before Flop (didn't bet)
Seat 6: z4muz (small blind) folded before Flop


PokerStars Hand #222981964676:  Hold'em No Limit ($2.50/$5.00 USD) - 2021/01/23 20:43:43 ET
Table 'Aaltje II' 6-max Seat #6 is the button
Seat 1: Rabarber77 ($623.14 in chips)
Seat 2: Nutsfit ($531.10 in chips)
Seat 3: evo.com ($514.44 in chips)
Seat 4: jjisnoob ($849.14 in chips)
Seat 5: EHJOOJOO6543 ($651.62 in chips)
Seat 6: z4muz ($522.13 in chips)
Rabarber77: posts small blind $2.50
Nutsfit: posts big blind $5
*** HOLE CARDS ***
evo.com: folds
jjisnoob: folds
EHJOOJOO6543: raises $7.50 to $12.50
z4muz: folds
Rabarber77: calls $10
Nutsfit: folds
*** FLOP *** [Ts 8c 9d]
Rabarber77: checks
EHJOOJOO6543: checks
*** TURN *** [Ts 8c 9d] [7h]
Rabarber77: bets $14.25
EHJOOJOO6543: calls $14.25
*** RIVER *** [Ts 8c 9d 7h] [Th]
Rabarber77: bets $27.79
EHJOOJOO6543: folds
Uncalled bet ($27.79) returned to Rabarber77
Rabarber77 collected $55.58 from pot
Rabarber77: doesn't show hand
*** SUMMARY ***
Total pot $58.50 | Rake $2.92
Board [Ts 8c 9d 7h Th]
Seat 1: Rabarber77 (small blind) collected ($55.58)
Seat 2: Nutsfit (big blind) folded before Flop
Seat 3: evo.com folded before Flop (didn't bet)
Seat 4: jjisnoob folded before Flop (didn't bet)
Seat 5: EHJOOJOO6543 folded on the River
Seat 6: z4muz (button) folded before Flop (didn't bet)


PokerStars Hand #222981992412:  Hold'em No Limit ($2.50/$5.00 USD) - 2021/01/23 20:44:40 ET
Table 'Aaltje II' 6-max Seat #1 is the button
Seat 1: Rabarber77 ($651.97 in chips)
Seat 2: Nutsfit ($526.10 in chips)
Seat 3: evo.com ($514.44 in chips)
Seat 4: jjisnoob ($849.14 in chips)
Seat 5: EHJOOJOO6543 ($624.87 in chips)
Seat 6: z4muz ($522.13 in chips)
Nutsfit: posts small blind $2.50
evo.com: posts big blind $5
*** HOLE CARDS ***
jjisnoob: folds
EHJOOJOO6543: folds
z4muz: folds
Rabarber77: folds
Nutsfit: raises $10 to $15
evo.com: folds
Uncalled bet ($10) returned to Nutsfit
Nutsfit collected $10 from pot
Nutsfit: doesn't show hand
*** SUMMARY ***
Total pot $10 | Rake $0
Seat 1: Rabarber77 (button) folded before Flop (didn't bet)
Seat 2: Nutsfit (small blind) collected ($10)
Seat 3: evo.com (big blind) folded before Flop
Seat 4: jjisnoob folded before Flop (didn't bet)
Seat 5: EHJOOJOO6543 folded before Flop (didn't bet)
Seat 6: z4muz folded before Flop (didn't bet)


PokerStars Hand #222982000070:  Hold'em No Limit ($2.50/$5.00 USD) - 2021/01/23 20:44:59 ET
Table 'Aaltje II' 6-max Seat #2 is the button
Seat 1: Rabarber77 ($651.97 in chips)
Seat 2: Nutsfit ($531.10 in chips)
Seat 3: evo.com ($509.44 in chips)
Seat 4: jjisnoob ($849.14 in chips)
Seat 5: EHJOOJOO6543 ($624.87 in chips)
Seat 6: z4muz ($522.13 in chips)
evo.com: posts small blind $2.50
jjisnoob: posts big blind $5
*** HOLE CARDS ***
EHJOOJOO6543: folds
z4muz: folds
Rabarber77: raises $10 to $15
Nutsfit: folds
evo.com: folds
jjisnoob: folds
Uncalled bet ($10) returned to Rabarber77
Rabarber77 collected $12.50 from pot
Rabarber77: doesn't show hand
*** SUMMARY ***
Total pot $12.50 | Rake $0
Seat 1: Rabarber77 collected ($12.50)
Seat 2: Nutsfit (button) folded before Flop (didn't bet)
Seat 3: evo.com (small blind) folded before Flop
Seat 4: jjisnoob (big blind) folded before Flop
Seat 5: EHJOOJOO6543 folded before Flop (didn't bet)
Seat 6: z4muz folded before Flop (didn't bet)


PokerStars Hand #222982006962:  Hold'em No Limit ($2.50/$5.00 USD) - 2021/01/23 20:45:15 ET
Table 'Aaltje II' 6-max Seat #3 is the button
Seat 1: Rabarber77 ($659.47 in chips)
Seat 2: Nutsfit ($531.10 in chips)
Seat 3: evo.com ($506.94 in chips)
Seat 4: jjisnoob ($844.14 in chips)
Seat 5: EHJOOJOO6543 ($624.87 in chips)
Seat 6: z4muz ($522.13 in chips)
jjisnoob: posts small blind $2.50
EHJOOJOO6543: posts big blind $5
*** HOLE CARDS ***
z4muz: folds
Rabarber77: folds
Nutsfit: folds
evo.com: folds
jjisnoob: raises $11.50 to $16.50
EHJOOJOO6543: folds
Uncalled bet ($11.50) returned to jjisnoob
jjisnoob collected $10 from pot
jjisnoob: doesn't show hand
*** SUMMARY ***
Total pot $10 | Rake $0
Seat 1: Rabarber77 folded before Flop (didn't bet)
Seat 2: Nutsfit folded before Flop (didn't bet)
Seat 3: evo.com (button) folded before Flop (didn't bet)
Seat 4: jjisnoob (small blind) collected ($10)
Seat 5: EHJOOJOO6543 (big blind) folded before Flop
Seat 6: z4muz folded before Flop (didn't bet)


PokerStars Hand #222982012755:  Hold'em No Limit ($2.50/$5.00 USD) - 2021/01/23 20:45:30 ET
Table 'Aaltje II' 6-max Seat #4 is the button
Seat 1: Rabarber77 ($659.47 in chips)
Seat 2: Nutsfit ($531.10 in chips)
Seat 3: evo.com ($506.94 in chips)
Seat 4: jjisnoob ($849.14 in chips)
Seat 5: EHJOOJOO6543 ($619.87 in chips)
Seat 6: z4muz ($522.13 in chips)
EHJOOJOO6543: posts small blind $2.50
z4muz: posts big blind $5
*** HOLE CARDS ***
Rabarber77: folds
Nutsfit: folds
evo.com: folds
jjisnoob: folds
EHJOOJOO6543: folds
Uncalled bet ($2.50) returned to z4muz
z4muz collected $5 from pot
z4muz: doesn't show hand
*** SUMMARY ***
Total pot $5 | Rake $0
Seat 1: Rabarber77 folded before Flop (didn't bet)
Seat 2: Nutsfit folded before Flop (didn't bet)
Seat 3: evo.com folded before Flop (didn't bet)
Seat 4: jjisnoob (button) folded before Flop (didn't bet)
Seat 5: EHJOOJOO6543 (small blind) folded before Flop
Seat 6: z4muz (big blind) collected ($5)


PokerStars Hand #222982020877:  Hold'em No Limit ($2.50/$5.00 USD) - 2021/01/23 20:45:50 ET
Table 'Aaltje II' 6-max Seat #5 is the button
Seat 1: Rabarber77 ($659.47 in chips)
Seat 2: Nutsfit ($531.10 in chips)
Seat 3: evo.com ($506.94 in chips)
Seat 4: jjisnoob ($849.14 in chips)
Seat 5: EHJOOJOO6543 ($617.37 in chips)
Seat 6: z4muz ($524.63 in chips)
z4muz: posts small blind $2.50
Rabarber77: posts big blind $5
*** HOLE CARDS ***
Nutsfit: folds
evo.com: folds
jjisnoob: folds
EHJOOJOO6543: raises $7.50 to $12.50
z4muz: raises $42.50 to $55
Rabarber77: folds
EHJOOJOO6543: folds
Uncalled bet ($42.50) returned to z4muz
z4muz collected $30 from pot
z4muz: doesn't show hand
*** SUMMARY ***
Total pot $30 | Rake $0
Seat 1: Rabarber77 (big blind) folded before Flop
Seat 2: Nutsfit folded before Flop (didn't bet)
Seat 3: evo.com folded before Flop (didn't bet)
Seat 4: jjisnoob folded before Flop (didn't bet)
Seat 5: EHJOOJOO6543 (button) folded before Flop
Seat 6: z4muz (small blind) collected ($30)


PokerStars Hand #222982033138:  Hold'em No Limit ($2.50/$5.00 USD) - 2021/01/23 20:46:19 ET
Table 'Aaltje II' 6-max Seat #6 is the button
Seat 1: Rabarber77 ($654.47 in chips)
Seat 2: Nutsfit ($531.10 in chips)
Seat 3: evo.com ($506.94 in chips)
Seat 4: jjisnoob ($849.14 in chips)
Seat 5: EHJOOJOO6543 ($604.87 in chips)
Seat 6: z4muz ($542.13 in chips)
Rabarber77: posts small blind $2.50
Nutsfit: posts big blind $5
*** HOLE CARDS ***
evo.com: folds
jjisnoob: raises $6.25 to $11.25
EHJOOJOO6543: folds
z4muz: folds
Rabarber77: calls $8.75
Nutsfit: raises $56.25 to $67.50
jjisnoob: folds
Rabarber77: calls $56.25
*** FLOP *** [6d 8s 2c]
Rabarber77: checks
Nutsfit: bets $45
Rabarber77: calls $45
*** TURN *** [6d 8s 2c] [Ts]
Rabarber77: checks
Nutsfit: checks
*** RIVER *** [6d 8s 2c Ts] [Kc]
Rabarber77: checks
Nutsfit: bets $181.94
Rabarber77: calls $181.94
*** SHOW DOWN ***
Nutsfit: shows [Kd Ac] (a pair of Kings)
Rabarber77: mucks hand
Nutsfit collected $597.13 from pot
*** SUMMARY ***
Total pot $600.13 | Rake $3
Board [6d 8s 2c Ts Kc]
Seat 1: Rabarber77 (small blind) mucked
Seat 2: Nutsfit (big blind) showed [Kd Ac] and won ($597.13) with a pair of Kings
Seat 3: evo.com folded before Flop (didn't bet)
Seat 4: jjisnoob folded before Flop
Seat 5: EHJOOJOO6543 folded before Flop (didn't bet)
Seat 6: z4muz (button) folded before Flop (didn't bet)


PokerStars Hand #222982072371:  Hold'em No Limit ($2.50/$5.00 USD) - 2021/01/23 20:47:54 ET
Table 'Aaltje II' 6-max Seat #1 is the button
Seat 1: Rabarber77 ($360.03 in chips)
Seat 2: Nutsfit ($833.79 in chips)
Seat 3: evo.com ($506.94 in chips)
Seat 4: jjisnoob ($837.89 in chips)
Seat 5: EHJOOJOO6543 ($604.87 in chips)
Seat 6: z4muz ($542.13 in chips)
Nutsfit: posts small blind $2.50
evo.com: posts big blind $5
*** HOLE CARDS ***
jjisnoob: raises $6.25 to $11.25
EHJOOJOO6543: folds
z4muz: folds
Rabarber77: folds
Nutsfit: folds
evo.com: calls $6.25
*** FLOP *** [7s 2s 5h]
evo.com: checks
jjisnoob: checks
*** TURN *** [7s 2s 5h] [3d]
evo.com: checks
jjisnoob: checks
*** RIVER *** [7s 2s 5h 3d] [4s]
evo.com: bets $16.63
jjisnoob: calls $16.63
*** SHOW DOWN ***
evo.com: shows [2h Ah] (a straight, Ace to Five)
jjisnoob: shows [Tc Ac] (a straight, Ace to Five)
evo.com collected $27.68 from pot
jjisnoob collected $27.67 from pot
*** SUMMARY ***
Total pot $58.26 | Rake $2.91
Board [7s 2s 5h 3d 4s]
Seat 1: Rabarber77 (button) folded before Flop (didn't bet)
Seat 2: Nutsfit (small blind) folded before Flop
Seat 3: evo.com (big blind) showed [2h Ah] and won ($27.68) with a straight, Ace to Five
Seat 4: jjisnoob showed [Tc Ac] and won ($27.67) with a straight, Ace to Five
Seat 5: EHJOOJOO6543 folded before Flop (didn't bet)
Seat 6: z4muz folded before Flop (didn't bet)


PokerStars Hand #222982105060:  Hold'em No Limit ($2.50/$5.00 USD) - 2021/01/23 20:49:14 ET
Table 'Aaltje II' 6-max Seat #2 is the button
Seat 1: Rabarber77 ($360.03 in chips)
Seat 2: Nutsfit ($831.29 in chips)
Seat 3: evo.com ($506.74 in chips)
Seat 4: jjisnoob ($837.68 in chips)
Seat 5: EHJOOJOO6543 ($604.87 in chips)
Seat 6: z4muz ($542.13 in chips)
evo.com: posts small blind $2.50
jjisnoob: posts big blind $5
*** HOLE CARDS ***
EHJOOJOO6543: folds
z4muz: folds
Rabarber77: folds
Nutsfit: folds
evo.com: raises $10 to $15
jjisnoob: folds
Uncalled bet ($10) returned to evo.com
evo.com collected $10 from pot
*** SUMMARY ***
Total pot $10 | Rake $0
Seat 1: Rabarber77 folded before Flop (didn't bet)
Seat 2: Nutsfit (button) folded before Flop (didn't bet)
Seat 3: evo.com (small blind) collected ($10)
Seat 4: jjisnoob (big blind) folded before Flop
Seat 5: EHJOOJOO6543 folded before Flop (didn't bet)
Seat 6: z4muz folded before Flop (didn't bet)


PokerStars Hand #222982115859:  Hold'em No Limit ($2.50/$5.00 USD) - 2021/01/23 20:49:40 ET
Table 'Aaltje II' 6-max Seat #3 is the button
Seat 1: Rabarber77 ($360.03 in chips)
Seat 2: Nutsfit ($831.29 in chips)
Seat 3: evo.com ($511.74 in chips)
Seat 4: jjisnoob ($832.68 in chips)
Seat 5: EHJOOJOO6543 ($604.87 in chips)
Seat 6: z4muz ($542.13 in chips)
jjisnoob: posts small blind $2.50
EHJOOJOO6543: posts big blind $5
*** HOLE CARDS ***
z4muz: raises $6 to $11
Rabarber77: calls $11
Nutsfit: folds
evo.com: folds
jjisnoob: folds
EHJOOJOO6543: folds
*** FLOP *** [Js 7s 3c]
z4muz: checks
Rabarber77: bets $14.01
z4muz: calls $14.01
*** TURN *** [Js 7s 3c] [Jh]
z4muz: checks
Rabarber77: bets $35
z4muz: folds
Uncalled bet ($35) returned to Rabarber77
Rabarber77 collected $54.64 from pot
Rabarber77: doesn't show hand
*** SUMMARY ***
Total pot $57.52 | Rake $2.88
Board [Js 7s 3c Jh]
Seat 1: Rabarber77 collected ($54.64)
Seat 2: Nutsfit folded before Flop (didn't bet)
Seat 3: evo.com (button) folded before Flop (didn't bet)
Seat 4: jjisnoob (small blind) folded before Flop
Seat 5: EHJOOJOO6543 (big blind) folded before Flop
Seat 6: z4muz folded on the Turn


PokerStars Hand #222982136171:  Hold'em No Limit ($2.50/$5.00 USD) - 2021/01/23 20:50:30 ET
Table 'Aaltje II' 6-max Seat #4 is the button
Seat 1: Rabarber77 ($389.66 in chips)
Seat 2: Nutsfit ($831.29 in chips)
Seat 3: evo.com ($511.74 in chips)
Seat 4: jjisnoob ($830.18 in chips)
Seat 5: EHJOOJOO6543 ($599.87 in chips)
Seat 6: z4muz ($517.12 in chips)
EHJOOJOO6543: posts small blind $2.50
z4muz: posts big blind $5
*** HOLE CARDS ***
Rabarber77: folds
Nutsfit: folds
evo.com: folds
jjisnoob: folds
EHJOOJOO6543: folds
Uncalled bet ($2.50) returned to z4muz
z4muz collected $5 from pot
z4muz: doesn't show hand
*** SUMMARY ***
Total pot $5 | Rake $0
Seat 1: Rabarber77 folded before Flop (didn't bet)
Seat 2: Nutsfit folded before Flop (didn't bet)
Seat 3: evo.com folded before Flop (didn't bet)
Seat 4: jjisnoob (button) folded before Flop (didn't bet)
Seat 5: EHJOOJOO6543 (small blind) folded before Flop
Seat 6: z4muz (big blind) collected ($5)


PokerStars Hand #222982145968:  Hold'em No Limit ($2.50/$5.00 USD) - 2021/01/23 20:50:54 ET
Table 'Aaltje II' 6-max Seat #5 is the button
Seat 1: Rabarber77 ($389.66 in chips)
Seat 2: Nutsfit ($831.29 in chips)
Seat 3: evo.com ($511.74 in chips)
Seat 4: jjisnoob ($830.18 in chips)
Seat 5: EHJOOJOO6543 ($597.37 in chips)
Seat 6: z4muz ($519.62 in chips)
z4muz: posts small blind $2.50
Rabarber77: posts big blind $5
*** HOLE CARDS ***
Nutsfit: folds
evo.com: folds
jjisnoob: folds
EHJOOJOO6543: folds
z4muz: raises $10 to $15
Rabarber77: calls $10
*** FLOP *** [Ks 6c 8d]
z4muz: checks
Rabarber77: checks
*** TURN *** [Ks 6c 8d] [2s]
z4muz: bets $28.50
Rabarber77: calls $28.50
*** RIVER *** [Ks 6c 8d 2s] [5c]
z4muz: bets $55.44
Rabarber77: calls $55.44
*** SHOW DOWN ***
z4muz: shows [8h 6h] (two pair, Eights and Sixes)
Rabarber77: mucks hand
z4muz collected $194.88 from pot
*** SUMMARY ***
Total pot $197.88 | Rake $3
Board [Ks 6c 8d 2s 5c]
Seat 1: Rabarber77 (big blind) mucked
Seat 2: Nutsfit folded before Flop (didn't bet)
Seat 3: evo.com folded before Flop (didn't bet)
Seat 4: jjisnoob folded before Flop (didn't bet)
Seat 5: EHJOOJOO6543 (button) folded before Flop (didn't bet)
Seat 6: z4muz (small blind) showed [8h 6h] and won ($194.88) with two pair, Eights and Sixes


PokerStars Hand #222982163964:  Hold'em No Limit ($2.50/$5.00 USD) - 2021/01/23 20:51:38 ET
Table 'Aaltje II' 6-max Seat #6 is the button
Seat 1: Rabarber77 ($290.72 in chips)
Seat 2: Nutsfit ($831.29 in chips)
Seat 3: evo.com ($511.74 in chips)
Seat 4: jjisnoob ($830.18 in chips)
Seat 5: EHJOOJOO6543 ($597.37 in chips)
Seat 6: z4muz ($615.56 in chips)
Rabarber77: posts small blind $2.50
Nutsfit: posts big blind $5
*** HOLE CARDS ***
evo.com: folds
jjisnoob: folds
EHJOOJOO6543: raises $7.50 to $12.50
z4muz: calls $12.50
Rabarber77: raises $42.50 to $55
Nutsfit: folds
EHJOOJOO6543: folds
z4muz: folds
Uncalled bet ($42.50) returned to Rabarber77
Rabarber77 collected $42.50 from pot
Rabarber77: doesn't show hand
*** SUMMARY ***
Total pot $42.50 | Rake $0
Seat 1: Rabarber77 (small blind) collected ($42.50)
Seat 2: Nutsfit (big blind) folded before Flop
Seat 3: evo.com folded before Flop (didn't bet)
Seat 4: jjisnoob folded before Flop (didn't bet)
Seat 5: EHJOOJOO6543 folded before Flop
Seat 6: z4muz (button) folded before Flop


PokerStars Hand #222982182187:  Hold'em No Limit ($2.50/$5.00 USD) - 2021/01/23 20:52:22 ET
Table 'Aaltje II' 6-max Seat #1 is the button
Seat 1: Rabarber77 ($320.72 in chips)
Seat 2: Nutsfit ($826.29 in chips)
Seat 3: evo.com ($511.74 in chips)
Seat 4: jjisnoob ($830.18 in chips)
Seat 5: EHJOOJOO6543 ($584.87 in chips)
Seat 6: z4muz ($603.06 in chips)
Nutsfit: posts small blind $2.50
evo.com: posts big blind $5
*** HOLE CARDS ***
jjisnoob: folds
EHJOOJOO6543: folds
z4muz: raises $6 to $11
Rabarber77: folds
Nutsfit: folds
jjisnoob leaves the table
blakerr joins the table at seat #4
evo.com: folds
Uncalled bet ($6) returned to z4muz
z4muz collected $12.50 from pot
z4muz: doesn't show hand
*** SUMMARY ***
Total pot $12.50 | Rake $0
Seat 1: Rabarber77 (button) folded before Flop (didn't bet)
Seat 2: Nutsfit (small blind) folded before Flop
Seat 3: evo.com (big blind) folded before Flop
Seat 4: jjisnoob folded before Flop (didn't bet)
Seat 5: EHJOOJOO6543 folded before Flop (didn't bet)
Seat 6: z4muz collected ($12.50)


PokerStars Hand #222982189813:  Hold'em No Limit ($2.50/$5.00 USD) - 2021/01/23 20:52:41 ET
Table 'Aaltje II' 6-max Seat #2 is the button
Seat 1: Rabarber77 ($320.72 in chips)
Seat 2: Nutsfit ($823.79 in chips)
Seat 3: evo.com ($506.74 in chips)
Seat 4: blakerr ($500 in chips)
Seat 5: EHJOOJOO6543 ($584.87 in chips)
Seat 6: z4muz ($610.56 in chips)
evo.com: posts small blind $2.50
blakerr: posts big blind $5
*** HOLE CARDS ***
EHJOOJOO6543: folds
z4muz: raises $6 to $11
Rabarber77: folds
Nutsfit: folds
evo.com: folds
blakerr: folds
Uncalled bet ($6) returned to z4muz
z4muz collected $12.50 from pot
z4muz: doesn't show hand
*** SUMMARY ***
Total pot $12.50 | Rake $0
Seat 1: Rabarber77 folded before Flop (didn't bet)
Seat 2: Nutsfit (button) folded before Flop (didn't bet)
Seat 3: evo.com (small blind) folded before Flop
Seat 4: blakerr (big blind) folded before Flop
Seat 5: EHJOOJOO6543 folded before Flop (didn't bet)
Seat 6: z4muz collected ($12.50)


PokerStars Hand #222982198375:  Hold'em No Limit ($2.50/$5.00 USD) - 2021/01/23 20:53:02 ET
Table 'Aaltje II' 6-max Seat #3 is the button
Seat 1: Rabarber77 ($320.72 in chips)
Seat 2: Nutsfit ($823.79 in chips)
Seat 3: evo.com ($504.24 in chips)
Seat 4: blakerr ($495 in chips)
Seat 5: EHJOOJOO6543 ($584.87 in chips)
Seat 6: z4muz ($618.06 in chips)
blakerr: posts small blind $2.50
EHJOOJOO6543: posts big blind $5
*** HOLE CARDS ***
z4muz: folds
Rabarber77: folds
Nutsfit: raises $7.50 to $12.50
evo.com: folds
blakerr: folds
EHJOOJOO6543: folds
Uncalled bet ($7.50) returned to Nutsfit
Nutsfit collected $12.50 from pot
Nutsfit: doesn't show hand
*** SUMMARY ***
Total pot $12.50 | Rake $0
Seat 1: Rabarber77 folded before Flop (didn't bet)
Seat 2: Nutsfit collected ($12.50)
Seat 3: evo.com (button) folded before Flop (didn't bet)
Seat 4: blakerr (small blind) folded before Flop
Seat 5: EHJOOJOO6543 (big blind) folded before Flop
Seat 6: z4muz folded before Flop (didn't bet)


PokerStars Hand #222982204663:  Hold'em No Limit ($2.50/$5.00 USD) - 2021/01/23 20:53:18 ET
Table 'Aaltje II' 6-max Seat #4 is the button
Seat 1: Rabarber77 ($320.72 in chips)
Seat 2: Nutsfit ($831.29 in chips)
Seat 3: evo.com ($504.24 in chips)
Seat 4: blakerr ($492.50 in chips)
Seat 5: EHJOOJOO6543 ($579.87 in chips)
Seat 6: z4muz ($618.06 in chips)
EHJOOJOO6543: posts small blind $2.50
z4muz: posts big blind $5
*** HOLE CARDS ***
Rabarber77: folds
Nutsfit: folds
evo.com: folds
blakerr: folds
EHJOOJOO6543: folds
Uncalled bet ($2.50) returned to z4muz
z4muz collected $5 from pot
z4muz: doesn't show hand
*** SUMMARY ***
Total pot $5 | Rake $0
Seat 1: Rabarber77 folded before Flop (didn't bet)
Seat 2: Nutsfit folded before Flop (didn't bet)
Seat 3: evo.com folded before Flop (didn't bet)
Seat 4: blakerr (button) folded before Flop (didn't bet)
Seat 5: EHJOOJOO6543 (small blind) folded before Flop
Seat 6: z4muz (big blind) collected ($5)


PokerStars Hand #222982210975:  Hold'em No Limit ($2.50/$5.00 USD) - 2021/01/23 20:53:33 ET
Table 'Aaltje II' 6-max Seat #5 is the button
Seat 1: Rabarber77 ($320.72 in chips)
Seat 2: Nutsfit ($831.29 in chips)
Seat 3: evo.com ($504.24 in chips)
Seat 4: blakerr ($492.50 in chips)
Seat 5: EHJOOJOO6543 ($577.37 in chips)
Seat 6: z4muz ($620.56 in chips)
z4muz: posts small blind $2.50
Rabarber77: posts big blind $5
*** HOLE CARDS ***
Nutsfit: folds
evo.com: folds
blakerr: raises $7.50 to $12.50
EHJOOJOO6543: folds
z4muz: calls $10
Rabarber77: calls $7.50
*** FLOP *** [9d 4s Kd]
z4muz: checks
Rabarber77: bets $17.81
blakerr: folds
z4muz: folds
Uncalled bet ($17.81) returned to Rabarber77
Rabarber77 collected $35.62 from pot
Rabarber77: doesn't show hand
*** SUMMARY ***
Total pot $37.50 | Rake $1.88
Board [9d 4s Kd]
Seat 1: Rabarber77 (big blind) collected ($35.62)
Seat 2: Nutsfit folded before Flop (didn't bet)
Seat 3: evo.com folded before Flop (didn't bet)
Seat 4: blakerr folded on the Flop
Seat 5: EHJOOJOO6543 (button) folded before Flop (didn't bet)
Seat 6: z4muz (small blind) folded on the Flop


PokerStars Hand #222982235801:  Hold'em No Limit ($2.50/$5.00 USD) - 2021/01/23 20:54:35 ET
Table 'Aaltje II' 6-max Seat #6 is the button
Seat 1: Rabarber77 ($343.84 in chips)
Seat 2: Nutsfit ($831.29 in chips)
Seat 3: evo.com ($504.24 in chips)
Seat 4: blakerr ($480 in chips)
Seat 5: EHJOOJOO6543 ($577.37 in chips)
Seat 6: z4muz ($608.06 in chips)
Rabarber77: posts small blind $2.50
Nutsfit: posts big blind $5
*** HOLE CARDS ***
evo.com: folds
blakerr: folds
EHJOOJOO6543: folds
z4muz: folds
Rabarber77: calls $2.50
Nutsfit: checks
*** FLOP *** [2s 7s 8d]
Rabarber77: checks
Nutsfit: bets $5
Rabarber77: calls $5
*** TURN *** [2s 7s 8d] [4s]
Rabarber77: checks
Nutsfit: bets $9.69
Rabarber77: raises $38.38 to $48.07
Nutsfit: folds
Uncalled bet ($38.38) returned to Rabarber77
Rabarber77 collected $37.41 from pot
Rabarber77: doesn't show hand
*** SUMMARY ***
Total pot $39.38 | Rake $1.97
Board [2s 7s 8d 4s]
Seat 1: Rabarber77 (small blind) collected ($37.41)
Seat 2: Nutsfit (big blind) folded on the Turn
Seat 3: evo.com folded before Flop (didn't bet)
Seat 4: blakerr folded before Flop (didn't bet)
Seat 5: EHJOOJOO6543 folded before Flop (didn't bet)
Seat 6: z4muz (button) folded before Flop (didn't bet)


PokerStars Hand #222982266590:  Hold'em No Limit ($2.50/$5.00 USD) - 2021/01/23 20:56:03 ET
Table 'Aaltje II' 6-max Seat #1 is the button
Seat 1: Rabarber77 ($361.56 in chips)
Seat 2: Nutsfit ($811.60 in chips)
Seat 3: evo.com ($504.24 in chips)
Seat 4: blakerr ($480 in chips)
Seat 5: EHJOOJOO6543 ($577.37 in chips)
Seat 6: z4muz ($608.06 in chips)
Nutsfit: posts small blind $2.50
evo.com: posts big blind $5
*** HOLE CARDS ***
blakerr: folds
EHJOOJOO6543: folds
z4muz: folds
Rabarber77: folds
Nutsfit: folds
Uncalled bet ($2.50) returned to evo.com
evo.com collected $5 from pot
*** SUMMARY ***
Total pot $5 | Rake $0
Seat 1: Rabarber77 (button) folded before Flop (didn't bet)
Seat 2: Nutsfit (small blind) folded before Flop
Seat 3: evo.com (big blind) collected ($5)
Seat 4: blakerr folded before Flop (didn't bet)
Seat 5: EHJOOJOO6543 folded before Flop (didn't bet)
Seat 6: z4muz folded before Flop (didn't bet)


PokerStars Hand #222982273557:  Hold'em No Limit ($2.50/$5.00 USD) - 2021/01/23 20:56:19 ET
Table 'Aaltje II' 6-max Seat #2 is the button
Seat 1: Rabarber77 ($361.56 in chips)
Seat 2: Nutsfit ($809.10 in chips)
Seat 3: evo.com ($506.74 in chips)
Seat 4: blakerr ($480 in chips)
Seat 5: EHJOOJOO6543 ($577.37 in chips)
Seat 6: z4muz ($608.06 in chips)
evo.com: posts small blind $2.50
blakerr: posts big blind $5
*** HOLE CARDS ***
EHJOOJOO6543: folds
z4muz: folds
Rabarber77: folds
Nutsfit: raises $7.50 to $12.50
evo.com: folds
z4muz leaves the table
blakerr: folds
Uncalled bet ($7.50) returned to Nutsfit
Nutsfit collected $12.50 from pot
Nutsfit: doesn't show hand
*** SUMMARY ***
Total pot $12.50 | Rake $0
Seat 1: Rabarber77 folded before Flop (didn't bet)
Seat 2: Nutsfit (button) collected ($12.50)
Seat 3: evo.com (small blind) folded before Flop
Seat 4: blakerr (big blind) folded before Flop
Seat 5: EHJOOJOO6543 folded before Flop (didn't bet)
Seat 6: z4muz folded before Flop (didn't bet)


PokerStars Hand #222982281523:  Hold'em No Limit ($2.50/$5.00 USD) - 2021/01/23 20:56:44 ET
Table 'Aaltje II' 6-max Seat #3 is the button
Seat 1: Rabarber77 ($361.56 in chips)
Seat 2: Nutsfit ($816.60 in chips)
Seat 3: evo.com ($504.24 in chips)
Seat 4: blakerr ($475 in chips)
Seat 5: EHJOOJOO6543 ($577.37 in chips)
blakerr: posts small blind $2.50
EHJOOJOO6543: posts big blind $5
*** HOLE CARDS ***
Rabarber77: raises $5 to $10
Nutsfit: folds
evo.com: folds
blakerr: folds
EHJOOJOO6543: folds
Uncalled bet ($5) returned to Rabarber77
Rabarber77 collected $12.50 from pot
Rabarber77: doesn't show hand
*** SUMMARY ***
Total pot $12.50 | Rake $0
Seat 1: Rabarber77 collected ($12.50)
Seat 2: Nutsfit folded before Flop (didn't bet)
Seat 3: evo.com (button) folded before Flop (didn't bet)
Seat 4: blakerr (small blind) folded before Flop
Seat 5: EHJOOJOO6543 (big blind) folded before Flop


PokerStars Hand #222982288152:  Hold'em No Limit ($2.50/$5.00 USD) - 2021/01/23 20:57:05 ET
Table 'Aaltje II' 6-max Seat #4 is the button
Seat 1: Rabarber77 ($369.06 in chips)
Seat 2: Nutsfit ($816.60 in chips)
Seat 3: evo.com ($504.24 in chips)
Seat 4: blakerr ($472.50 in chips)
Seat 5: EHJOOJOO6543 ($572.37 in chips)
EHJOOJOO6543: posts small blind $2.50
Rabarber77: posts big blind $5
*** HOLE CARDS ***
Nutsfit: raises $5.90 to $10.90
evo.com: raises $29.10 to $40
blakerr: raises $62.50 to $102.50
EHJOOJOO6543: folds
Rabarber77: folds
Nutsfit: folds
evo.com: folds
Uncalled bet ($62.50) returned to blakerr
blakerr collected $98.40 from pot
blakerr: doesn't show hand
*** SUMMARY ***
Total pot $98.40 | Rake $0
Seat 1: Rabarber77 (big blind) folded before Flop
Seat 2: Nutsfit folded before Flop
Seat 3: evo.com folded before Flop
Seat 4: blakerr (button) collected ($98.40)
Seat 5: EHJOOJOO6543 (small blind) folded before Flop


PokerStars Hand #222982303056:  Hold'em No Limit ($2.50/$5.00 USD) - 2021/01/23 20:57:53 ET
Table 'Aaltje II' 6-max Seat #5 is the button
Seat 1: Rabarber77 ($364.06 in chips)
Seat 2: Nutsfit ($805.70 in chips)
Seat 3: evo.com ($500 in chips)
Seat 4: blakerr ($530.90 in chips)
Seat 5: EHJOOJOO6543 ($569.87 in chips)
Rabarber77: posts small blind $2.50
Nutsfit: posts big blind $5
*** HOLE CARDS ***
evo.com: folds
blakerr: folds
EHJOOJOO6543: raises $7.50 to $12.50
Rabarber77: folds
Nutsfit: calls $7.50
*** FLOP *** [Ts 8s 9h]
Nutsfit: checks
EHJOOJOO6543: bets $6.53
Nutsfit: calls $6.53
*** TURN *** [Ts 8s 9h] [Jc]
Nutsfit: checks
EHJOOJOO6543: checks
*** RIVER *** [Ts 8s 9h Jc] [3d]
Nutsfit: checks
EHJOOJOO6543: bets $21.19
Nutsfit: folds
Uncalled bet ($21.19) returned to EHJOOJOO6543
EHJOOJOO6543 collected $38.53 from pot
EHJOOJOO6543: doesn't show hand
*** SUMMARY ***
Total pot $40.56 | Rake $2.03
Board [Ts 8s 9h Jc 3d]
Seat 1: Rabarber77 (small blind) folded before Flop
Seat 2: Nutsfit (big blind) folded on the River
Seat 3: evo.com folded before Flop (didn't bet)
Seat 4: blakerr folded before Flop (didn't bet)
Seat 5: EHJOOJOO6543 (button) collected ($38.53)


PokerStars Hand #222982339624:  Hold'em No Limit ($2.50/$5.00 USD) - 2021/01/23 20:59:49 ET
Table 'Aaltje II' 6-max Seat #1 is the button
Seat 1: Rabarber77 ($361.56 in chips)
Seat 2: Nutsfit ($786.67 in chips)
Seat 3: evo.com ($500 in chips)
Seat 4: blakerr ($530.90 in chips)
Seat 5: EHJOOJOO6543 ($589.37 in chips)
Nutsfit: posts small blind $2.50
evo.com: posts big blind $5
*** HOLE CARDS ***
blakerr: folds
EHJOOJOO6543: folds
Rabarber77: folds
Nutsfit: folds
Uncalled bet ($2.50) returned to evo.com
evo.com collected $5 from pot
*** SUMMARY ***
Total pot $5 | Rake $0
Seat 1: Rabarber77 (button) folded before Flop (didn't bet)
Seat 2: Nutsfit (small blind) folded before Flop
Seat 3: evo.com (big blind) collected ($5)
Seat 4: blakerr folded before Flop (didn't bet)
Seat 5: EHJOOJOO6543 folded before Flop (didn't bet)


PokerStars Hand #222982344867:  Hold'em No Limit ($2.50/$5.00 USD) - 2021/01/23 21:00:05 ET
Table 'Aaltje II' 6-max Seat #2 is the button
Seat 1: Rabarber77 ($361.56 in chips)
Seat 2: Nutsfit ($784.17 in chips)
Seat 3: evo.com ($502.50 in chips)
Seat 4: blakerr ($530.90 in chips)
Seat 5: EHJOOJOO6543 ($589.37 in chips)
evo.com: posts small blind $2.50
blakerr: posts big blind $5
*** HOLE CARDS ***
EHJOOJOO6543: folds
Rabarber77: raises $10 to $15
Nutsfit: folds
evo.com: folds
blakerr: folds
Uncalled bet ($10) returned to Rabarber77
Rabarber77 collected $12.50 from pot
Rabarber77: doesn't show hand
*** SUMMARY ***
Total pot $12.50 | Rake $0
Seat 1: Rabarber77 collected ($12.50)
Seat 2: Nutsfit (button) folded before Flop (didn't bet)
Seat 3: evo.com (small blind) folded before Flop
Seat 4: blakerr (big blind) folded before Flop
Seat 5: EHJOOJOO6543 folded before Flop (didn't bet)


PokerStars Hand #222982359144:  Hold'em No Limit ($2.50/$5.00 USD) - 2021/01/23 21:00:45 ET
Table 'Aaltje II' 6-max Seat #3 is the button
Seat 1: Rabarber77 ($369.06 in chips)
Seat 2: Nutsfit ($784.17 in chips)
Seat 3: evo.com ($500 in chips)
Seat 4: blakerr ($525.90 in chips)
Seat 5: EHJOOJOO6543 ($589.37 in chips)
blakerr: posts small blind $2.50
EHJOOJOO6543: posts big blind $5
*** HOLE CARDS ***
Rabarber77: folds
Nutsfit: folds
evo.com: folds
blakerr: folds
Uncalled bet ($2.50) returned to EHJOOJOO6543
EHJOOJOO6543 collected $5 from pot
EHJOOJOO6543: doesn't show hand
*** SUMMARY ***
Total pot $5 | Rake $0
Seat 1: Rabarber77 folded before Flop (didn't bet)
Seat 2: Nutsfit folded before Flop (didn't bet)
Seat 3: evo.com (button) folded before Flop (didn't bet)
Seat 4: blakerr (small blind) folded before Flop
Seat 5: EHJOOJOO6543 (big blind) collected ($5)


PokerStars Hand #222982373472:  Hold'em No Limit ($2.50/$5.00 USD) - 2021/01/23 21:01:07 ET
Table 'Aaltje II' 6-max Seat #4 is the button
Seat 1: Rabarber77 ($369.06 in chips)
Seat 2: Nutsfit ($784.17 in chips)
Seat 3: evo.com ($500 in chips)
Seat 4: blakerr ($523.40 in chips)
Seat 5: EHJOOJOO6543 ($591.87 in chips)
EHJOOJOO6543: posts small blind $2.50
Rabarber77: posts big blind $5
*** HOLE CARDS ***
NZQT joins the table at seat #6
Nutsfit: folds
evo.com: raises $6 to $11
blakerr: folds
EHJOOJOO6543: folds
Rabarber77: calls $6
*** FLOP *** [6s 3h 9s]
Rabarber77: checks
evo.com: bets $20
Rabarber77: calls $20
*** TURN *** [6s 3h 9s] [4s]
Rabarber77: checks
evo.com: bets $40
Rabarber77: calls $40
*** RIVER *** [6s 3h 9s 4s] [Js]
Rabarber77: checks
evo.com: bets $110
Rabarber77: calls $110
*** SHOW DOWN ***
evo.com: shows [Th As] (a flush, Ace high)
Rabarber77: mucks hand
evo.com collected $361.50 from pot
*** SUMMARY ***
Total pot $364.50 | Rake $3
Board [6s 3h 9s 4s Js]
Seat 1: Rabarber77 (big blind) mucked
Seat 2: Nutsfit folded before Flop (didn't bet)
Seat 3: evo.com showed [Th As] and won ($361.50) with a flush, Ace high
Seat 4: blakerr (button) folded before Flop (didn't bet)
Seat 5: EHJOOJOO6543 (small blind) folded before Flop


PokerStars Hand #222982416229:  Hold'em No Limit ($2.50/$5.00 USD) - 2021/01/23 21:02:31 ET
Table 'Aaltje II' 6-max Seat #5 is the button
Seat 1: Rabarber77 ($188.06 in chips)
Seat 2: Nutsfit ($784.17 in chips)
Seat 3: evo.com ($680.50 in chips)
Seat 4: blakerr ($523.40 in chips)
Seat 5: EHJOOJOO6543 ($589.37 in chips)
Rabarber77: posts small blind $2.50
Nutsfit: posts big blind $5
*** HOLE CARDS ***
evo.com: raises $6 to $11
blakerr: folds
EHJOOJOO6543: folds
Rabarber77: calls $8.50
Nutsfit: folds
*** FLOP *** [Qs Ks 7c]
Rabarber77: checks
evo.com: checks
*** TURN *** [Qs Ks 7c] [7d]
Rabarber77: bets $25.65
evo.com: calls $25.65
*** RIVER *** [Qs Ks 7c 7d] [Ad]
Rabarber77: checks
evo.com: checks
*** SHOW DOWN ***
Rabarber77: shows [Kc 6c] (two pair, Kings and Sevens)
evo.com: shows [Jh Kd] (two pair, Kings and Sevens)
Rabarber77 collected $37.65 from pot
evo.com collected $37.65 from pot
*** SUMMARY ***
Total pot $78.30 | Rake $3
Board [Qs Ks 7c 7d Ad]
Seat 1: Rabarber77 (small blind) showed [Kc 6c] and won ($37.65) with two pair, Kings and Sevens
Seat 2: Nutsfit (big blind) folded before Flop
Seat 3: evo.com showed [Jh Kd] and won ($37.65) with two pair, Kings and Sevens
Seat 4: blakerr folded before Flop (didn't bet)
Seat 5: EHJOOJOO6543 (button) folded before Flop (didn't bet)


PokerStars Hand #222982442553:  Hold'em No Limit ($2.50/$5.00 USD) - 2021/01/23 21:03:34 ET
Table 'Aaltje II' 6-max Seat #1 is the button
Seat 1: Rabarber77 ($189.06 in chips)
Seat 2: Nutsfit ($779.17 in chips)
Seat 3: evo.com ($681.50 in chips)
Seat 4: blakerr ($523.40 in chips)
Seat 5: EHJOOJOO6543 ($589.37 in chips)
Nutsfit: posts small blind $2.50
evo.com: posts big blind $5
NZQT: sits out
*** HOLE CARDS ***
blakerr: folds
EHJOOJOO6543: raises $7.50 to $12.50
Rabarber77: calls $12.50
Nutsfit: raises $60 to $72.50
evo.com: folds
EHJOOJOO6543: folds
Rabarber77: calls $60
*** FLOP *** [Qs 7h 2d]
Nutsfit: bets $706.67 and is all-in
Rabarber77: folds
Uncalled bet ($706.67) returned to Nutsfit
Nutsfit collected $159.50 from pot
Nutsfit: doesn't show hand
*** SUMMARY ***
Total pot $162.50 | Rake $3
Board [Qs 7h 2d]
Seat 1: Rabarber77 (button) folded on the Flop
Seat 2: Nutsfit (small blind) collected ($159.50)
Seat 3: evo.com (big blind) folded before Flop
Seat 4: blakerr folded before Flop (didn't bet)
Seat 5: EHJOOJOO6543 folded before Flop


PokerStars Hand #222982461075:  Hold'em No Limit ($2.50/$5.00 USD) - 2021/01/23 21:04:18 ET
Table 'Aaltje II' 6-max Seat #2 is the button
Seat 1: Rabarber77 ($116.56 in chips)
Seat 2: Nutsfit ($866.17 in chips)
Seat 3: evo.com ($676.50 in chips)
Seat 4: blakerr ($523.40 in chips)
Seat 5: EHJOOJOO6543 ($576.87 in chips)
evo.com: posts small blind $2.50
blakerr: posts big blind $5
NZQT: sits out
*** HOLE CARDS ***
EHJOOJOO6543: folds
Rabarber77: raises $10 to $15
Nutsfit: folds
evo.com: folds
blakerr: folds
Uncalled bet ($10) returned to Rabarber77
Rabarber77 collected $12.50 from pot
Rabarber77: doesn't show hand
*** SUMMARY ***
Total pot $12.50 | Rake $0
Seat 1: Rabarber77 collected ($12.50)
Seat 2: Nutsfit (button) folded before Flop (didn't bet)
Seat 3: evo.com (small blind) folded before Flop
Seat 4: blakerr (big blind) folded before Flop
Seat 5: EHJOOJOO6543 folded before Flop (didn't bet)


PokerStars Hand #222982467931:  Hold'em No Limit ($2.50/$5.00 USD) - 2021/01/23 21:04:35 ET
Table 'Aaltje II' 6-max Seat #3 is the button
Seat 1: Rabarber77 ($124.06 in chips)
Seat 2: Nutsfit ($866.17 in chips)
Seat 3: evo.com ($674 in chips)
Seat 4: blakerr ($518.40 in chips)
Seat 5: EHJOOJOO6543 ($576.87 in chips)
blakerr: posts small blind $2.50
EHJOOJOO6543: posts big blind $5
NZQT: sits out
*** HOLE CARDS ***
Rabarber77: raises $10 to $15
Nutsfit: folds
evo.com: raises $25 to $40
blakerr: folds
EHJOOJOO6543: folds
Rabarber77: calls $25
*** FLOP *** [2c Qd Kd]
Rabarber77: checks
evo.com: bets $10
Rabarber77: calls $10
*** TURN *** [2c Qd Kd] [Tc]
Rabarber77: checks
evo.com: checks
*** RIVER *** [2c Qd Kd Tc] [7c]
Rabarber77: bets $52.25
evo.com: folds
Uncalled bet ($52.25) returned to Rabarber77
Rabarber77 collected $104.50 from pot
Rabarber77: doesn't show hand
*** SUMMARY ***
Total pot $107.50 | Rake $3
Board [2c Qd Kd Tc 7c]
Seat 1: Rabarber77 collected ($104.50)
Seat 2: Nutsfit folded before Flop (didn't bet)
Seat 3: evo.com (button) folded on the River
Seat 4: blakerr (small blind) folded before Flop
Seat 5: EHJOOJOO6543 (big blind) folded before Flop


PokerStars Hand #222982498798:  Hold'em No Limit ($2.50/$5.00 USD) - 2021/01/23 21:05:49 ET
Table 'Aaltje II' 6-max Seat #4 is the button
Seat 1: Rabarber77 ($178.56 in chips)
Seat 2: Nutsfit ($866.17 in chips)
Seat 3: evo.com ($624 in chips)
Seat 4: blakerr ($515.90 in chips)
Seat 5: EHJOOJOO6543 ($571.87 in chips)
Seat 6: NZQT ($500 in chips)
EHJOOJOO6543: posts small blind $2.50
NZQT: posts big blind $5
*** HOLE CARDS ***
Rabarber77: folds
Nutsfit: raises $5.90 to $10.90
evo.com: folds
blakerr: folds
EHJOOJOO6543: folds
NZQT: folds
Uncalled bet ($5.90) returned to Nutsfit
Nutsfit collected $12.50 from pot
Nutsfit: doesn't show hand
*** SUMMARY ***
Total pot $12.50 | Rake $0
Seat 1: Rabarber77 folded before Flop (didn't bet)
Seat 2: Nutsfit collected ($12.50)
Seat 3: evo.com folded before Flop (didn't bet)
Seat 4: blakerr (button) folded before Flop (didn't bet)
Seat 5: EHJOOJOO6543 (small blind) folded before Flop
Seat 6: NZQT (big blind) folded before Flop


PokerStars Hand #222982510784:  Hold'em No Limit ($2.50/$5.00 USD) - 2021/01/23 21:06:18 ET
Table 'Aaltje II' 6-max Seat #5 is the button
Seat 1: Rabarber77 ($178.56 in chips)
Seat 2: Nutsfit ($873.67 in chips)
Seat 3: evo.com ($624 in chips)
Seat 4: blakerr ($515.90 in chips)
Seat 5: EHJOOJOO6543 ($569.37 in chips)
Seat 6: NZQT ($500 in chips)
NZQT: posts small blind $2.50
Rabarber77: posts big blind $5
*** HOLE CARDS ***
Nutsfit: raises $5.90 to $10.90
evo.com: folds
blakerr: folds
EHJOOJOO6543: folds
NZQT: folds
Rabarber77: folds
Uncalled bet ($5.90) returned to Nutsfit
Nutsfit collected $12.50 from pot
Nutsfit: doesn't show hand
*** SUMMARY ***
Total pot $12.50 | Rake $0
Seat 1: Rabarber77 (big blind) folded before Flop
Seat 2: Nutsfit collected ($12.50)
Seat 3: evo.com folded before Flop (didn't bet)
Seat 4: blakerr folded before Flop (didn't bet)
Seat 5: EHJOOJOO6543 (button) folded before Flop (didn't bet)
Seat 6: NZQT (small blind) folded before Flop


PokerStars Hand #222982518307:  Hold'em No Limit ($2.50/$5.00 USD) - 2021/01/23 21:06:36 ET
Table 'Aaltje II' 6-max Seat #6 is the button
Seat 1: Rabarber77 ($173.56 in chips)
Seat 2: Nutsfit ($881.17 in chips)
Seat 3: evo.com ($624 in chips)
Seat 4: blakerr ($515.90 in chips)
Seat 5: EHJOOJOO6543 ($569.37 in chips)
Seat 6: NZQT ($500 in chips)
Rabarber77: posts small blind $2.50
Nutsfit: posts big blind $5
*** HOLE CARDS ***
evo.com: raises $6 to $11
blakerr has timed out
blakerr: folds
EHJOOJOO6543: folds
NZQT: folds
Rabarber77: folds
Nutsfit: folds
Uncalled bet ($6) returned to evo.com
evo.com collected $12.50 from pot
*** SUMMARY ***
Total pot $12.50 | Rake $0
Seat 1: Rabarber77 (small blind) folded before Flop
Seat 2: Nutsfit (big blind) folded before Flop
Seat 3: evo.com collected ($12.50)
Seat 4: blakerr folded before Flop (didn't bet)
Seat 5: EHJOOJOO6543 folded before Flop (didn't bet)
Seat 6: NZQT (button) folded before Flop (didn't bet)


PokerStars Hand #222982530112:  Hold'em No Limit ($2.50/$5.00 USD) - 2021/01/23 21:07:04 ET
Table 'Aaltje II' 6-max Seat #1 is the button
Seat 1: Rabarber77 ($171.06 in chips)
Seat 2: Nutsfit ($876.17 in chips)
Seat 5: EHJOOJOO6543 ($569.37 in chips)
Seat 6: NZQT ($500 in chips)
Nutsfit: posts small blind $2.50
evo.com: is sitting out
EHJOOJOO6543: posts big blind $5
*** HOLE CARDS ***
NZQT: folds
Rabarber77: raises $10 to $15
evo.com leaves the table
Nutsfit: folds
EHJOOJOO6543: calls $10
*** FLOP *** [2d 4s 9h]
EHJOOJOO6543: checks
el.suertero joins the table at seat #3
Rabarber77: bets $25
EHJOOJOO6543: raises $529.37 to $554.37 and is all-in
blakerr leaves the table
Rabarber77: folds
Uncalled bet ($529.37) returned to EHJOOJOO6543
EHJOOJOO6543 collected $81 from pot
EHJOOJOO6543: doesn't show hand
*** SUMMARY ***
Total pot $82.50 | Rake $1.50
Board [2d 4s 9h]
Seat 1: Rabarber77 (button) folded on the Flop
Seat 2: Nutsfit (small blind) folded before Flop
Seat 5: EHJOOJOO6543 (big blind) collected ($81)
Seat 6: NZQT folded before Flop (didn't bet)


PokerStars Hand #222982549354:  Hold'em No Limit ($2.50/$5.00 USD) - 2021/01/23 21:07:51 ET
Table 'Aaltje II' 6-max Seat #2 is the button
Seat 1: Rabarber77 ($131.06 in chips)
Seat 2: Nutsfit ($873.67 in chips)
Seat 5: EHJOOJOO6543 ($610.37 in chips)
Seat 6: NZQT ($500 in chips)
EHJOOJOO6543: posts small blind $2.50
NZQT: posts big blind $5
*** HOLE CARDS ***
Rabarber77: folds
Nutsfit: raises $7.50 to $12.50
EHJOOJOO6543: folds
NZQT: raises $40 to $52.50
Nutsfit: folds
Uncalled bet ($40) returned to NZQT
NZQT collected $27.50 from pot
NZQT: doesn't show hand
*** SUMMARY ***
Total pot $27.50 | Rake $0
Seat 1: Rabarber77 folded before Flop (didn't bet)
Seat 2: Nutsfit (button) folded before Flop
Seat 5: EHJOOJOO6543 (small blind) folded before Flop
Seat 6: NZQT (big blind) collected ($27.50)


PokerStars Hand #222982557765:  Hold'em No Limit ($2.50/$5.00 USD) - 2021/01/23 21:08:11 ET
Table 'Aaltje II' 6-max Seat #5 is the button
Seat 1: Rabarber77 ($131.06 in chips)
Seat 2: Nutsfit ($861.17 in chips)
Seat 5: EHJOOJOO6543 ($607.87 in chips)
Seat 6: NZQT ($515 in chips)
NZQT: posts small blind $2.50
Rabarber77: posts big blind $5
el.suertero: sits out
*** HOLE CARDS ***
Nutsfit: folds
EHJOOJOO6543: folds
NZQT: raises $9.50 to $14.50
Rabarber77: calls $9.50
*** FLOP *** [7d 9d 5c]
NZQT: bets $10.74
Rabarber77: calls $10.74
*** TURN *** [7d 9d 5c] [7c]
NZQT: checks
Rabarber77: bets $25
NZQT: raises $464.76 to $489.76 and is all-in
Rabarber77: folds
Uncalled bet ($464.76) returned to NZQT
NZQT collected $98.98 from pot
NZQT: doesn't show hand
*** SUMMARY ***
Total pot $100.48 | Rake $1.50
Board [7d 9d 5c 7c]
Seat 1: Rabarber77 (big blind) folded on the Turn
Seat 2: Nutsfit folded before Flop (didn't bet)
Seat 5: EHJOOJOO6543 (button) folded before Flop (didn't bet)
Seat 6: NZQT (small blind) collected ($98.98)


PokerStars Hand #222982576434:  Hold'em No Limit ($2.50/$5.00 USD) - 2021/01/23 21:08:57 ET
Table 'Aaltje II' 6-max Seat #6 is the button
Seat 1: Rabarber77 ($80.82 in chips)
Seat 2: Nutsfit ($861.17 in chips)
Seat 5: EHJOOJOO6543 ($607.87 in chips)
Seat 6: NZQT ($563.74 in chips)
Rabarber77: posts small blind $2.50
Nutsfit: posts big blind $5
el.suertero: sits out
*** HOLE CARDS ***
EHJOOJOO6543: folds
NZQT: raises $6 to $11
Rabarber77: folds
Nutsfit: calls $6
*** FLOP *** [Ah Td 8c]
Nutsfit: checks
NZQT: bets $6.05
Nutsfit: calls $6.05
*** TURN *** [Ah Td 8c] [8h]
Nutsfit: checks
NZQT: bets $23.52
Nutsfit: raises $55.03 to $78.55
NZQT: calls $55.03
*** RIVER *** [Ah Td 8c 8h] [Qd]
Nutsfit: bets $67.50
NZQT: raises $109.22 to $176.72
Nutsfit: calls $109.22
*** SHOW DOWN ***
NZQT: shows [8s 9c] (three of a kind, Eights)
Nutsfit: shows [8d Kh] (three of a kind, Eights - Ace+King kicker)
Nutsfit collected $545.64 from pot
*** SUMMARY ***
Total pot $547.14 | Rake $1.50
Board [Ah Td 8c 8h Qd]
Seat 1: Rabarber77 (small blind) folded before Flop
Seat 2: Nutsfit (big blind) showed [8d Kh] and won ($545.64) with three of a kind, Eights
Seat 5: EHJOOJOO6543 folded before Flop (didn't bet)
Seat 6: NZQT (button) showed [8s 9c] and lost with three of a kind, Eights


PokerStars Hand #222982630724:  Hold'em No Limit ($2.50/$5.00 USD) - 2021/01/23 21:11:08 ET
Table 'Aaltje II' 6-max Seat #1 is the button
Seat 1: Rabarber77 ($461 in chips)
Seat 2: Nutsfit ($1134.49 in chips)
Seat 3: el.suertero ($500 in chips)
Seat 5: EHJOOJOO6543 ($607.87 in chips)
Seat 6: NZQT ($500 in chips)
Nutsfit: posts small blind $2.50
el.suertero: posts big blind $5
*** HOLE CARDS ***
EHJOOJOO6543: folds
NZQT: folds
Rabarber77: folds
Nutsfit: folds
Uncalled bet ($2.50) returned to el.suertero
el.suertero collected $5 from pot
el.suertero: doesn't show hand
*** SUMMARY ***
Total pot $5 | Rake $0
Seat 1: Rabarber77 (button) folded before Flop (didn't bet)
Seat 2: Nutsfit (small blind) folded before Flop
Seat 3: el.suertero (big blind) collected ($5)
Seat 5: EHJOOJOO6543 folded before Flop (didn't bet)
Seat 6: NZQT folded before Flop (didn't bet)


PokerStars Hand #222982635035:  Hold'em No Limit ($2.50/$5.00 USD) - 2021/01/23 21:11:18 ET
Table 'Aaltje II' 6-max Seat #2 is the button
Seat 1: Rabarber77 ($461 in chips)
Seat 2: Nutsfit ($1131.99 in chips)
Seat 3: el.suertero ($502.50 in chips)
Seat 5: EHJOOJOO6543 ($607.87 in chips)
Seat 6: NZQT ($500 in chips)
el.suertero: posts small blind $2.50
EHJOOJOO6543: posts big blind $5
*** HOLE CARDS ***
NZQT: folds
Rabarber77: raises $10 to $15
Nutsfit: folds
el.suertero: folds
EHJOOJOO6543: calls $10
*** FLOP *** [5d 6c 2d]
EHJOOJOO6543: checks
Rabarber77: bets $35
EHJOOJOO6543: calls $35
*** TURN *** [5d 6c 2d] [6s]
EHJOOJOO6543: checks
Rabarber77: checks
*** RIVER *** [5d 6c 2d 6s] [2h]
EHJOOJOO6543: checks
Rabarber77: bets $45
EHJOOJOO6543: calls $45
*** SHOW DOWN ***
Rabarber77: shows [Jc Qd] (two pair, Sixes and Deuces)
EHJOOJOO6543: shows [Ks 5s] (two pair, Sixes and Fives)
EHJOOJOO6543 collected $189.50 from pot
*** SUMMARY ***
Total pot $192.50 | Rake $3
Board [5d 6c 2d 6s 2h]
Seat 1: Rabarber77 showed [Jc Qd] and lost with two pair, Sixes and Deuces
Seat 2: Nutsfit (button) folded before Flop (didn't bet)
Seat 3: el.suertero (small blind) folded before Flop
Seat 5: EHJOOJOO6543 (big blind) showed [Ks 5s] and won ($189.50) with two pair, Sixes and Fives
Seat 6: NZQT folded before Flop (didn't bet)


PokerStars Hand #222982676830:  Hold'em No Limit ($2.50/$5.00 USD) - 2021/01/23 21:12:49 ET
Table 'Aaltje II' 6-max Seat #5 is the button
Seat 2: Nutsfit ($1131.99 in chips)
Seat 3: el.suertero ($515.88 in chips)
Seat 5: EHJOOJOO6543 ($699.87 in chips)
Seat 6: NZQT ($500 in chips)
NZQT: posts small blind $2.50
Nutsfit: posts big blind $5
*** HOLE CARDS ***
el.suertero: folds
EHJOOJOO6543: folds
NZQT: folds
Uncalled bet ($2.50) returned to Nutsfit
Nutsfit collected $5 from pot
Nutsfit: doesn't show hand
*** SUMMARY ***
Total pot $5 | Rake $0
Seat 2: Nutsfit (big blind) collected ($5)
Seat 3: el.suertero folded before Flop (didn't bet)
Seat 5: EHJOOJOO6543 (button) folded before Flop (didn't bet)
Seat 6: NZQT (small blind) folded before Flop


PokerStars Hand #222982662478:  Hold'em No Limit ($2.50/$5.00 USD) - 2021/01/23 21:12:14 ET
Table 'Aaltje II' 6-max Seat #3 is the button
Seat 1: Rabarber77 ($366 in chips)
Seat 2: Nutsfit ($1131.99 in chips)
Seat 3: el.suertero ($500 in chips)
Seat 5: EHJOOJOO6543 ($702.37 in chips)
Seat 6: NZQT ($500 in chips)
EHJOOJOO6543: posts small blind $2.50
NZQT: posts big blind $5
*** HOLE CARDS ***
Rabarber77: folds
Nutsfit: folds
el.suertero: raises $10 to $15
EHJOOJOO6543: folds
NZQT: calls $10
*** FLOP *** [Kc 7d 8c]
NZQT: checks
el.suertero: bets $30.88
NZQT: folds
Uncalled bet ($30.88) returned to el.suertero
el.suertero collected $30.88 from pot
el.suertero: doesn't show hand
*** SUMMARY ***
Total pot $32.50 | Rake $1.62
Board [Kc 7d 8c]
Seat 1: Rabarber77 folded before Flop (didn't bet)
Seat 2: Nutsfit folded before Flop (didn't bet)
Seat 3: el.suertero (button) collected ($30.88)
Seat 5: EHJOOJOO6543 (small blind) folded before Flop
Seat 6: NZQT (big blind) folded on the Flop


PokerStars Hand #222982679904:  Hold'em No Limit ($2.50/$5.00 USD) - 2021/01/23 21:12:56 ET
Table 'Aaltje II' 6-max Seat #6 is the button
Seat 2: Nutsfit ($1134.49 in chips)
Seat 3: el.suertero ($515.88 in chips)
Seat 5: EHJOOJOO6543 ($699.87 in chips)
Seat 6: NZQT ($500 in chips)
Nutsfit: posts small blind $2.50
el.suertero: posts big blind $5
*** HOLE CARDS ***
EHJOOJOO6543: folds
NZQT: raises $6 to $11
Nutsfit: folds
el.suertero: folds
Uncalled bet ($6) returned to NZQT
NZQT collected $12.50 from pot
NZQT: doesn't show hand
*** SUMMARY ***
Total pot $12.50 | Rake $0
Seat 2: Nutsfit (small blind) folded before Flop
Seat 3: el.suertero (big blind) folded before Flop
Seat 5: EHJOOJOO6543 folded before Flop (didn't bet)
Seat 6: NZQT (button) collected ($12.50)


PokerStars Hand #222982684888:  Hold'em No Limit ($2.50/$5.00 USD) - 2021/01/23 21:13:09 ET
Table 'Aaltje II' 6-max Seat #2 is the button
Seat 2: Nutsfit ($1131.99 in chips)
Seat 3: el.suertero ($510.88 in chips)
Seat 5: EHJOOJOO6543 ($699.87 in chips)
Seat 6: NZQT ($507.50 in chips)
el.suertero: posts small blind $2.50
EHJOOJOO6543: posts big blind $5
*** HOLE CARDS ***
NZQT: folds
Nutsfit: folds
el.suertero: raises $10 to $15
EHJOOJOO6543: folds
Uncalled bet ($10) returned to el.suertero
el.suertero collected $10 from pot
el.suertero: doesn't show hand
*** SUMMARY ***
Total pot $10 | Rake $0
Seat 2: Nutsfit (button) folded before Flop (didn't bet)
Seat 3: el.suertero (small blind) collected ($10)
Seat 5: EHJOOJOO6543 (big blind) folded before Flop
Seat 6: NZQT folded before Flop (didn't bet)


PokerStars Hand #222982691234:  Hold'em No Limit ($2.50/$5.00 USD) - 2021/01/23 21:13:24 ET
Table 'Aaltje II' 6-max Seat #3 is the button
Seat 2: Nutsfit ($1131.99 in chips)
Seat 3: el.suertero ($515.88 in chips)
Seat 5: EHJOOJOO6543 ($694.87 in chips)
Seat 6: NZQT ($507.50 in chips)
EHJOOJOO6543: posts small blind $2.50
NZQT: posts big blind $5
*** HOLE CARDS ***
Nutsfit: raises $7.50 to $12.50
el.suertero: folds
EHJOOJOO6543: folds
NZQT: folds
Uncalled bet ($7.50) returned to Nutsfit
Nutsfit collected $12.50 from pot
Nutsfit: doesn't show hand
*** SUMMARY ***
Total pot $12.50 | Rake $0
Seat 2: Nutsfit collected ($12.50)
Seat 3: el.suertero (button) folded before Flop (didn't bet)
Seat 5: EHJOOJOO6543 (small blind) folded before Flop
Seat 6: NZQT (big blind) folded before Flop


PokerStars Hand #222982700874:  Hold'em No Limit ($2.50/$5.00 USD) - 2021/01/23 21:13:48 ET
Table 'Aaltje II' 6-max Seat #5 is the button
Seat 2: Nutsfit ($1139.49 in chips)
Seat 3: el.suertero ($515.88 in chips)
Seat 5: EHJOOJOO6543 ($692.37 in chips)
Seat 6: NZQT ($502.50 in chips)
NZQT: posts small blind $2.50
Nutsfit: posts big blind $5
*** HOLE CARDS ***
el.suertero: folds
EHJOOJOO6543: folds
NZQT: folds
Uncalled bet ($2.50) returned to Nutsfit
Nutsfit collected $5 from pot
Nutsfit: doesn't show hand
*** SUMMARY ***
Total pot $5 | Rake $0
Seat 2: Nutsfit (big blind) collected ($5)
Seat 3: el.suertero folded before Flop (didn't bet)
Seat 5: EHJOOJOO6543 (button) folded before Flop (didn't bet)
Seat 6: NZQT (small blind) folded before Flop


PokerStars Hand #222982704851:  Hold'em No Limit ($2.50/$5.00 USD) - 2021/01/23 21:13:58 ET
Table 'Aaltje II' 6-max Seat #6 is the button
Seat 2: Nutsfit ($1141.99 in chips)
Seat 3: el.suertero ($515.88 in chips)
Seat 5: EHJOOJOO6543 ($692.37 in chips)
Seat 6: NZQT ($500 in chips)
Nutsfit: posts small blind $2.50
el.suertero: posts big blind $5
*** HOLE CARDS ***
EHJOOJOO6543: folds
NZQT: folds
Nutsfit: calls $2.50
el.suertero: checks
*** FLOP *** [3c Ah 9d]
Nutsfit: bets $5
el.suertero: calls $5
*** TURN *** [3c Ah 9d] [Qc]
Nutsfit: bets $12.50
el.suertero: calls $12.50
*** RIVER *** [3c Ah 9d Qc] [7d]
Nutsfit: bets $22.19
el.suertero: calls $22.19
*** SHOW DOWN ***
Nutsfit: shows [Ks Th] (high card Ace)
el.suertero: shows [Ac 2h] (a pair of Aces)
el.suertero collected $87.88 from pot
*** SUMMARY ***
Total pot $89.38 | Rake $1.50
Board [3c Ah 9d Qc 7d]
Seat 2: Nutsfit (small blind) showed [Ks Th] and lost with high card Ace
Seat 3: el.suertero (big blind) showed [Ac 2h] and won ($87.88) with a pair of Aces
Seat 5: EHJOOJOO6543 folded before Flop (didn't bet)
Seat 6: NZQT (button) folded before Flop (didn't bet)


PokerStars Hand #222982732038:  Hold'em No Limit ($2.50/$5.00 USD) - 2021/01/23 21:15:04 ET
Table 'Aaltje II' 6-max Seat #2 is the button
Seat 2: Nutsfit ($1097.30 in chips)
Seat 3: el.suertero ($559.07 in chips)
Seat 5: EHJOOJOO6543 ($692.37 in chips)
Seat 6: NZQT ($500 in chips)
el.suertero: posts small blind $2.50
EHJOOJOO6543: posts big blind $5
*** HOLE CARDS ***
NZQT: raises $6 to $11
Nutsfit: folds
el.suertero: folds
EHJOOJOO6543: calls $6
*** FLOP *** [Qh 6s 6h]
EHJOOJOO6543: checks
NZQT: bets $6.05
EHJOOJOO6543: calls $6.05
*** TURN *** [Qh 6s 6h] [6c]
EHJOOJOO6543: checks
NZQT: checks
*** RIVER *** [Qh 6s 6h 6c] [2h]
EHJOOJOO6543: bets $57.92
NZQT: folds
Uncalled bet ($57.92) returned to EHJOOJOO6543
EHJOOJOO6543 collected $35.10 from pot
EHJOOJOO6543: doesn't show hand
*** SUMMARY ***
Total pot $36.60 | Rake $1.50
Board [Qh 6s 6h 6c 2h]
Seat 2: Nutsfit (button) folded before Flop (didn't bet)
Seat 3: el.suertero (small blind) folded before Flop
Seat 5: EHJOOJOO6543 (big blind) collected ($35.10)
Seat 6: NZQT folded on the River


PokerStars Hand #222982756636:  Hold'em No Limit ($2.50/$5.00 USD) - 2021/01/23 21:16:04 ET
Table 'Aaltje II' 6-max Seat #3 is the button
Seat 1: Rabarber77 ($366 in chips)
Seat 2: Nutsfit ($1097.30 in chips)
Seat 3: el.suertero ($556.57 in chips)
Seat 5: EHJOOJOO6543 ($710.42 in chips)
EHJOOJOO6543: posts small blind $2.50
Rabarber77: posts big blind $5
*** HOLE CARDS ***
Nutsfit: folds
el.suertero: raises $10 to $15
EHJOOJOO6543: folds
Rabarber77: raises $40 to $55
el.suertero: calls $40
*** FLOP *** [Js Th 7h]
Rabarber77: bets $60
el.suertero: folds
Uncalled bet ($60) returned to Rabarber77
Rabarber77 collected $111 from pot
Rabarber77: doesn't show hand
*** SUMMARY ***
Total pot $112.50 | Rake $1.50
Board [Js Th 7h]
Seat 1: Rabarber77 (big blind) collected ($111)
Seat 2: Nutsfit folded before Flop (didn't bet)
Seat 3: el.suertero (button) folded on the Flop
Seat 5: EHJOOJOO6543 (small blind) folded before Flop


PokerStars Hand #222982768231:  Hold'em No Limit ($2.50/$5.00 USD) - 2021/01/23 21:16:32 ET
Table 'Aaltje II' 6-max Seat #5 is the button
Seat 1: Rabarber77 ($422 in chips)
Seat 2: Nutsfit ($1097.30 in chips)
Seat 3: el.suertero ($501.57 in chips)
Seat 5: EHJOOJOO6543 ($707.92 in chips)
Rabarber77: posts small blind $2.50
Nutsfit: posts big blind $5
*** HOLE CARDS ***
el.suertero: folds
EHJOOJOO6543 has timed out
EHJOOJOO6543: folds
Rabarber77: calls $2.50
Nutsfit: raises $15 to $20
Rabarber77: calls $15
*** FLOP *** [5h 9h 2h]
Rabarber77: checks
Nutsfit: bets $12.50
Rabarber77: calls $12.50
*** TURN *** [5h 9h 2h] [Ah]
Rabarber77: checks
Nutsfit: checks
*** RIVER *** [5h 9h 2h Ah] [7d]
Rabarber77: checks
Nutsfit: checks
*** SHOW DOWN ***
Rabarber77: shows [9s Qc] (a pair of Nines)
Nutsfit: shows [7h 8h] (a flush, Ace high)
Nutsfit collected $63.50 from pot
*** SUMMARY ***
Total pot $65 | Rake $1.50
Board [5h 9h 2h Ah 7d]
Seat 1: Rabarber77 (small blind) showed [9s Qc] and lost with a pair of Nines
Seat 2: Nutsfit (big blind) showed [7h 8h] and won ($63.50) with a flush, Ace high
Seat 3: el.suertero folded before Flop (didn't bet)
Seat 5: EHJOOJOO6543 (button) folded before Flop (didn't bet)


PokerStars Hand #222982790504:  Hold'em No Limit ($2.50/$5.00 USD) - 2021/01/23 21:17:27 ET
Table 'Aaltje II' 6-max Seat #1 is the button
Seat 1: Rabarber77 ($389.50 in chips)
Seat 2: Nutsfit ($1128.30 in chips)
Seat 3: el.suertero ($501.57 in chips)
Seat 5: EHJOOJOO6543 ($707.92 in chips)
Nutsfit: posts small blind $2.50
el.suertero: posts big blind $5
*** HOLE CARDS ***
EHJOOJOO6543: folds
Rabarber77: folds
Nutsfit: raises $10 to $15
el.suertero: raises $30 to $45
Nutsfit: calls $30
*** FLOP *** [5c 2s 4d]
Nutsfit: checks
el.suertero: bets $66.38
Nutsfit: calls $66.38
*** TURN *** [5c 2s 4d] [Ac]
Nutsfit: checks
el.suertero: checks
*** RIVER *** [5c 2s 4d Ac] [2d]
Nutsfit: checks
el.suertero: bets $73.02
Nutsfit: folds
Uncalled bet ($73.02) returned to el.suertero
el.suertero collected $221.26 from pot
el.suertero: doesn't show hand
*** SUMMARY ***
Total pot $222.76 | Rake $1.50
Board [5c 2s 4d Ac 2d]
Seat 1: Rabarber77 (button) folded before Flop (didn't bet)
Seat 2: Nutsfit (small blind) folded on the River
Seat 3: el.suertero (big blind) collected ($221.26)
Seat 5: EHJOOJOO6543 folded before Flop (didn't bet)


PokerStars Hand #222982824148:  Hold'em No Limit ($2.50/$5.00 USD) - 2021/01/23 21:18:41 ET
Table 'Aaltje II' 6-max Seat #2 is the button
Seat 1: Rabarber77 ($389.50 in chips)
Seat 2: Nutsfit ($1016.92 in chips)
Seat 3: el.suertero ($611.45 in chips)
Seat 5: EHJOOJOO6543 ($707.92 in chips)
el.suertero: posts small blind $2.50
EHJOOJOO6543: posts big blind $5
*** HOLE CARDS ***
Rabarber77: raises $10 to $15
Nutsfit: raises $30 to $45
el.suertero: folds
EHJOOJOO6543: folds
Rabarber77: calls $30
*** FLOP *** [4c 7h Th]
Rabarber77: checks
Nutsfit: checks
*** TURN *** [4c 7h Th] [Js]
Rabarber77: bets $48
Nutsfit: calls $48
*** RIVER *** [4c 7h Th Js] [7d]
Rabarber77: bets $96
Nutsfit: folds
Uncalled bet ($96) returned to Rabarber77
Rabarber77 collected $192 from pot
Rabarber77: doesn't show hand
*** SUMMARY ***
Total pot $193.50 | Rake $1.50
Board [4c 7h Th Js 7d]
Seat 1: Rabarber77 collected ($192)
Seat 2: Nutsfit (button) folded on the River
Seat 3: el.suertero (small blind) folded before Flop
Seat 5: EHJOOJOO6543 (big blind) folded before Flop


PokerStars Hand #222982847154:  Hold'em No Limit ($2.50/$5.00 USD) - 2021/01/23 21:19:38 ET
Table 'Aaltje II' 6-max Seat #3 is the button
Seat 1: Rabarber77 ($488.50 in chips)
Seat 2: Nutsfit ($923.92 in chips)
Seat 3: el.suertero ($608.95 in chips)
Seat 5: EHJOOJOO6543 ($702.92 in chips)
EHJOOJOO6543: posts small blind $2.50
Rabarber77: posts big blind $5
*** HOLE CARDS ***
Nutsfit: folds
el.suertero: folds
EHJOOJOO6543: folds
Uncalled bet ($2.50) returned to Rabarber77
Rabarber77 collected $5 from pot
Rabarber77: doesn't show hand
*** SUMMARY ***
Total pot $5 | Rake $0
Seat 1: Rabarber77 (big blind) collected ($5)
Seat 2: Nutsfit folded before Flop (didn't bet)
Seat 3: el.suertero (button) folded before Flop (didn't bet)
Seat 5: EHJOOJOO6543 (small blind) folded before Flop


PokerStars Hand #222982852415:  Hold'em No Limit ($2.50/$5.00 USD) - 2021/01/23 21:19:51 ET
Table 'Aaltje II' 6-max Seat #5 is the button
Seat 1: Rabarber77 ($491 in chips)
Seat 2: Nutsfit ($923.92 in chips)
Seat 3: el.suertero ($608.95 in chips)
Seat 5: EHJOOJOO6543 ($700.42 in chips)
Rabarber77: posts small blind $2.50
Nutsfit: posts big blind $5
*** HOLE CARDS ***
el.suertero: folds
EHJOOJOO6543: folds
Rabarber77: folds
Uncalled bet ($2.50) returned to Nutsfit
Nutsfit collected $5 from pot
Nutsfit: doesn't show hand
*** SUMMARY ***
Total pot $5 | Rake $0
Seat 1: Rabarber77 (small blind) folded before Flop
Seat 2: Nutsfit (big blind) collected ($5)
Seat 3: el.suertero folded before Flop (didn't bet)
Seat 5: EHJOOJOO6543 (button) folded before Flop (didn't bet)


PokerStars Hand #222983020568:  Hold'em No Limit ($2.50/$5.00 USD) - 2021/01/23 21:26:17 ET
Table 'Aaltje II' 6-max Seat #1 is the button
Seat 1: Rabarber77 ($482.70 in chips)
Seat 2: Nutsfit ($918.72 in chips)
Seat 6: NZQT ($500 in chips)
Nutsfit: posts small blind $2.50
NZQT: posts big blind $5
*** HOLE CARDS ***
Rabarber77: folds
Nutsfit: raises $10 to $15
NZQT: calls $10
*** FLOP *** [6s 7d Kh]
Nutsfit: bets $14.54
NZQT: folds
Uncalled bet ($14.54) returned to Nutsfit
Nutsfit collected $28.50 from pot
Nutsfit: doesn't show hand
*** SUMMARY ***
Total pot $30 | Rake $1.50
Board [6s 7d Kh]
Seat 1: Rabarber77 (button) folded before Flop (didn't bet)
Seat 2: Nutsfit (small blind) collected ($28.50)
Seat 6: NZQT (big blind) folded on the Flop


PokerStars Hand #222983029240:  Hold'em No Limit ($2.50/$5.00 USD) - 2021/01/23 21:26:39 ET
Table 'Aaltje II' 6-max Seat #2 is the button
Seat 1: Rabarber77 ($482.70 in chips)
Seat 2: Nutsfit ($932.22 in chips)
Seat 6: NZQT ($500 in chips)
NZQT: posts small blind $2.50
Rabarber77: posts big blind $5
*** HOLE CARDS ***
Nutsfit: folds
NZQT: folds
Uncalled bet ($2.50) returned to Rabarber77
Rabarber77 collected $5 from pot
Rabarber77: doesn't show hand
*** SUMMARY ***
Total pot $5 | Rake $0
Seat 1: Rabarber77 (big blind) collected ($5)
Seat 2: Nutsfit (button) folded before Flop (didn't bet)
Seat 6: NZQT (small blind) folded before Flop


PokerStars Hand #222983031689:  Hold'em No Limit ($2.50/$5.00 USD) - 2021/01/23 21:26:46 ET
Table 'Aaltje II' 6-max Seat #6 is the button
Seat 1: Rabarber77 ($485.20 in chips)
Seat 2: Nutsfit ($932.22 in chips)
Seat 6: NZQT ($500 in chips)
Rabarber77: posts small blind $2.50
Nutsfit: posts big blind $5
*** HOLE CARDS ***
NZQT: folds
Rabarber77: raises $10 to $15
Nutsfit: folds
Uncalled bet ($10) returned to Rabarber77
Rabarber77 collected $10 from pot
Rabarber77: doesn't show hand
*** SUMMARY ***
Total pot $10 | Rake $0
Seat 1: Rabarber77 (small blind) collected ($10)
Seat 2: Nutsfit (big blind) folded before Flop
Seat 6: NZQT (button) folded before Flop (didn't bet)


PokerStars Hand #222983034786:  Hold'em No Limit ($2.50/$5.00 USD) - 2021/01/23 21:26:54 ET
Table 'Aaltje II' 6-max Seat #1 is the button
Seat 1: Rabarber77 ($490.20 in chips)
Seat 2: Nutsfit ($927.22 in chips)
Seat 6: NZQT ($500 in chips)
Nutsfit: posts small blind $2.50
NZQT: posts big blind $5
*** HOLE CARDS ***
Rabarber77: raises $10 to $15
Nutsfit: folds
NZQT: folds
Uncalled bet ($10) returned to Rabarber77
Rabarber77 collected $12.50 from pot
Rabarber77: doesn't show hand
*** SUMMARY ***
Total pot $12.50 | Rake $0
Seat 1: Rabarber77 (button) collected ($12.50)
Seat 2: Nutsfit (small blind) folded before Flop
Seat 6: NZQT (big blind) folded before Flop


PokerStars Hand #222983041839:  Hold'em No Limit ($2.50/$5.00 USD) - 2021/01/23 21:27:11 ET
Table 'Aaltje II' 6-max Seat #2 is the button
Seat 1: Rabarber77 ($497.70 in chips)
Seat 2: Nutsfit ($924.72 in chips)
Seat 6: NZQT ($500 in chips)
NZQT: posts small blind $2.50
Rabarber77: posts big blind $5
*** HOLE CARDS ***
Nutsfit: raises $7.50 to $12.50
NZQT: folds
Rabarber77: calls $7.50
*** FLOP *** [3h Kh 9s]
Rabarber77: checks
jjisnoob joins the table at seat #3
Nutsfit: bets $8.10
Rabarber77: folds
Uncalled bet ($8.10) returned to Nutsfit
Nutsfit collected $26.12 from pot
Nutsfit: doesn't show hand
*** SUMMARY ***
Total pot $27.50 | Rake $1.38
Board [3h Kh 9s]
Seat 1: Rabarber77 (big blind) folded on the Flop
Seat 2: Nutsfit (button) collected ($26.12)
Seat 6: NZQT (small blind) folded before Flop


PokerStars Hand #222983049582:  Hold'em No Limit ($2.50/$5.00 USD) - 2021/01/23 21:27:31 ET
Table 'Aaltje II' 6-max Seat #6 is the button
Seat 1: Rabarber77 ($485.20 in chips)
Seat 2: Nutsfit ($938.34 in chips)
Seat 6: NZQT ($500 in chips)
Rabarber77: posts small blind $2.50
Nutsfit: posts big blind $5
jjisnoob: sits out
*** HOLE CARDS ***
NZQT: raises $7.50 to $12.50
Rabarber77: folds
Nutsfit: calls $7.50
*** FLOP *** [Ks 3s 7c]
Nutsfit: checks
NZQT: bets $10.19
Nutsfit: calls $10.19
*** TURN *** [Ks 3s 7c] [5c]
Nutsfit: checks
NZQT: bets $38.96
Nutsfit: folds
Uncalled bet ($38.96) returned to NZQT
NZQT collected $46.38 from pot
NZQT: doesn't show hand
*** SUMMARY ***
Total pot $47.88 | Rake $1.50
Board [Ks 3s 7c 5c]
Seat 1: Rabarber77 (small blind) folded before Flop
Seat 2: Nutsfit (big blind) folded on the Turn
Seat 6: NZQT (button) collected ($46.38)


PokerStars Hand #222983063778:  Hold'em No Limit ($2.50/$5.00 USD) - 2021/01/23 21:28:07 ET
Table 'Aaltje II' 6-max Seat #1 is the button
Seat 1: Rabarber77 ($482.70 in chips)
Seat 2: Nutsfit ($915.65 in chips)
Seat 3: jjisnoob ($830.18 in chips)
Seat 6: NZQT ($523.69 in chips)
Nutsfit: posts small blind $2.50
jjisnoob: posts big blind $5
*** HOLE CARDS ***
NZQT: folds
NZQT leaves the table
Rabarber77: folds
Nutsfit: folds
Uncalled bet ($2.50) returned to jjisnoob
jjisnoob collected $5 from pot
jjisnoob: doesn't show hand
*** SUMMARY ***
Total pot $5 | Rake $0
Seat 1: Rabarber77 (button) folded before Flop (didn't bet)
Seat 2: Nutsfit (small blind) folded before Flop
Seat 3: jjisnoob (big blind) collected ($5)
Seat 6: NZQT folded before Flop (didn't bet)


PokerStars Hand #222983066758:  Hold'em No Limit ($2.50/$5.00 USD) - 2021/01/23 21:28:15 ET
Table 'Aaltje II' 6-max Seat #2 is the button
Seat 1: Rabarber77 ($482.70 in chips)
Seat 2: Nutsfit ($913.15 in chips)
Seat 3: jjisnoob ($832.68 in chips)
jjisnoob: posts small blind $2.50
Rabarber77: posts big blind $5
*** HOLE CARDS ***
Nutsfit: raises $7.50 to $12.50
jjisnoob: calls $10
Rabarber77: folds
*** FLOP *** [6s 7s 3s]
jjisnoob: checks
Nutsfit: checks
*** TURN *** [6s 7s 3s] [8h]
jjisnoob: bets $7.98
Nutsfit: calls $7.98
*** RIVER *** [6s 7s 3s 8h] [4s]
jjisnoob: checks
Nutsfit: checks
*** SHOW DOWN ***
jjisnoob: shows [4c 4h] (three of a kind, Fours)
Nutsfit: mucks hand
jjisnoob collected $44.46 from pot
*** SUMMARY ***
Total pot $45.96 | Rake $1.50
Board [6s 7s 3s 8h 4s]
Seat 1: Rabarber77 (big blind) folded before Flop
Seat 2: Nutsfit (button) mucked
Seat 3: jjisnoob (small blind) showed [4c 4h] and won ($44.46) with three of a kind, Fours


PokerStars Hand #222983091817:  Hold'em No Limit ($2.50/$5.00 USD) - 2021/01/23 21:29:19 ET
Table 'Aaltje II' 6-max Seat #3 is the button
Seat 1: Rabarber77 ($477.70 in chips)
Seat 2: Nutsfit ($892.67 in chips)
Seat 3: jjisnoob ($856.66 in chips)
Rabarber77: posts small blind $2.50
Nutsfit: posts big blind $5
*** HOLE CARDS ***
jjisnoob: raises $6.25 to $11.25
Rabarber77: folds
supbigdiaper joins the table at seat #4
Nutsfit: folds
Uncalled bet ($6.25) returned to jjisnoob
jjisnoob collected $12.50 from pot
jjisnoob: doesn't show hand
*** SUMMARY ***
Total pot $12.50 | Rake $0
Seat 1: Rabarber77 (small blind) folded before Flop
Seat 2: Nutsfit (big blind) folded before Flop
Seat 3: jjisnoob (button) collected ($12.50)


PokerStars Hand #222983098474:  Hold'em No Limit ($2.50/$5.00 USD) - 2021/01/23 21:29:36 ET
Table 'Aaltje II' 6-max Seat #1 is the button
Seat 1: Rabarber77 ($475.20 in chips)
Seat 2: Nutsfit ($887.67 in chips)
Seat 3: jjisnoob ($864.16 in chips)
Nutsfit: posts small blind $2.50
jjisnoob: posts big blind $5
supbigdiaper: sits out
*** HOLE CARDS ***
Rabarber77: raises $10 to $15
kampnou20 joins the table at seat #5
Nutsfit: folds
jjisnoob: folds
Uncalled bet ($10) returned to Rabarber77
Rabarber77 collected $12.50 from pot
Rabarber77: doesn't show hand
*** SUMMARY ***
Total pot $12.50 | Rake $0
Seat 1: Rabarber77 (button) collected ($12.50)
Seat 2: Nutsfit (small blind) folded before Flop
Seat 3: jjisnoob (big blind) folded before Flop


PokerStars Hand #222983103491:  Hold'em No Limit ($2.50/$5.00 USD) - 2021/01/23 21:29:49 ET
Table 'Aaltje II' 6-max Seat #2 is the button
Seat 1: Rabarber77 ($482.70 in chips)
Seat 2: Nutsfit ($885.17 in chips)
Seat 3: jjisnoob ($859.16 in chips)
Seat 4: supbigdiaper ($500 in chips)
jjisnoob: posts small blind $2.50
supbigdiaper: posts big blind $5
kampnou20: sits out
*** HOLE CARDS ***
Rabarber77: folds
Nutsfit: folds
jjisnoob: folds
Uncalled bet ($2.50) returned to supbigdiaper
supbigdiaper collected $5 from pot
supbigdiaper: doesn't show hand
*** SUMMARY ***
Total pot $5 | Rake $0
Seat 1: Rabarber77 folded before Flop (didn't bet)
Seat 2: Nutsfit (button) folded before Flop (didn't bet)
Seat 3: jjisnoob (small blind) folded before Flop
Seat 4: supbigdiaper (big blind) collected ($5)


PokerStars Hand #222983108628:  Hold'em No Limit ($2.50/$5.00 USD) - 2021/01/23 21:30:02 ET
Table 'Aaltje II' 6-max Seat #3 is the button
Seat 1: Rabarber77 ($482.70 in chips)
Seat 2: Nutsfit ($885.17 in chips)
Seat 3: jjisnoob ($856.66 in chips)
Seat 4: supbigdiaper ($502.50 in chips)
Seat 5: kampnou20 ($319.92 in chips)
supbigdiaper: posts small blind $2.50
kampnou20: posts big blind $5
*** HOLE CARDS ***
Rabarber77: folds
Nutsfit: raises $7.50 to $12.50
NZQT joins the table at seat #6
jjisnoob: calls $12.50
supbigdiaper: folds
kampnou20: folds
*** FLOP *** [Ah 4s 6h]
Nutsfit: checks
jjisnoob: checks
*** TURN *** [Ah 4s 6h] [Tc]
Nutsfit: bets $20.69
jjisnoob: calls $20.69
*** RIVER *** [Ah 4s 6h Tc] [Th]
Nutsfit: checks
jjisnoob: checks
*** SHOW DOWN ***
Nutsfit: shows [Jd Kh] (a pair of Tens)
jjisnoob: shows [Js Jc] (two pair, Jacks and Tens)
jjisnoob collected $70.88 from pot
*** SUMMARY ***
Total pot $73.88 | Rake $3
Board [Ah 4s 6h Tc Th]
Seat 1: Rabarber77 folded before Flop (didn't bet)
Seat 2: Nutsfit showed [Jd Kh] and lost with a pair of Tens
Seat 3: jjisnoob (button) showed [Js Jc] and won ($70.88) with two pair, Jacks and Tens
Seat 4: supbigdiaper (small blind) folded before Flop
Seat 5: kampnou20 (big blind) folded before Flop


PokerStars Hand #222983134933:  Hold'em No Limit ($2.50/$5.00 USD) - 2021/01/23 21:31:08 ET
Table 'Aaltje II' 6-max Seat #4 is the button
Seat 1: Rabarber77 ($482.70 in chips)
Seat 2: Nutsfit ($851.98 in chips)
Seat 3: jjisnoob ($894.35 in chips)
Seat 4: supbigdiaper ($500 in chips)
Seat 5: kampnou20 ($314.92 in chips)
Seat 6: NZQT ($523.69 in chips)
kampnou20: posts small blind $2.50
NZQT: posts big blind $5
*** HOLE CARDS ***
Rabarber77: folds
Nutsfit: folds
jjisnoob: folds
supbigdiaper: folds
kampnou20: folds
Uncalled bet ($2.50) returned to NZQT
NZQT collected $5 from pot
NZQT: doesn't show hand
*** SUMMARY ***
Total pot $5 | Rake $0
Seat 1: Rabarber77 folded before Flop (didn't bet)
Seat 2: Nutsfit folded before Flop (didn't bet)
Seat 3: jjisnoob folded before Flop (didn't bet)
Seat 4: supbigdiaper (button) folded before Flop (didn't bet)
Seat 5: kampnou20 (small blind) folded before Flop
Seat 6: NZQT (big blind) collected ($5)


PokerStars Hand #222983141103:  Hold'em No Limit ($2.50/$5.00 USD) - 2021/01/23 21:31:24 ET
Table 'Aaltje II' 6-max Seat #5 is the button
Seat 1: Rabarber77 ($482.70 in chips)
Seat 2: Nutsfit ($851.98 in chips)
Seat 3: jjisnoob ($894.35 in chips)
Seat 4: supbigdiaper ($500 in chips)
Seat 5: kampnou20 ($312.42 in chips)
Seat 6: NZQT ($526.19 in chips)
NZQT: posts small blind $2.50
Rabarber77: posts big blind $5
*** HOLE CARDS ***
Nutsfit: folds
jjisnoob: raises $6.25 to $11.25
supbigdiaper: folds
kampnou20: calls $11.25
NZQT: folds
Rabarber77: calls $6.25
*** FLOP *** [Tc Kd Jh]
Rabarber77: checks
jjisnoob: bets $21.70
kampnou20: folds
Rabarber77: folds
Uncalled bet ($21.70) returned to jjisnoob
jjisnoob collected $34.44 from pot
jjisnoob: doesn't show hand
*** SUMMARY ***
Total pot $36.25 | Rake $1.81
Board [Tc Kd Jh]
Seat 1: Rabarber77 (big blind) folded on the Flop
Seat 2: Nutsfit folded before Flop (didn't bet)
Seat 3: jjisnoob collected ($34.44)
Seat 4: supbigdiaper folded before Flop (didn't bet)
Seat 5: kampnou20 (button) folded on the Flop
Seat 6: NZQT (small blind) folded before Flop


PokerStars Hand #222983159413:  Hold'em No Limit ($2.50/$5.00 USD) - 2021/01/23 21:32:10 ET
Table 'Aaltje II' 6-max Seat #6 is the button
Seat 1: Rabarber77 ($471.45 in chips)
Seat 2: Nutsfit ($851.98 in chips)
Seat 3: jjisnoob ($917.54 in chips)
Seat 4: supbigdiaper ($500 in chips)
Seat 5: kampnou20 ($301.17 in chips)
Seat 6: NZQT ($523.69 in chips)
Rabarber77: posts small blind $2.50
Nutsfit: posts big blind $5
*** HOLE CARDS ***
jjisnoob: folds
supbigdiaper: folds
kampnou20: raises $12.50 to $17.50
NZQT: folds
Rabarber77: raises $27.50 to $45
Nutsfit: folds
kampnou20: raises $95 to $140
Rabarber77: calls $95
*** FLOP *** [4d 9c 6s]
Rabarber77: bets $331.45 and is all-in
kampnou20: calls $161.17 and is all-in
Uncalled bet ($170.28) returned to Rabarber77
*** TURN *** [4d 9c 6s] [Jc]
*** RIVER *** [4d 9c 6s Jc] [Js]
*** SHOW DOWN ***
Rabarber77: shows [8s 8d] (two pair, Jacks and Eights)
kampnou20: shows [As Ac] (two pair, Aces and Jacks)
kampnou20 collected $604.34 from pot
*** SUMMARY ***
Total pot $607.34 | Rake $3
Board [4d 9c 6s Jc Js]
Seat 1: Rabarber77 (small blind) showed [8s 8d] and lost with two pair, Jacks and Eights
Seat 2: Nutsfit (big blind) folded before Flop
Seat 3: jjisnoob folded before Flop (didn't bet)
Seat 4: supbigdiaper folded before Flop (didn't bet)
Seat 5: kampnou20 showed [As Ac] and won ($604.34) with two pair, Aces and Jacks
Seat 6: NZQT (button) folded before Flop (didn't bet)


PokerStars Hand #222983177080:  Hold'em No Limit ($2.50/$5.00 USD) - 2021/01/23 21:32:55 ET
Table 'Aaltje II' 6-max Seat #1 is the button
Seat 1: Rabarber77 ($170.28 in chips)
Seat 2: Nutsfit ($846.98 in chips)
Seat 3: jjisnoob ($917.54 in chips)
Seat 4: supbigdiaper ($500 in chips)
Seat 5: kampnou20 ($604.34 in chips)
Seat 6: NZQT ($523.69 in chips)
Nutsfit: posts small blind $2.50
jjisnoob: posts big blind $5
*** HOLE CARDS ***
supbigdiaper: folds
kampnou20: folds
NZQT: folds
Rabarber77: folds
Nutsfit: folds
Uncalled bet ($2.50) returned to jjisnoob
jjisnoob collected $5 from pot
jjisnoob: doesn't show hand
*** SUMMARY ***
Total pot $5 | Rake $0
Seat 1: Rabarber77 (button) folded before Flop (didn't bet)
Seat 2: Nutsfit (small blind) folded before Flop
Seat 3: jjisnoob (big blind) collected ($5)
Seat 4: supbigdiaper folded before Flop (didn't bet)
Seat 5: kampnou20 folded before Flop (didn't bet)
Seat 6: NZQT folded before Flop (didn't bet)


PokerStars Hand #222983184280:  Hold'em No Limit ($2.50/$5.00 USD) - 2021/01/23 21:33:13 ET
Table 'Aaltje II' 6-max Seat #2 is the button
Seat 1: Rabarber77 ($170.28 in chips)
Seat 2: Nutsfit ($844.48 in chips)
Seat 3: jjisnoob ($920.04 in chips)
Seat 4: supbigdiaper ($500 in chips)
Seat 5: kampnou20 ($604.34 in chips)
Seat 6: NZQT ($523.69 in chips)
jjisnoob: posts small blind $2.50
supbigdiaper: posts big blind $5
*** HOLE CARDS ***
kampnou20: folds
NZQT: folds
Rabarber77: raises $10 to $15
Nutsfit: folds
jjisnoob: folds
supbigdiaper: folds
Uncalled bet ($10) returned to Rabarber77
Rabarber77 collected $12.50 from pot
Rabarber77: doesn't show hand
*** SUMMARY ***
Total pot $12.50 | Rake $0
Seat 1: Rabarber77 collected ($12.50)
Seat 2: Nutsfit (button) folded before Flop (didn't bet)
Seat 3: jjisnoob (small blind) folded before Flop
Seat 4: supbigdiaper (big blind) folded before Flop
Seat 5: kampnou20 folded before Flop (didn't bet)
Seat 6: NZQT folded before Flop (didn't bet)


PokerStars Hand #222983195038:  Hold'em No Limit ($2.50/$5.00 USD) - 2021/01/23 21:33:41 ET
Table 'Aaltje II' 6-max Seat #3 is the button
Seat 1: Rabarber77 ($177.78 in chips)
Seat 2: Nutsfit ($844.48 in chips)
Seat 3: jjisnoob ($917.54 in chips)
Seat 4: supbigdiaper ($500 in chips)
Seat 5: kampnou20 ($604.34 in chips)
Seat 6: NZQT ($523.69 in chips)
supbigdiaper: posts small blind $2.50
kampnou20: posts big blind $5
*** HOLE CARDS ***
NZQT: raises $6 to $11
Rabarber77: calls $11
Nutsfit: folds
jjisnoob: calls $11
supbigdiaper: calls $8.50
kampnou20: calls $6
*** FLOP *** [7h Jc 9s]
supbigdiaper: checks
kampnou20: checks
NZQT: bets $20.38
Rabarber77: folds
jjisnoob: folds
supbigdiaper: folds
kampnou20: folds
Uncalled bet ($20.38) returned to NZQT
NZQT collected $52.25 from pot
NZQT: doesn't show hand
*** SUMMARY ***
Total pot $55 | Rake $2.75
Board [7h Jc 9s]
Seat 1: Rabarber77 folded on the Flop
Seat 2: Nutsfit folded before Flop (didn't bet)
Seat 3: jjisnoob (button) folded on the Flop
Seat 4: supbigdiaper (small blind) folded on the Flop
Seat 5: kampnou20 (big blind) folded on the Flop
Seat 6: NZQT collected ($52.25)


PokerStars Hand #222983211664:  Hold'em No Limit ($2.50/$5.00 USD) - 2021/01/23 21:34:17 ET
Table 'Aaltje II' 6-max Seat #4 is the button
Seat 1: Rabarber77 ($166.78 in chips)
Seat 2: Nutsfit ($844.48 in chips)
Seat 3: jjisnoob ($906.54 in chips)
Seat 4: supbigdiaper ($500 in chips)
Seat 5: kampnou20 ($593.34 in chips)
Seat 6: NZQT ($564.94 in chips)
kampnou20: posts small blind $2.50
NZQT: posts big blind $5
*** HOLE CARDS ***
Rabarber77: folds
Nutsfit: folds
jjisnoob: folds
supbigdiaper: raises $7.50 to $12.50
kampnou20: folds
NZQT: folds
Uncalled bet ($7.50) returned to supbigdiaper
supbigdiaper collected $12.50 from pot
supbigdiaper: doesn't show hand
*** SUMMARY ***
Total pot $12.50 | Rake $0
Seat 1: Rabarber77 folded before Flop (didn't bet)
Seat 2: Nutsfit folded before Flop (didn't bet)
Seat 3: jjisnoob folded before Flop (didn't bet)
Seat 4: supbigdiaper (button) collected ($12.50)
Seat 5: kampnou20 (small blind) folded before Flop
Seat 6: NZQT (big blind) folded before Flop


PokerStars Hand #222983217281:  Hold'em No Limit ($2.50/$5.00 USD) - 2021/01/23 21:34:31 ET
Table 'Aaltje II' 6-max Seat #5 is the button
Seat 1: Rabarber77 ($166.78 in chips)
Seat 2: Nutsfit ($844.48 in chips)
Seat 3: jjisnoob ($906.54 in chips)
Seat 4: supbigdiaper ($507.50 in chips)
Seat 5: kampnou20 ($590.84 in chips)
Seat 6: NZQT ($559.94 in chips)
NZQT: posts small blind $2.50
Rabarber77: posts big blind $5
*** HOLE CARDS ***
Nutsfit: folds
jjisnoob: raises $6.25 to $11.25
supbigdiaper: calls $11.25
kampnou20: folds
NZQT: folds
Rabarber77: calls $6.25
*** FLOP *** [Ac 4c 5s]
Rabarber77: checks
jjisnoob: checks
supbigdiaper: checks
*** TURN *** [Ac 4c 5s] [2d]
Rabarber77: checks
jjisnoob: checks
supbigdiaper: checks
*** RIVER *** [Ac 4c 5s 2d] [2h]
Rabarber77: bets $17.22
jjisnoob: folds
supbigdiaper: folds
Uncalled bet ($17.22) returned to Rabarber77
Rabarber77 collected $34.44 from pot
Rabarber77: doesn't show hand
*** SUMMARY ***
Total pot $36.25 | Rake $1.81
Board [Ac 4c 5s 2d 2h]
Seat 1: Rabarber77 (big blind) collected ($34.44)
Seat 2: Nutsfit folded before Flop (didn't bet)
Seat 3: jjisnoob folded on the River
Seat 4: supbigdiaper folded on the River
Seat 5: kampnou20 (button) folded before Flop (didn't bet)
Seat 6: NZQT (small blind) folded before Flop


PokerStars Hand #222983247590:  Hold'em No Limit ($2.50/$5.00 USD) - 2021/01/23 21:35:47 ET
Table 'Aaltje II' 6-max Seat #6 is the button
Seat 1: Rabarber77 ($189.97 in chips)
Seat 2: Nutsfit ($844.48 in chips)
Seat 3: jjisnoob ($895.29 in chips)
Seat 4: supbigdiaper ($500 in chips)
Seat 5: kampnou20 ($590.84 in chips)
Seat 6: NZQT ($557.44 in chips)
Rabarber77: posts small blind $2.50
Nutsfit: posts big blind $5
*** HOLE CARDS ***
jjisnoob: folds
supbigdiaper: folds
kampnou20: folds
NZQT: folds
Rabarber77: folds
Uncalled bet ($2.50) returned to Nutsfit
Nutsfit collected $5 from pot
Nutsfit: doesn't show hand
*** SUMMARY ***
Total pot $5 | Rake $0
Seat 1: Rabarber77 (small blind) folded before Flop
Seat 2: Nutsfit (big blind) collected ($5)
Seat 3: jjisnoob folded before Flop (didn't bet)
Seat 4: supbigdiaper folded before Flop (didn't bet)
Seat 5: kampnou20 folded before Flop (didn't bet)
Seat 6: NZQT (button) folded before Flop (didn't bet)


PokerStars Hand #222983251289:  Hold'em No Limit ($2.50/$5.00 USD) - 2021/01/23 21:35:57 ET
Table 'Aaltje II' 6-max Seat #1 is the button
Seat 1: Rabarber77 ($187.47 in chips)
Seat 2: Nutsfit ($846.98 in chips)
Seat 3: jjisnoob ($895.29 in chips)
Seat 4: supbigdiaper ($500 in chips)
Seat 5: kampnou20 ($590.84 in chips)
Seat 6: NZQT ($557.44 in chips)
Nutsfit: posts small blind $2.50
jjisnoob: posts big blind $5
*** HOLE CARDS ***
supbigdiaper: folds
kampnou20: folds
NZQT: raises $6 to $11
Rabarber77: folds
Nutsfit: folds
jjisnoob: folds
Uncalled bet ($6) returned to NZQT
NZQT collected $12.50 from pot
NZQT: doesn't show hand
*** SUMMARY ***
Total pot $12.50 | Rake $0
Seat 1: Rabarber77 (button) folded before Flop (didn't bet)
Seat 2: Nutsfit (small blind) folded before Flop
Seat 3: jjisnoob (big blind) folded before Flop
Seat 4: supbigdiaper folded before Flop (didn't bet)
Seat 5: kampnou20 folded before Flop (didn't bet)
Seat 6: NZQT collected ($12.50)


PokerStars Hand #222983256712:  Hold'em No Limit ($2.50/$5.00 USD) - 2021/01/23 21:36:10 ET
Table 'Aaltje II' 6-max Seat #2 is the button
Seat 1: Rabarber77 ($187.47 in chips)
Seat 2: Nutsfit ($844.48 in chips)
Seat 3: jjisnoob ($890.29 in chips)
Seat 4: supbigdiaper ($500 in chips)
Seat 5: kampnou20 ($590.84 in chips)
Seat 6: NZQT ($564.94 in chips)
jjisnoob: posts small blind $2.50
supbigdiaper: posts big blind $5
*** HOLE CARDS ***
kampnou20: raises $5 to $10
NZQT: folds
Rabarber77: folds
Nutsfit: raises $25 to $35
jjisnoob: folds
supbigdiaper: folds
kampnou20: calls $25
*** FLOP *** [5c 4c 2s]
kampnou20: checks
Nutsfit: bets $49.92
kampnou20: raises $59.92 to $109.84
Nutsfit: calls $59.92
*** TURN *** [5c 4c 2s] [6c]
kampnou20: bets $167.09
Nutsfit: raises $532.55 to $699.64 and is all-in
kampnou20: calls $278.91 and is all-in
Uncalled bet ($253.64) returned to Nutsfit
*** RIVER *** [5c 4c 2s 6c] [Jc]
*** SHOW DOWN ***
kampnou20: shows [6d Td] (a pair of Sixes)
Nutsfit: shows [Tc 9c] (a flush, Jack high)
Nutsfit collected $1186.18 from pot
*** SUMMARY ***
Total pot $1189.18 | Rake $3
Board [5c 4c 2s 6c Jc]
Seat 1: Rabarber77 folded before Flop (didn't bet)
Seat 2: Nutsfit (button) showed [Tc 9c] and won ($1186.18) with a flush, Jack high
Seat 3: jjisnoob (small blind) folded before Flop
Seat 4: supbigdiaper (big blind) folded before Flop
Seat 5: kampnou20 showed [6d Td] and lost with a pair of Sixes
Seat 6: NZQT folded before Flop (didn't bet)


PokerStars Hand #222983287891:  Hold'em No Limit ($2.50/$5.00 USD) - 2021/01/23 21:37:29 ET
Table 'Aaltje II' 6-max Seat #3 is the button
Seat 1: Rabarber77 ($187.47 in chips)
Seat 2: Nutsfit ($1439.82 in chips)
Seat 3: jjisnoob ($887.79 in chips)
Seat 4: supbigdiaper ($500 in chips)
Seat 6: NZQT ($564.94 in chips)
supbigdiaper: posts small blind $2.50
NZQT: posts big blind $5
*** HOLE CARDS ***
Rabarber77: folds
Nutsfit: folds
kampnou20 leaves the table
jjisnoob: folds
supbigdiaper: raises $7.50 to $12.50
NZQT: calls $7.50
*** FLOP *** [4s 9d Kh]
supbigdiaper: bets $7.84
NZQT: folds
Uncalled bet ($7.84) returned to supbigdiaper
supbigdiaper collected $23.75 from pot
supbigdiaper: doesn't show hand
*** SUMMARY ***
Total pot $25 | Rake $1.25
Board [4s 9d Kh]
Seat 1: Rabarber77 folded before Flop (didn't bet)
Seat 2: Nutsfit folded before Flop (didn't bet)
Seat 3: jjisnoob (button) folded before Flop (didn't bet)
Seat 4: supbigdiaper (small blind) collected ($23.75)
Seat 6: NZQT (big blind) folded on the Flop


PokerStars Hand #222983303878:  Hold'em No Limit ($2.50/$5.00 USD) - 2021/01/23 21:38:01 ET
Table 'Aaltje II' 6-max Seat #4 is the button
Seat 1: Rabarber77 ($187.47 in chips)
Seat 2: Nutsfit ($1439.82 in chips)
Seat 3: jjisnoob ($887.79 in chips)
Seat 4: supbigdiaper ($511.25 in chips)
Seat 6: NZQT ($552.44 in chips)
NZQT: posts small blind $2.50
Rabarber77: posts big blind $5
*** HOLE CARDS ***
Nutsfit: raises $5.90 to $10.90
jjisnoob: folds
supbigdiaper: folds
NZQT: folds
Rabarber77: folds
Uncalled bet ($5.90) returned to Nutsfit
Nutsfit collected $12.50 from pot
Nutsfit: doesn't show hand
*** SUMMARY ***
Total pot $12.50 | Rake $0
Seat 1: Rabarber77 (big blind) folded before Flop
Seat 2: Nutsfit collected ($12.50)
Seat 3: jjisnoob folded before Flop (didn't bet)
Seat 4: supbigdiaper (button) folded before Flop (didn't bet)
Seat 6: NZQT (small blind) folded before Flop


PokerStars Hand #222983312687:  Hold'em No Limit ($2.50/$5.00 USD) - 2021/01/23 21:38:24 ET
Table 'Aaltje II' 6-max Seat #6 is the button
Seat 1: Rabarber77 ($182.47 in chips)
Seat 2: Nutsfit ($1447.32 in chips)
Seat 3: jjisnoob ($887.79 in chips)
Seat 4: supbigdiaper ($511.25 in chips)
Seat 6: NZQT ($549.94 in chips)
Rabarber77: posts small blind $2.50
Nutsfit: posts big blind $5
*** HOLE CARDS ***
jjisnoob: folds
supbigdiaper: raises $7.50 to $12.50
NZQT: folds
Rabarber77: folds
Nutsfit: folds
Uncalled bet ($7.50) returned to supbigdiaper
supbigdiaper collected $12.50 from pot
supbigdiaper: doesn't show hand
*** SUMMARY ***
Total pot $12.50 | Rake $0
Seat 1: Rabarber77 (small blind) folded before Flop
Seat 2: Nutsfit (big blind) folded before Flop
Seat 3: jjisnoob folded before Flop (didn't bet)
Seat 4: supbigdiaper collected ($12.50)
Seat 6: NZQT (button) folded before Flop (didn't bet)


PokerStars Hand #222983317237:  Hold'em No Limit ($2.50/$5.00 USD) - 2021/01/23 21:38:35 ET
Table 'Aaltje II' 6-max Seat #1 is the button
Seat 1: Rabarber77 ($179.97 in chips)
Seat 2: Nutsfit ($1442.32 in chips)
Seat 3: jjisnoob ($887.79 in chips)
Seat 4: supbigdiaper ($518.75 in chips)
Seat 6: NZQT ($549.94 in chips)
Nutsfit: posts small blind $2.50
jjisnoob: posts big blind $5
*** HOLE CARDS ***
supbigdiaper: folds
NZQT: raises $6 to $11
Rabarber77: folds
Nutsfit: folds
jjisnoob: folds
Uncalled bet ($6) returned to NZQT
NZQT collected $12.50 from pot
NZQT: doesn't show hand
*** SUMMARY ***
Total pot $12.50 | Rake $0
Seat 1: Rabarber77 (button) folded before Flop (didn't bet)
Seat 2: Nutsfit (small blind) folded before Flop
Seat 3: jjisnoob (big blind) folded before Flop
Seat 4: supbigdiaper folded before Flop (didn't bet)
Seat 6: NZQT collected ($12.50)


PokerStars Hand #222983325112:  Hold'em No Limit ($2.50/$5.00 USD) - 2021/01/23 21:38:56 ET
Table 'Aaltje II' 6-max Seat #2 is the button
Seat 1: Rabarber77 ($179.97 in chips)
Seat 2: Nutsfit ($1439.82 in chips)
Seat 3: jjisnoob ($882.79 in chips)
Seat 4: supbigdiaper ($518.75 in chips)
Seat 6: NZQT ($557.44 in chips)
jjisnoob: posts small blind $2.50
supbigdiaper: posts big blind $5
*** HOLE CARDS ***
NZQT: folds
Rabarber77: raises $10 to $15
Nutsfit: folds
jjisnoob: raises $45 to $60
supbigdiaper: folds
Rabarber77: folds
Uncalled bet ($45) returned to jjisnoob
jjisnoob collected $35 from pot
jjisnoob: doesn't show hand
*** SUMMARY ***
Total pot $35 | Rake $0
Seat 1: Rabarber77 folded before Flop
Seat 2: Nutsfit (button) folded before Flop (didn't bet)
Seat 3: jjisnoob (small blind) collected ($35)
Seat 4: supbigdiaper (big blind) folded before Flop
Seat 6: NZQT folded before Flop (didn't bet)


PokerStars Hand #222983338495:  Hold'em No Limit ($2.50/$5.00 USD) - 2021/01/23 21:39:29 ET
Table 'Aaltje II' 6-max Seat #3 is the button
Seat 1: Rabarber77 ($164.97 in chips)
Seat 2: Nutsfit ($1439.82 in chips)
Seat 3: jjisnoob ($902.79 in chips)
Seat 4: supbigdiaper ($513.75 in chips)
Seat 6: NZQT ($557.44 in chips)
supbigdiaper: posts small blind $2.50
NZQT: posts big blind $5
*** HOLE CARDS ***
Rabarber77: raises $10 to $15
Nutsfit: folds
jjisnoob: folds
supbigdiaper: folds
NZQT: folds
Uncalled bet ($10) returned to Rabarber77
Rabarber77 collected $12.50 from pot
Rabarber77: doesn't show hand
*** SUMMARY ***
Total pot $12.50 | Rake $0
Seat 1: Rabarber77 collected ($12.50)
Seat 2: Nutsfit folded before Flop (didn't bet)
Seat 3: jjisnoob (button) folded before Flop (didn't bet)
Seat 4: supbigdiaper (small blind) folded before Flop
Seat 6: NZQT (big blind) folded before Flop


PokerStars Hand #222983344637:  Hold'em No Limit ($2.50/$5.00 USD) - 2021/01/23 21:39:45 ET
Table 'Aaltje II' 6-max Seat #4 is the button
Seat 1: Rabarber77 ($172.47 in chips)
Seat 2: Nutsfit ($1439.82 in chips)
Seat 3: jjisnoob ($902.79 in chips)
Seat 4: supbigdiaper ($511.25 in chips)
Seat 6: NZQT ($552.44 in chips)
NZQT: posts small blind $2.50
Rabarber77: posts big blind $5
*** HOLE CARDS ***
Nutsfit: folds
jjisnoob: raises $6.25 to $11.25
supbigdiaper: folds
NZQT: folds
Rabarber77: raises $31.25 to $42.50
jjisnoob: raises $243.25 to $285.75
Rabarber77: calls $129.97 and is all-in
Uncalled bet ($113.28) returned to jjisnoob
*** FLOP *** [8h 6c 8d]
*** TURN *** [8h 6c 8d] [Jc]
*** RIVER *** [8h 6c 8d Jc] [6d]
*** SHOW DOWN ***
Rabarber77: shows [Qd Ac] (two pair, Eights and Sixes)
jjisnoob: shows [Qc As] (two pair, Eights and Sixes)
Rabarber77 collected $172.22 from pot
jjisnoob collected $172.22 from pot
*** SUMMARY ***
Total pot $347.44 | Rake $3
Board [8h 6c 8d Jc 6d]
Seat 1: Rabarber77 (big blind) showed [Qd Ac] and won ($172.22) with two pair, Eights and Sixes
Seat 2: Nutsfit folded before Flop (didn't bet)
Seat 3: jjisnoob showed [Qc As] and won ($172.22) with two pair, Eights and Sixes
Seat 4: supbigdiaper (button) folded before Flop (didn't bet)
Seat 6: NZQT (small blind) folded before Flop


PokerStars Hand #222983367476:  Hold'em No Limit ($2.50/$5.00 USD) - 2021/01/23 21:40:43 ET
Table 'Aaltje II' 6-max Seat #6 is the button
Seat 1: Rabarber77 ($172.22 in chips)
Seat 2: Nutsfit ($1439.82 in chips)
Seat 3: jjisnoob ($902.54 in chips)
Seat 4: supbigdiaper ($511.25 in chips)
Seat 6: NZQT ($549.94 in chips)
Rabarber77: posts small blind $2.50
Nutsfit: posts big blind $5
*** HOLE CARDS ***
jjisnoob: folds
supbigdiaper: folds
NZQT: folds
Rabarber77: raises $10 to $15
Nutsfit: folds
Uncalled bet ($10) returned to Rabarber77
Rabarber77 collected $10 from pot
Rabarber77: doesn't show hand
*** SUMMARY ***
Total pot $10 | Rake $0
Seat 1: Rabarber77 (small blind) collected ($10)
Seat 2: Nutsfit (big blind) folded before Flop
Seat 3: jjisnoob folded before Flop (didn't bet)
Seat 4: supbigdiaper folded before Flop (didn't bet)
Seat 6: NZQT (button) folded before Flop (didn't bet)


PokerStars Hand #222983372458:  Hold'em No Limit ($2.50/$5.00 USD) - 2021/01/23 21:40:56 ET
Table 'Aaltje II' 6-max Seat #1 is the button
Seat 1: Rabarber77 ($177.22 in chips)
Seat 2: Nutsfit ($1434.82 in chips)
Seat 3: jjisnoob ($902.54 in chips)
Seat 4: supbigdiaper ($511.25 in chips)
Seat 6: NZQT ($549.94 in chips)
Nutsfit: posts small blind $2.50
jjisnoob: posts big blind $5
*** HOLE CARDS ***
supbigdiaper: folds
NZQT: folds
Rabarber77: raises $10 to $15
Nutsfit: folds
jjisnoob: raises $48.75 to $63.75
Rabarber77: raises $113.47 to $177.22 and is all-in
jjisnoob: calls $113.47
*** FLOP *** [8d Kc 6s]
*** TURN *** [8d Kc 6s] [4c]
*** RIVER *** [8d Kc 6s 4c] [As]
*** SHOW DOWN ***
jjisnoob: shows [Jc Jd] (a pair of Jacks)
Rabarber77: shows [Qh Ah] (a pair of Aces)
Rabarber77 collected $353.94 from pot
*** SUMMARY ***
Total pot $356.94 | Rake $3
Board [8d Kc 6s 4c As]
Seat 1: Rabarber77 (button) showed [Qh Ah] and won ($353.94) with a pair of Aces
Seat 2: Nutsfit (small blind) folded before Flop
Seat 3: jjisnoob (big blind) showed [Jc Jd] and lost with a pair of Jacks
Seat 4: supbigdiaper folded before Flop (didn't bet)
Seat 6: NZQT folded before Flop (didn't bet)


PokerStars Hand #222983389674:  Hold'em No Limit ($2.50/$5.00 USD) - 2021/01/23 21:41:39 ET
Table 'Aaltje II' 6-max Seat #2 is the button
Seat 1: Rabarber77 ($353.94 in chips)
Seat 2: Nutsfit ($1432.32 in chips)
Seat 3: jjisnoob ($725.32 in chips)
Seat 4: supbigdiaper ($511.25 in chips)
Seat 6: NZQT ($549.94 in chips)
jjisnoob: posts small blind $2.50
supbigdiaper: posts big blind $5
*** HOLE CARDS ***
NZQT: folds
Rabarber77: raises $10 to $15
Nutsfit: folds
jjisnoob: folds
supbigdiaper: calls $10
*** FLOP *** [Ah Kc 3c]
supbigdiaper: checks
Rabarber77: bets $15.44
supbigdiaper: folds
Uncalled bet ($15.44) returned to Rabarber77
Rabarber77 collected $30.88 from pot
Rabarber77: doesn't show hand
*** SUMMARY ***
Total pot $32.50 | Rake $1.62
Board [Ah Kc 3c]
Seat 1: Rabarber77 collected ($30.88)
Seat 2: Nutsfit (button) folded before Flop (didn't bet)
Seat 3: jjisnoob (small blind) folded before Flop
Seat 4: supbigdiaper (big blind) folded on the Flop
Seat 6: NZQT folded before Flop (didn't bet)


PokerStars Hand #222983402004:  Hold'em No Limit ($2.50/$5.00 USD) - 2021/01/23 21:42:10 ET
Table 'Aaltje II' 6-max Seat #3 is the button
Seat 1: Rabarber77 ($369.82 in chips)
Seat 2: Nutsfit ($1432.32 in chips)
Seat 3: jjisnoob ($722.82 in chips)
Seat 4: supbigdiaper ($500 in chips)
Seat 6: NZQT ($549.94 in chips)
supbigdiaper: posts small blind $2.50
NZQT: posts big blind $5
*** HOLE CARDS ***
Rabarber77: raises $10 to $15
Nutsfit: raises $30 to $45
jjisnoob: folds
supbigdiaper: folds
NZQT: folds
Rabarber77: calls $30
*** FLOP *** [5h Tc 5c]
Rabarber77: checks
Nutsfit: bets $48.20
Rabarber77: calls $48.20
*** TURN *** [5h Tc 5c] [7s]
Rabarber77: checks
Nutsfit: bets $160
Rabarber77: raises $116.62 to $276.62 and is all-in
Nutsfit: calls $116.62
*** RIVER *** [5h Tc 5c 7s] [8d]
*** SHOW DOWN ***
Rabarber77: shows [Ts Ad] (two pair, Tens and Fives)
Nutsfit: shows [Qc Kc] (a pair of Fives)
Rabarber77 collected $744.14 from pot
*** SUMMARY ***
Total pot $747.14 | Rake $3
Board [5h Tc 5c 7s 8d]
Seat 1: Rabarber77 showed [Ts Ad] and won ($744.14) with two pair, Tens and Fives
Seat 2: Nutsfit showed [Qc Kc] and lost with a pair of Fives
Seat 3: jjisnoob (button) folded before Flop (didn't bet)
Seat 4: supbigdiaper (small blind) folded before Flop
Seat 6: NZQT (big blind) folded before Flop


PokerStars Hand #222983423799:  Hold'em No Limit ($2.50/$5.00 USD) - 2021/01/23 21:42:54 ET
Table 'Aaltje II' 6-max Seat #4 is the button
Seat 1: Rabarber77 ($744.14 in chips)
Seat 2: Nutsfit ($1062.50 in chips)
Seat 3: jjisnoob ($722.82 in chips)
Seat 4: supbigdiaper ($500 in chips)
Seat 6: NZQT ($544.94 in chips)
NZQT: posts small blind $2.50
Rabarber77: posts big blind $5
*** HOLE CARDS ***
Nutsfit: folds
jjisnoob: folds
supbigdiaper: folds
NZQT: raises $9.50 to $14.50
Rabarber77: calls $9.50
*** FLOP *** [5c Ac Kh]
NZQT: bets $7.16
jektiss joins the table at seat #5
Rabarber77: raises $7.16 to $14.32
jektiss leaves the table
NZQT: calls $7.16
*** TURN *** [5c Ac Kh] [Jd]
NZQT: checks
Rabarber77: checks
*** RIVER *** [5c Ac Kh Jd] [9s]
NZQT: checks
Rabarber77: checks
*** SHOW DOWN ***
NZQT: shows [7h Qh] (high card Ace)
Rabarber77: shows [Kd 6c] (a pair of Kings)
Rabarber77 collected $54.76 from pot
*** SUMMARY ***
Total pot $57.64 | Rake $2.88
Board [5c Ac Kh Jd 9s]
Seat 1: Rabarber77 (big blind) showed [Kd 6c] and won ($54.76) with a pair of Kings
Seat 2: Nutsfit folded before Flop (didn't bet)
Seat 3: jjisnoob folded before Flop (didn't bet)
Seat 4: supbigdiaper (button) folded before Flop (didn't bet)
Seat 6: NZQT (small blind) showed [7h Qh] and lost with high card Ace


PokerStars Hand #222983444895:  Hold'em No Limit ($2.50/$5.00 USD) - 2021/01/23 21:43:48 ET
Table 'Aaltje II' 6-max Seat #6 is the button
Seat 1: Rabarber77 ($770.08 in chips)
Seat 3: jjisnoob ($722.82 in chips)
Seat 4: supbigdiaper ($500 in chips)
Seat 6: NZQT ($516.12 in chips)
Rabarber77: posts small blind $2.50
Nutsfit: is sitting out
jjisnoob: posts big blind $5
*** HOLE CARDS ***
supbigdiaper: raises $7.50 to $12.50
NZQT: folds
Rabarber77: calls $10
jjisnoob: folds
*** FLOP *** [9s Jd Ah]
Rabarber77: checks
supbigdiaper: checks
*** TURN *** [9s Jd Ah] [Td]
Rabarber77: bets $14.25
supbigdiaper: calls $14.25
*** RIVER *** [9s Jd Ah Td] [4c]
Rabarber77: checks
supbigdiaper: bets $28.50
Rabarber77: folds
Uncalled bet ($28.50) returned to supbigdiaper
supbigdiaper collected $57 from pot
supbigdiaper: doesn't show hand
*** SUMMARY ***
Total pot $58.50 | Rake $1.50
Board [9s Jd Ah Td 4c]
Seat 1: Rabarber77 (small blind) folded on the River
Seat 3: jjisnoob (big blind) folded before Flop
Seat 4: supbigdiaper collected ($57)
Seat 6: NZQT (button) folded before Flop (didn't bet)


PokerStars Hand #222983460787:  Hold'em No Limit ($2.50/$5.00 USD) - 2021/01/23 21:44:29 ET
Table 'Aaltje II' 6-max Seat #1 is the button
Seat 1: Rabarber77 ($743.33 in chips)
Seat 3: jjisnoob ($717.82 in chips)
Seat 4: supbigdiaper ($530.25 in chips)
Seat 6: NZQT ($516.12 in chips)
jjisnoob: posts small blind $2.50
supbigdiaper: posts big blind $5
*** HOLE CARDS ***
NZQT: folds
Rabarber77: folds
jjisnoob: raises $11.50 to $16.50
supbigdiaper: calls $11.50
*** FLOP *** [8s Ad 3s]
jjisnoob: checks
supbigdiaper: checks
*** TURN *** [8s Ad 3s] [Kh]
jjisnoob: checks
supbigdiaper: checks
*** RIVER *** [8s Ad 3s Kh] [3h]
jjisnoob: bets $8.82
supbigdiaper: raises $49.63 to $58.45
jjisnoob: folds
Uncalled bet ($49.63) returned to supbigdiaper
supbigdiaper collected $49.14 from pot
supbigdiaper: doesn't show hand
*** SUMMARY ***
Total pot $50.64 | Rake $1.50
Board [8s Ad 3s Kh 3h]
Seat 1: Rabarber77 (button) folded before Flop (didn't bet)
Seat 3: jjisnoob (small blind) folded on the River
Seat 4: supbigdiaper (big blind) collected ($49.14)
Seat 6: NZQT folded before Flop (didn't bet)


PokerStars Hand #222983488665:  Hold'em No Limit ($2.50/$5.00 USD) - 2021/01/23 21:45:41 ET
Table 'Aaltje II' 6-max Seat #3 is the button
Seat 1: Rabarber77 ($743.33 in chips)
Seat 3: jjisnoob ($692.50 in chips)
Seat 4: supbigdiaper ($554.07 in chips)
Seat 6: NZQT ($516.12 in chips)
supbigdiaper: posts small blind $2.50
NZQT: posts big blind $5
*** HOLE CARDS ***
Rabarber77: folds
jjisnoob: folds
supbigdiaper: raises $7.50 to $12.50
NZQT: folds
Uncalled bet ($7.50) returned to supbigdiaper
supbigdiaper collected $10 from pot
supbigdiaper: doesn't show hand
*** SUMMARY ***
Total pot $10 | Rake $0
Seat 1: Rabarber77 folded before Flop (didn't bet)
Seat 3: jjisnoob (button) folded before Flop (didn't bet)
Seat 4: supbigdiaper (small blind) collected ($10)
Seat 6: NZQT (big blind) folded before Flop


PokerStars Hand #222983492189:  Hold'em No Limit ($2.50/$5.00 USD) - 2021/01/23 21:45:50 ET
Table 'Aaltje II' 6-max Seat #4 is the button
Seat 1: Rabarber77 ($743.33 in chips)
Seat 3: jjisnoob ($692.50 in chips)
Seat 4: supbigdiaper ($559.07 in chips)
Seat 6: NZQT ($511.12 in chips)
NZQT: posts small blind $2.50
Rabarber77: posts big blind $5
*** HOLE CARDS ***
jjisnoob: raises $6.25 to $11.25
supbigdiaper: folds
NZQT: folds
Rabarber77: calls $6.25
*** FLOP *** [Ks As Kc]
Rabarber77: checks
jjisnoob: checks
*** TURN *** [Ks As Kc] [3s]
Rabarber77: checks
jjisnoob: bets $13.06
Rabarber77: folds
Uncalled bet ($13.06) returned to jjisnoob
jjisnoob collected $23.75 from pot
jjisnoob: doesn't show hand
*** SUMMARY ***
Total pot $25 | Rake $1.25
Board [Ks As Kc 3s]
Seat 1: Rabarber77 (big blind) folded on the Turn
Seat 3: jjisnoob collected ($23.75)
Seat 4: supbigdiaper (button) folded before Flop (didn't bet)
Seat 6: NZQT (small blind) folded before Flop


PokerStars Hand #222983504096:  Hold'em No Limit ($2.50/$5.00 USD) - 2021/01/23 21:46:21 ET
Table 'Aaltje II' 6-max Seat #6 is the button
Seat 1: Rabarber77 ($732.08 in chips)
Seat 4: supbigdiaper ($559.07 in chips)
Seat 6: NZQT ($508.62 in chips)
Rabarber77: posts small blind $2.50
jjisnoob: is sitting out
supbigdiaper: posts big blind $5
*** HOLE CARDS ***
NZQT: raises $6 to $11
jjisnoob leaves the table
Rabarber77: calls $8.50
supbigdiaper: raises $46.50 to $57.50
NZQT: folds
Rabarber77: calls $46.50
*** FLOP *** [4s 8d Jh]
Rabarber77: checks
supbigdiaper: checks
*** TURN *** [4s 8d Jh] [3s]
Rabarber77: bets $40
supbigdiaper: calls $40
*** RIVER *** [4s 8d Jh 3s] [3h]
Rabarber77: bets $85
supbigdiaper: calls $85
*** SHOW DOWN ***
Rabarber77: shows [Jc Th] (two pair, Jacks and Threes)
supbigdiaper: mucks hand
Rabarber77 collected $374.50 from pot
*** SUMMARY ***
Total pot $376 | Rake $1.50
Board [4s 8d Jh 3s 3h]
Seat 1: Rabarber77 (small blind) showed [Jc Th] and won ($374.50) with two pair, Jacks and Threes
Seat 4: supbigdiaper (big blind) mucked
Seat 6: NZQT (button) folded before Flop


PokerStars Hand #222983526829:  Hold'em No Limit ($2.50/$5.00 USD) - 2021/01/23 21:47:20 ET
Table 'Aaltje II' 6-max Seat #1 is the button
Seat 1: Rabarber77 ($924.08 in chips)
Seat 4: supbigdiaper ($500 in chips)
Seat 6: NZQT ($500 in chips)
supbigdiaper: posts small blind $2.50
NZQT: posts big blind $5
*** HOLE CARDS ***
Rabarber77: raises $10 to $15
supbigdiaper: raises $52.50 to $67.50
NZQT: folds
Rabarber77: calls $52.50
*** FLOP *** [2c 5c 9c]
supbigdiaper: checks
Rabarber77: bets $55
supbigdiaper: calls $55
*** TURN *** [2c 5c 9c] [6s]
supbigdiaper: checks
Rabarber77: checks
*** RIVER *** [2c 5c 9c 6s] [9h]
supbigdiaper: checks
Rabarber77: bets $165
supbigdiaper: calls $165
*** SHOW DOWN ***
Rabarber77: shows [6c 7c] (a flush, Nine high)
supbigdiaper: mucks hand
Rabarber77 collected $578.50 from pot
*** SUMMARY ***
Total pot $580 | Rake $1.50
Board [2c 5c 9c 6s 9h]
Seat 1: Rabarber77 (button) showed [6c 7c] and won ($578.50) with a flush, Nine high
Seat 4: supbigdiaper (small blind) mucked
Seat 6: NZQT (big blind) folded before Flop


PokerStars Hand #222983548556:  Hold'em No Limit ($2.50/$5.00 USD) - 2021/01/23 21:48:16 ET
Table 'Aaltje II' 6-max Seat #4 is the button
Seat 1: Rabarber77 ($1215.08 in chips)
Seat 4: supbigdiaper ($500 in chips)
Seat 6: NZQT ($500 in chips)
NZQT: posts small blind $2.50
Rabarber77: posts big blind $5
Nutsfit: sits out
*** HOLE CARDS ***
supbigdiaper: raises $7.50 to $12.50
NZQT: folds
Rabarber77: calls $7.50
*** FLOP *** [6s 8h 9s]
Rabarber77: checks
supbigdiaper: bets $19.59
Rabarber77: calls $19.59
*** TURN *** [6s 8h 9s] [Qh]
Rabarber77: checks
supbigdiaper: bets $48.89
Rabarber77: calls $48.89
*** RIVER *** [6s 8h 9s Qh] [Jh]
Rabarber77: bets $81.48
supbigdiaper: calls $81.48
*** SHOW DOWN ***
Rabarber77: shows [6h 4h] (a flush, Queen high)
supbigdiaper: mucks hand
Rabarber77 collected $325.92 from pot
*** SUMMARY ***
Total pot $327.42 | Rake $1.50
Board [6s 8h 9s Qh Jh]
Seat 1: Rabarber77 (big blind) showed [6h 4h] and won ($325.92) with a flush, Queen high
Seat 4: supbigdiaper (button) mucked
Seat 6: NZQT (small blind) folded before Flop


PokerStars Hand #222983561674:  Hold'em No Limit ($2.50/$5.00 USD) - 2021/01/23 21:48:51 ET
Table 'Aaltje II' 6-max Seat #6 is the button
Seat 1: Rabarber77 ($1378.54 in chips)
Seat 2: Nutsfit ($1062.50 in chips)
Seat 4: supbigdiaper ($500 in chips)
Seat 6: NZQT ($500 in chips)
magorko joins the table at seat #3
Rabarber77: posts small blind $2.50
Nutsfit: posts big blind $5
*** HOLE CARDS ***
supbigdiaper: folds
NZQT: folds
Rabarber77: folds
Uncalled bet ($2.50) returned to Nutsfit
Nutsfit collected $5 from pot
Nutsfit: doesn't show hand
*** SUMMARY ***
Total pot $5 | Rake $0
Seat 1: Rabarber77 (small blind) folded before Flop
Seat 2: Nutsfit (big blind) collected ($5)
Seat 4: supbigdiaper folded before Flop (didn't bet)
Seat 6: NZQT (button) folded before Flop (didn't bet)


PokerStars Hand #222983563619:  Hold'em No Limit ($2.50/$5.00 USD) - 2021/01/23 21:48:56 ET
Table 'Aaltje II' 6-max Seat #1 is the button
Seat 1: Rabarber77 ($1376.04 in chips)
Seat 2: Nutsfit ($1065 in chips)
Seat 3: magorko ($500 in chips)
Seat 4: supbigdiaper ($500 in chips)
Seat 6: NZQT ($500 in chips)
Nutsfit: posts small blind $2.50
magorko: posts big blind $5
*** HOLE CARDS ***
supbigdiaper: folds
NZQT: raises $6 to $11
Rabarber77: folds
Nutsfit: folds
magorko: folds
Uncalled bet ($6) returned to NZQT
NZQT collected $12.50 from pot
NZQT: doesn't show hand
*** SUMMARY ***
Total pot $12.50 | Rake $0
Seat 1: Rabarber77 (button) folded before Flop (didn't bet)
Seat 2: Nutsfit (small blind) folded before Flop
Seat 3: magorko (big blind) folded before Flop
Seat 4: supbigdiaper folded before Flop (didn't bet)
Seat 6: NZQT collected ($12.50)


PokerStars Hand #222983572300:  Hold'em No Limit ($2.50/$5.00 USD) - 2021/01/23 21:49:07 ET
Table 'Aaltje II' 6-max Seat #2 is the button
Seat 1: Rabarber77 ($1376.04 in chips)
Seat 2: Nutsfit ($1062.50 in chips)
Seat 3: magorko ($500 in chips)
Seat 4: supbigdiaper ($500 in chips)
Seat 6: NZQT ($507.50 in chips)
magorko: posts small blind $2.50
supbigdiaper: posts big blind $5
*** HOLE CARDS ***
NZQT: folds
Rabarber77: raises $10 to $15
Nutsfit: folds
magorko: folds
supbigdiaper: folds
Uncalled bet ($10) returned to Rabarber77
Rabarber77 collected $12.50 from pot
Rabarber77: doesn't show hand
*** SUMMARY ***
Total pot $12.50 | Rake $0
Seat 1: Rabarber77 collected ($12.50)
Seat 2: Nutsfit (button) folded before Flop (didn't bet)
Seat 3: magorko (small blind) folded before Flop
Seat 4: supbigdiaper (big blind) folded before Flop
Seat 6: NZQT folded before Flop (didn't bet)


PokerStars Hand #222983577904:  Hold'em No Limit ($2.50/$5.00 USD) - 2021/01/23 21:49:22 ET
Table 'Aaltje II' 6-max Seat #3 is the button
Seat 1: Rabarber77 ($1383.54 in chips)
Seat 2: Nutsfit ($1062.50 in chips)
Seat 3: magorko ($500 in chips)
Seat 4: supbigdiaper ($500 in chips)
supbigdiaper: posts small blind $2.50
NZQT: is sitting out
Rabarber77: posts big blind $5
*** HOLE CARDS ***
Nutsfit: folds
NZQT leaves the table
magorko: raises $7.50 to $12.50
supbigdiaper: calls $10
Rabarber77: folds
*** FLOP *** [3h 6s Qc]
supbigdiaper: checks
magorko: bets $21.38
supbigdiaper: calls $21.38
*** TURN *** [3h 6s Qc] [Ac]
supbigdiaper: checks
magorko: bets $90.15
Yaaaazz joins the table at seat #5
supbigdiaper: calls $90.15
*** RIVER *** [3h 6s Qc Ac] [7s]
supbigdiaper: checks
magorko: checks
*** SHOW DOWN ***
supbigdiaper: shows [Ah 7h] (two pair, Aces and Sevens)
magorko: mucks hand
supbigdiaper collected $251.56 from pot
*** SUMMARY ***
Total pot $253.06 | Rake $1.50
Board [3h 6s Qc Ac 7s]
Seat 1: Rabarber77 (big blind) folded before Flop
Seat 2: Nutsfit folded before Flop (didn't bet)
Seat 3: magorko (button) mucked
Seat 4: supbigdiaper (small blind) showed [Ah 7h] and won ($251.56) with two pair, Aces and Sevens


PokerStars Hand #222983632961:  Hold'em No Limit ($2.50/$5.00 USD) - 2021/01/23 21:51:27 ET
Table 'Aaltje II' 6-max Seat #1 is the button
Seat 1: Rabarber77 ($1366.04 in chips)
Seat 2: Nutsfit ($1038.12 in chips)
Seat 3: magorko ($500 in chips)
Seat 4: supbigdiaper ($662.91 in chips)
Nutsfit: posts small blind $2.50
magorko: posts big blind $5
Yaaaazz: sits out
*** HOLE CARDS ***
supbigdiaper: raises $7.50 to $12.50
Rabarber77: calls $12.50
Nutsfit: folds
magorko: folds
*** FLOP *** [Qs Ad 7d]
supbigdiaper: checks
Rabarber77: bets $15.50
supbigdiaper: calls $15.50
*** TURN *** [Qs Ad 7d] [9h]
supbigdiaper: checks
Rabarber77: checks
*** RIVER *** [Qs Ad 7d 9h] [3h]
supbigdiaper: checks
Rabarber77: checks
*** SHOW DOWN ***
supbigdiaper: shows [Jd Kc] (high card Ace)
Rabarber77: shows [5d 5h] (a pair of Fives)
Rabarber77 collected $62 from pot
*** SUMMARY ***
Total pot $63.50 | Rake $1.50
Board [Qs Ad 7d 9h 3h]
Seat 1: Rabarber77 (button) showed [5d 5h] and won ($62) with a pair of Fives
Seat 2: Nutsfit (small blind) folded before Flop
Seat 3: magorko (big blind) folded before Flop
Seat 4: supbigdiaper showed [Jd Kc] and lost with high card Ace


PokerStars Hand #222983649899:  Hold'em No Limit ($2.50/$5.00 USD) - 2021/01/23 21:52:13 ET
Table 'Aaltje II' 6-max Seat #2 is the button
Seat 1: Rabarber77 ($1400.04 in chips)
Seat 2: Nutsfit ($1035.62 in chips)
Seat 3: magorko ($500 in chips)
Seat 4: supbigdiaper ($634.91 in chips)
magorko: posts small blind $2.50
supbigdiaper: posts big blind $5
Yaaaazz: sits out
*** HOLE CARDS ***
Rabarber77: folds
Nutsfit: raises $7.50 to $12.50
magorko: folds
supbigdiaper: calls $7.50
*** FLOP *** [Kh 2h 5d]
supbigdiaper: checks
johannes682 joins the table at seat #6
Nutsfit: bets $8.10
supbigdiaper: calls $8.10
*** TURN *** [Kh 2h 5d] [2s]
supbigdiaper: checks
Nutsfit: bets $28.91
supbigdiaper: folds
Uncalled bet ($28.91) returned to Nutsfit
Nutsfit collected $42.20 from pot
Nutsfit: doesn't show hand
*** SUMMARY ***
Total pot $43.70 | Rake $1.50
Board [Kh 2h 5d 2s]
Seat 1: Rabarber77 folded before Flop (didn't bet)
Seat 2: Nutsfit (button) collected ($42.20)
Seat 3: magorko (small blind) folded before Flop
Seat 4: supbigdiaper (big blind) folded on the Turn


PokerStars Hand #222983663358:  Hold'em No Limit ($2.50/$5.00 USD) - 2021/01/23 21:52:48 ET
Table 'Aaltje II' 6-max Seat #3 is the button
Seat 1: Rabarber77 ($1400.04 in chips)
Seat 2: Nutsfit ($1057.22 in chips)
Seat 3: magorko ($500 in chips)
Seat 4: supbigdiaper ($614.31 in chips)
Seat 5: Yaaaazz ($500 in chips)
supbigdiaper: posts small blind $2.50
Yaaaazz: posts big blind $5
johannes682: sits out
*** HOLE CARDS ***
Rabarber77: raises $10 to $15
Nutsfit: folds
magorko: folds
supbigdiaper: folds
Yaaaazz: folds
Uncalled bet ($10) returned to Rabarber77
Rabarber77 collected $12.50 from pot
Rabarber77: doesn't show hand
*** SUMMARY ***
Total pot $12.50 | Rake $0
Seat 1: Rabarber77 collected ($12.50)
Seat 2: Nutsfit folded before Flop (didn't bet)
Seat 3: magorko (button) folded before Flop (didn't bet)
Seat 4: supbigdiaper (small blind) folded before Flop
Seat 5: Yaaaazz (big blind) folded before Flop


PokerStars Hand #222983669406:  Hold'em No Limit ($2.50/$5.00 USD) - 2021/01/23 21:53:04 ET
Table 'Aaltje II' 6-max Seat #4 is the button
Seat 1: Rabarber77 ($1407.54 in chips)
Seat 2: Nutsfit ($1057.22 in chips)
Seat 3: magorko ($500 in chips)
Seat 4: supbigdiaper ($611.81 in chips)
Seat 5: Yaaaazz ($500 in chips)
Seat 6: johannes682 ($500 in chips)
Yaaaazz: posts small blind $2.50
johannes682: posts big blind $5
*** HOLE CARDS ***
Rabarber77: folds
Nutsfit: folds
magorko: folds
supbigdiaper: folds
Yaaaazz: folds
Uncalled bet ($2.50) returned to johannes682
johannes682 collected $5 from pot
johannes682: doesn't show hand
*** SUMMARY ***
Total pot $5 | Rake $0
Seat 1: Rabarber77 folded before Flop (didn't bet)
Seat 2: Nutsfit folded before Flop (didn't bet)
Seat 3: magorko folded before Flop (didn't bet)
Seat 4: supbigdiaper (button) folded before Flop (didn't bet)
Seat 5: Yaaaazz (small blind) folded before Flop
Seat 6: johannes682 (big blind) collected ($5)


PokerStars Hand #222983675516:  Hold'em No Limit ($2.50/$5.00 USD) - 2021/01/23 21:53:21 ET
Table 'Aaltje II' 6-max Seat #5 is the button
Seat 1: Rabarber77 ($1407.54 in chips)
Seat 2: Nutsfit ($1057.22 in chips)
Seat 3: magorko ($500 in chips)
Seat 4: supbigdiaper ($611.81 in chips)
Seat 5: Yaaaazz ($500 in chips)
Seat 6: johannes682 ($502.50 in chips)
johannes682: posts small blind $2.50
Rabarber77: posts big blind $5
*** HOLE CARDS ***
Nutsfit: folds
magorko: folds
supbigdiaper: folds
Yaaaazz: folds
johannes682: calls $2.50
Rabarber77: raises $10 to $15
johannes682: folds
Uncalled bet ($10) returned to Rabarber77
Rabarber77 collected $10 from pot
Rabarber77: doesn't show hand
*** SUMMARY ***
Total pot $10 | Rake $0
Seat 1: Rabarber77 (big blind) collected ($10)
Seat 2: Nutsfit folded before Flop (didn't bet)
Seat 3: magorko folded before Flop (didn't bet)
Seat 4: supbigdiaper folded before Flop (didn't bet)
Seat 5: Yaaaazz (button) folded before Flop (didn't bet)
Seat 6: johannes682 (small blind) folded before Flop


PokerStars Hand #222983686871:  Hold'em No Limit ($2.50/$5.00 USD) - 2021/01/23 21:53:51 ET
Table 'Aaltje II' 6-max Seat #6 is the button
Seat 1: Rabarber77 ($1412.54 in chips)
Seat 2: Nutsfit ($1057.22 in chips)
Seat 3: magorko ($500 in chips)
Seat 4: supbigdiaper ($611.81 in chips)
Seat 5: Yaaaazz ($500 in chips)
Seat 6: johannes682 ($497.50 in chips)
Rabarber77: posts small blind $2.50
Nutsfit: posts big blind $5
*** HOLE CARDS ***
magorko: raises $7.50 to $12.50
supbigdiaper: folds
Yaaaazz: folds
johannes682: folds
Rabarber77: calls $10
Nutsfit: folds
*** FLOP *** [5s 6c Js]
Rabarber77: checks
magorko: checks
*** TURN *** [5s 6c Js] [9s]
Rabarber77: bets $14.25
magorko: folds
Uncalled bet ($14.25) returned to Rabarber77
Rabarber77 collected $28.50 from pot
Rabarber77: doesn't show hand
*** SUMMARY ***
Total pot $30 | Rake $1.50
Board [5s 6c Js 9s]
Seat 1: Rabarber77 (small blind) collected ($28.50)
Seat 2: Nutsfit (big blind) folded before Flop
Seat 3: magorko folded on the Turn
Seat 4: supbigdiaper folded before Flop (didn't bet)
Seat 5: Yaaaazz folded before Flop (didn't bet)
Seat 6: johannes682 (button) folded before Flop (didn't bet)


PokerStars Hand #222983708578:  Hold'em No Limit ($2.50/$5.00 USD) - 2021/01/23 21:54:49 ET
Table 'Aaltje II' 6-max Seat #1 is the button
Seat 1: Rabarber77 ($1428.54 in chips)
Seat 2: Nutsfit ($1052.22 in chips)
Seat 3: magorko ($500 in chips)
Seat 4: supbigdiaper ($611.81 in chips)
Seat 5: Yaaaazz ($500 in chips)
Seat 6: johannes682 ($497.50 in chips)
Nutsfit: posts small blind $2.50
magorko: posts big blind $5
*** HOLE CARDS ***
supbigdiaper: raises $7.50 to $12.50
Yaaaazz: raises $25 to $37.50
johannes682: folds
Rabarber77: folds
Nutsfit: folds
magorko: folds
supbigdiaper: folds
Uncalled bet ($25) returned to Yaaaazz
Yaaaazz collected $32.50 from pot
Yaaaazz: doesn't show hand
*** SUMMARY ***
Total pot $32.50 | Rake $0
Seat 1: Rabarber77 (button) folded before Flop (didn't bet)
Seat 2: Nutsfit (small blind) folded before Flop
Seat 3: magorko (big blind) folded before Flop
Seat 4: supbigdiaper folded before Flop
Seat 5: Yaaaazz collected ($32.50)
Seat 6: johannes682 folded before Flop (didn't bet)


PokerStars Hand #222983716992:  Hold'em No Limit ($2.50/$5.00 USD) - 2021/01/23 21:55:12 ET
Table 'Aaltje II' 6-max Seat #2 is the button
Seat 1: Rabarber77 ($1428.54 in chips)
Seat 2: Nutsfit ($1049.72 in chips)
Seat 3: magorko ($500 in chips)
Seat 4: supbigdiaper ($599.31 in chips)
Seat 5: Yaaaazz ($520 in chips)
Seat 6: johannes682 ($497.50 in chips)
magorko: posts small blind $2.50
supbigdiaper: posts big blind $5
*** HOLE CARDS ***
Yaaaazz: folds
johannes682: calls $5
Rabarber77: raises $10 to $15
Nutsfit: folds
magorko: folds
supbigdiaper: folds
johannes682: calls $10
*** FLOP *** [Kd 4h Th]
johannes682: checks
Rabarber77: bets $25
johannes682: folds
Uncalled bet ($25) returned to Rabarber77
Rabarber77 collected $35.62 from pot
Rabarber77: doesn't show hand
*** SUMMARY ***
Total pot $37.50 | Rake $1.88
Board [Kd 4h Th]
Seat 1: Rabarber77 collected ($35.62)
Seat 2: Nutsfit (button) folded before Flop (didn't bet)
Seat 3: magorko (small blind) folded before Flop
Seat 4: supbigdiaper (big blind) folded before Flop
Seat 5: Yaaaazz folded before Flop (didn't bet)
Seat 6: johannes682 folded on the Flop


PokerStars Hand #222983743097:  Hold'em No Limit ($2.50/$5.00 USD) - 2021/01/23 21:56:13 ET
Table 'Aaltje II' 6-max Seat #3 is the button
Seat 1: Rabarber77 ($1449.16 in chips)
Seat 2: Nutsfit ($1049.72 in chips)
Seat 3: magorko ($500 in chips)
Seat 4: supbigdiaper ($594.31 in chips)
Seat 5: Yaaaazz ($520 in chips)
Seat 6: johannes682 ($482.50 in chips)
supbigdiaper: posts small blind $2.50
Yaaaazz: posts big blind $5
*** HOLE CARDS ***
johannes682: folds
Rabarber77: folds
Nutsfit: folds
magorko: folds
supbigdiaper: folds
Uncalled bet ($2.50) returned to Yaaaazz
Yaaaazz collected $5 from pot
Yaaaazz: doesn't show hand
*** SUMMARY ***
Total pot $5 | Rake $0
Seat 1: Rabarber77 folded before Flop (didn't bet)
Seat 2: Nutsfit folded before Flop (didn't bet)
Seat 3: magorko (button) folded before Flop (didn't bet)
Seat 4: supbigdiaper (small blind) folded before Flop
Seat 5: Yaaaazz (big blind) collected ($5)
Seat 6: johannes682 folded before Flop (didn't bet)


PokerStars Hand #222983746502:  Hold'em No Limit ($2.50/$5.00 USD) - 2021/01/23 21:56:26 ET
Table 'Aaltje II' 6-max Seat #4 is the button
Seat 1: Rabarber77 ($1449.16 in chips)
Seat 2: Nutsfit ($1049.72 in chips)
Seat 3: magorko ($500 in chips)
Seat 4: supbigdiaper ($591.81 in chips)
Seat 5: Yaaaazz ($522.50 in chips)
Seat 6: johannes682 ($482.50 in chips)
Yaaaazz: posts small blind $2.50
johannes682: posts big blind $5
*** HOLE CARDS ***
Rabarber77: raises $10 to $15
Nutsfit: folds
magorko: folds
supbigdiaper: folds
Yaaaazz: folds
johannes682: calls $10
*** FLOP *** [Qd Kc 2d]
johannes682: bets $15
Rabarber77: calls $15
*** TURN *** [Qd Kc 2d] [3h]
johannes682: checks
Rabarber77: bets $29.75
johannes682: folds
Uncalled bet ($29.75) returned to Rabarber77
Rabarber77 collected $59.50 from pot
Rabarber77: doesn't show hand
*** SUMMARY ***
Total pot $62.50 | Rake $3
Board [Qd Kc 2d 3h]
Seat 1: Rabarber77 collected ($59.50)
Seat 2: Nutsfit folded before Flop (didn't bet)
Seat 3: magorko folded before Flop (didn't bet)
Seat 4: supbigdiaper (button) folded before Flop (didn't bet)
Seat 5: Yaaaazz (small blind) folded before Flop
Seat 6: johannes682 (big blind) folded on the Turn


PokerStars Hand #222983757173:  Hold'em No Limit ($2.50/$5.00 USD) - 2021/01/23 21:57:05 ET
Table 'Aaltje II' 6-max Seat #5 is the button
Seat 1: Rabarber77 ($1478.66 in chips)
Seat 2: Nutsfit ($1049.72 in chips)
Seat 3: magorko ($500 in chips)
Seat 4: supbigdiaper ($591.81 in chips)
Seat 5: Yaaaazz ($520 in chips)
Seat 6: johannes682 ($452.50 in chips)
johannes682: posts small blind $2.50
Rabarber77: posts big blind $5
*** HOLE CARDS ***
Nutsfit: folds
magorko: folds
supbigdiaper: raises $7.50 to $12.50
Yaaaazz: folds
johannes682: folds
Rabarber77: calls $7.50
*** FLOP *** [5c Jc Ah]
Rabarber77: checks
supbigdiaper: bets $8.62
Rabarber77: calls $8.62
*** TURN *** [5c Jc Ah] [9h]
Rabarber77: checks
supbigdiaper: checks
*** RIVER *** [5c Jc Ah 9h] [6d]
Rabarber77: bets $42.50
supbigdiaper: calls $42.50
*** SHOW DOWN ***
Rabarber77: shows [As 6c] (two pair, Aces and Sixes)
supbigdiaper: mucks hand
Rabarber77 collected $126.74 from pot
*** SUMMARY ***
Total pot $129.74 | Rake $3
Board [5c Jc Ah 9h 6d]
Seat 1: Rabarber77 (big blind) showed [As 6c] and won ($126.74) with two pair, Aces and Sixes
Seat 2: Nutsfit folded before Flop (didn't bet)
Seat 3: magorko folded before Flop (didn't bet)
Seat 4: supbigdiaper mucked
Seat 5: Yaaaazz (button) folded before Flop (didn't bet)
Seat 6: johannes682 (small blind) folded before Flop


PokerStars Hand #222983765723:  Hold'em No Limit ($2.50/$5.00 USD) - 2021/01/23 21:57:36 ET
Table 'Aaltje II' 6-max Seat #6 is the button
Seat 1: Rabarber77 ($1541.78 in chips)
Seat 2: Nutsfit ($1049.72 in chips)
Seat 3: magorko ($500 in chips)
Seat 4: supbigdiaper ($528.19 in chips)
Seat 5: Yaaaazz ($520 in chips)
Seat 6: johannes682 ($450 in chips)
Rabarber77: posts small blind $2.50
Nutsfit: posts big blind $5
*** HOLE CARDS ***
magorko: raises $7.50 to $12.50
supbigdiaper: folds
Yaaaazz: folds
johannes682: folds
Rabarber77: folds
Nutsfit: folds
Uncalled bet ($7.50) returned to magorko
magorko collected $12.50 from pot
magorko: doesn't show hand
*** SUMMARY ***
Total pot $12.50 | Rake $0
Seat 1: Rabarber77 (small blind) folded before Flop
Seat 2: Nutsfit (big blind) folded before Flop
Seat 3: magorko collected ($12.50)
Seat 4: supbigdiaper folded before Flop (didn't bet)
Seat 5: Yaaaazz folded before Flop (didn't bet)
Seat 6: johannes682 (button) folded before Flop (didn't bet)


PokerStars Hand #222983772172:  Hold'em No Limit ($2.50/$5.00 USD) - 2021/01/23 21:58:00 ET
Table 'Aaltje II' 6-max Seat #1 is the button
Seat 1: Rabarber77 ($1539.28 in chips)
Seat 2: Nutsfit ($1044.72 in chips)
Seat 3: magorko ($507.50 in chips)
Seat 4: supbigdiaper ($528.19 in chips)
Seat 5: Yaaaazz ($520 in chips)
Seat 6: johannes682 ($450 in chips)
Nutsfit: posts small blind $2.50
magorko: posts big blind $5
*** HOLE CARDS ***
supbigdiaper: raises $7.50 to $12.50
Yaaaazz: folds
johannes682: folds
Rabarber77: folds
Nutsfit: folds
magorko: folds
Uncalled bet ($7.50) returned to supbigdiaper
supbigdiaper collected $12.50 from pot
supbigdiaper: doesn't show hand
*** SUMMARY ***
Total pot $12.50 | Rake $0
Seat 1: Rabarber77 (button) folded before Flop (didn't bet)
Seat 2: Nutsfit (small blind) folded before Flop
Seat 3: magorko (big blind) folded before Flop
Seat 4: supbigdiaper collected ($12.50)
Seat 5: Yaaaazz folded before Flop (didn't bet)
Seat 6: johannes682 folded before Flop (didn't bet)


PokerStars Hand #222983778972:  Hold'em No Limit ($2.50/$5.00 USD) - 2021/01/23 21:58:25 ET
Table 'Aaltje II' 6-max Seat #2 is the button
Seat 1: Rabarber77 ($1539.28 in chips)
Seat 2: Nutsfit ($1042.22 in chips)
Seat 3: magorko ($502.50 in chips)
Seat 4: supbigdiaper ($535.69 in chips)
Seat 5: Yaaaazz ($520 in chips)
Seat 6: johannes682 ($450 in chips)
magorko: posts small blind $2.50
supbigdiaper: posts big blind $5
*** HOLE CARDS ***
Yaaaazz: folds
johannes682: folds
Rabarber77: raises $10 to $15
Nutsfit: folds
magorko: folds
supbigdiaper: calls $10
*** FLOP *** [8h 3d Tc]
supbigdiaper: checks
Rabarber77: bets $15.44
supbigdiaper: folds
Uncalled bet ($15.44) returned to Rabarber77
Rabarber77 collected $30.88 from pot
Rabarber77: doesn't show hand
*** SUMMARY ***
Total pot $32.50 | Rake $1.62
Board [8h 3d Tc]
Seat 1: Rabarber77 collected ($30.88)
Seat 2: Nutsfit (button) folded before Flop (didn't bet)
Seat 3: magorko (small blind) folded before Flop
Seat 4: supbigdiaper (big blind) folded on the Flop
Seat 5: Yaaaazz folded before Flop (didn't bet)
Seat 6: johannes682 folded before Flop (didn't bet)


PokerStars Hand #222983786232:  Hold'em No Limit ($2.50/$5.00 USD) - 2021/01/23 21:58:52 ET
Table 'Aaltje II' 6-max Seat #3 is the button
Seat 1: Rabarber77 ($1555.16 in chips)
Seat 2: Nutsfit ($1042.22 in chips)
Seat 3: magorko ($500 in chips)
Seat 4: supbigdiaper ($520.69 in chips)
Seat 5: Yaaaazz ($520 in chips)
Seat 6: johannes682 ($450 in chips)
supbigdiaper: posts small blind $2.50
Yaaaazz: posts big blind $5
*** HOLE CARDS ***
johannes682: folds
Rabarber77: raises $10 to $15
Nutsfit: folds
magorko: folds
supbigdiaper: folds
Yaaaazz: folds
Uncalled bet ($10) returned to Rabarber77
Rabarber77 collected $12.50 from pot
Rabarber77: doesn't show hand
*** SUMMARY ***
Total pot $12.50 | Rake $0
Seat 1: Rabarber77 collected ($12.50)
Seat 2: Nutsfit folded before Flop (didn't bet)
Seat 3: magorko (button) folded before Flop (didn't bet)
Seat 4: supbigdiaper (small blind) folded before Flop
Seat 5: Yaaaazz (big blind) folded before Flop
Seat 6: johannes682 folded before Flop (didn't bet)


PokerStars Hand #222983791286:  Hold'em No Limit ($2.50/$5.00 USD) - 2021/01/23 21:59:11 ET
Table 'Aaltje II' 6-max Seat #4 is the button
Seat 1: Rabarber77 ($1562.66 in chips)
Seat 2: Nutsfit ($1042.22 in chips)
Seat 3: magorko ($500 in chips)
Seat 4: supbigdiaper ($518.19 in chips)
Seat 5: Yaaaazz ($515 in chips)
Seat 6: johannes682 ($450 in chips)
Yaaaazz: posts small blind $2.50
johannes682: posts big blind $5
*** HOLE CARDS ***
Rabarber77: folds
Nutsfit: folds
magorko: raises $7.50 to $12.50
supbigdiaper: folds
Yaaaazz: folds
johannes682: folds
Uncalled bet ($7.50) returned to magorko
magorko collected $12.50 from pot
magorko: doesn't show hand
*** SUMMARY ***
Total pot $12.50 | Rake $0
Seat 1: Rabarber77 folded before Flop (didn't bet)
Seat 2: Nutsfit folded before Flop (didn't bet)
Seat 3: magorko collected ($12.50)
Seat 4: supbigdiaper (button) folded before Flop (didn't bet)
Seat 5: Yaaaazz (small blind) folded before Flop
Seat 6: johannes682 (big blind) folded before Flop


PokerStars Hand #222983799184:  Hold'em No Limit ($2.50/$5.00 USD) - 2021/01/23 21:59:40 ET
Table 'Aaltje II' 6-max Seat #5 is the button
Seat 1: Rabarber77 ($1562.66 in chips)
Seat 2: Nutsfit ($1042.22 in chips)
Seat 3: magorko ($507.50 in chips)
Seat 4: supbigdiaper ($518.19 in chips)
Seat 5: Yaaaazz ($512.50 in chips)
Seat 6: johannes682 ($445 in chips)
johannes682: posts small blind $2.50
Rabarber77: posts big blind $5
*** HOLE CARDS ***
Nutsfit: raises $5.90 to $10.90
magorko: folds
supbigdiaper: folds
Yaaaazz: folds
johannes682: calls $8.40
Rabarber77: calls $5.90
*** FLOP *** [6d 3s 9c]
johannes682: checks
Rabarber77: bets $15
Nutsfit: calls $15
johannes682: raises $70 to $85
Rabarber77: folds
Nutsfit: folds
Uncalled bet ($70) returned to johannes682
johannes682 collected $74.70 from pot
johannes682: doesn't show hand
*** SUMMARY ***
Total pot $77.70 | Rake $3
Board [6d 3s 9c]
Seat 1: Rabarber77 (big blind) folded on the Flop
Seat 2: Nutsfit folded on the Flop
Seat 3: magorko folded before Flop (didn't bet)
Seat 4: supbigdiaper folded before Flop (didn't bet)
Seat 5: Yaaaazz (button) folded before Flop (didn't bet)
Seat 6: johannes682 (small blind) collected ($74.70)


PokerStars Hand #222983812750:  Hold'em No Limit ($2.50/$5.00 USD) - 2021/01/23 22:00:27 ET
Table 'Aaltje II' 6-max Seat #6 is the button
Seat 1: Rabarber77 ($1536.76 in chips)
Seat 2: Nutsfit ($1016.32 in chips)
Seat 3: magorko ($507.50 in chips)
Seat 4: supbigdiaper ($518.19 in chips)
Seat 5: Yaaaazz ($512.50 in chips)
Seat 6: johannes682 ($493.80 in chips)
Rabarber77: posts small blind $2.50
Nutsfit: posts big blind $5
*** HOLE CARDS ***
magorko: folds
supbigdiaper: raises $7.50 to $12.50
Yaaaazz: calls $12.50
johannes682: folds
Rabarber77: folds
Nutsfit: folds
*** FLOP *** [2h 5d Kd]
supbigdiaper: bets $10.19
Yaaaazz: raises $16.92 to $27.11
supbigdiaper: calls $16.92
*** TURN *** [2h 5d Kd] [Td]
supbigdiaper: checks
Yaaaazz: checks
*** RIVER *** [2h 5d Kd Td] [7c]
supbigdiaper: bets $62.79
Yaaaazz: folds
Uncalled bet ($62.79) returned to supbigdiaper
supbigdiaper collected $83.72 from pot
supbigdiaper: doesn't show hand
*** SUMMARY ***
Total pot $86.72 | Rake $3
Board [2h 5d Kd Td 7c]
Seat 1: Rabarber77 (small blind) folded before Flop
Seat 2: Nutsfit (big blind) folded before Flop
Seat 3: magorko folded before Flop (didn't bet)
Seat 4: supbigdiaper collected ($83.72)
Seat 5: Yaaaazz folded on the River
Seat 6: johannes682 (button) folded before Flop (didn't bet)


PokerStars Hand #222983839601:  Hold'em No Limit ($2.50/$5.00 USD) - 2021/01/23 22:01:44 ET
Table 'Aaltje II' 6-max Seat #1 is the button
Seat 1: Rabarber77 ($1534.26 in chips)
Seat 2: Nutsfit ($1011.32 in chips)
Seat 3: magorko ($507.50 in chips)
Seat 4: supbigdiaper ($562.30 in chips)
Seat 5: Yaaaazz ($500 in chips)
Seat 6: johannes682 ($493.80 in chips)
Nutsfit: posts small blind $2.50
magorko: posts big blind $5
*** HOLE CARDS ***
supbigdiaper: folds
Yaaaazz: folds
johannes682: folds
Rabarber77: folds
Nutsfit: raises $10 to $15
magorko: calls $10
*** FLOP *** [Tc Ad 9h]
Nutsfit: bets $8.83
magorko: calls $8.83
*** TURN *** [Tc Ad 9h] [As]
Nutsfit: checks
magorko: checks
*** RIVER *** [Tc Ad 9h As] [Kh]
Nutsfit: checks
magorko: bets $22.64
Nutsfit: folds
Uncalled bet ($22.64) returned to magorko
magorko collected $45.28 from pot
magorko: doesn't show hand
*** SUMMARY ***
Total pot $47.66 | Rake $2.38
Board [Tc Ad 9h As Kh]
Seat 1: Rabarber77 (button) folded before Flop (didn't bet)
Seat 2: Nutsfit (small blind) folded on the River
Seat 3: magorko (big blind) collected ($45.28)
Seat 4: supbigdiaper folded before Flop (didn't bet)
Seat 5: Yaaaazz folded before Flop (didn't bet)
Seat 6: johannes682 folded before Flop (didn't bet)


PokerStars Hand #222983870656:  Hold'em No Limit ($2.50/$5.00 USD) - 2021/01/23 22:03:07 ET
Table 'Aaltje II' 6-max Seat #2 is the button
Seat 1: Rabarber77 ($1534.26 in chips)
Seat 2: Nutsfit ($987.49 in chips)
Seat 3: magorko ($528.95 in chips)
Seat 4: supbigdiaper ($562.30 in chips)
Seat 5: Yaaaazz ($500 in chips)
Seat 6: johannes682 ($493.80 in chips)
magorko: posts small blind $2.50
supbigdiaper: posts big blind $5
*** HOLE CARDS ***
Yaaaazz: folds
johannes682: folds
Rabarber77: raises $10 to $15
Nutsfit: raises $30 to $45
magorko: folds
supbigdiaper: folds
Rabarber77: calls $30
*** FLOP *** [Td 5s Qh]
Rabarber77: checks
Nutsfit: checks
*** TURN *** [Td 5s Qh] [Kc]
Rabarber77: bets $47.25
Nutsfit: folds
Uncalled bet ($47.25) returned to Rabarber77
Rabarber77 collected $94.50 from pot
Rabarber77: doesn't show hand
*** SUMMARY ***
Total pot $97.50 | Rake $3
Board [Td 5s Qh Kc]
Seat 1: Rabarber77 collected ($94.50)
Seat 2: Nutsfit (button) folded on the Turn
Seat 3: magorko (small blind) folded before Flop
Seat 4: supbigdiaper (big blind) folded before Flop
Seat 5: Yaaaazz folded before Flop (didn't bet)
Seat 6: johannes682 folded before Flop (didn't bet)


PokerStars Hand #222983885537:  Hold'em No Limit ($2.50/$5.00 USD) - 2021/01/23 22:03:47 ET
Table 'Aaltje II' 6-max Seat #3 is the button
Seat 1: Rabarber77 ($1583.76 in chips)
Seat 2: Nutsfit ($942.49 in chips)
Seat 3: magorko ($526.45 in chips)
Seat 4: supbigdiaper ($557.30 in chips)
Seat 5: Yaaaazz ($500 in chips)
Seat 6: johannes682 ($493.80 in chips)
supbigdiaper: posts small blind $2.50
Yaaaazz: posts big blind $5
*** HOLE CARDS ***
johannes682: folds
Rabarber77: folds
Nutsfit: folds
magorko: folds
supbigdiaper: raises $7.50 to $12.50
Yaaaazz: folds
Uncalled bet ($7.50) returned to supbigdiaper
supbigdiaper collected $10 from pot
supbigdiaper: doesn't show hand
*** SUMMARY ***
Total pot $10 | Rake $0
Seat 1: Rabarber77 folded before Flop (didn't bet)
Seat 2: Nutsfit folded before Flop (didn't bet)
Seat 3: magorko (button) folded before Flop (didn't bet)
Seat 4: supbigdiaper (small blind) collected ($10)
Seat 5: Yaaaazz (big blind) folded before Flop
Seat 6: johannes682 folded before Flop (didn't bet)


PokerStars Hand #222983891879:  Hold'em No Limit ($2.50/$5.00 USD) - 2021/01/23 22:04:04 ET
Table 'Aaltje II' 6-max Seat #4 is the button
Seat 1: Rabarber77 ($1583.76 in chips)
Seat 2: Nutsfit ($942.49 in chips)
Seat 3: magorko ($526.45 in chips)
Seat 4: supbigdiaper ($562.30 in chips)
Seat 5: Yaaaazz ($500 in chips)
Seat 6: johannes682 ($493.80 in chips)
Yaaaazz: posts small blind $2.50
johannes682: posts big blind $5
*** HOLE CARDS ***
Rabarber77: raises $10 to $15
Nutsfit: folds
magorko: folds
supbigdiaper: folds
Yaaaazz has timed out
Yaaaazz: folds
johannes682: folds
Uncalled bet ($10) returned to Rabarber77
Rabarber77 collected $12.50 from pot
Rabarber77: doesn't show hand
*** SUMMARY ***
Total pot $12.50 | Rake $0
Seat 1: Rabarber77 collected ($12.50)
Seat 2: Nutsfit folded before Flop (didn't bet)
Seat 3: magorko folded before Flop (didn't bet)
Seat 4: supbigdiaper (button) folded before Flop (didn't bet)
Seat 5: Yaaaazz (small blind) folded before Flop
Seat 6: johannes682 (big blind) folded before Flop


PokerStars Hand #222983905962:  Hold'em No Limit ($2.50/$5.00 USD) - 2021/01/23 22:04:42 ET
Table 'Aaltje II' 6-max Seat #5 is the button
Seat 1: Rabarber77 ($1591.26 in chips)
Seat 2: Nutsfit ($942.49 in chips)
Seat 3: magorko ($526.45 in chips)
Seat 4: supbigdiaper ($562.30 in chips)
Seat 5: Yaaaazz ($500 in chips)
Seat 6: johannes682 ($488.80 in chips)
johannes682: posts small blind $2.50
Rabarber77: posts big blind $5
*** HOLE CARDS ***
Nutsfit: raises $5.90 to $10.90
magorko: folds
supbigdiaper: folds
Yaaaazz: folds
johannes682: folds
Rabarber77: folds
Uncalled bet ($5.90) returned to Nutsfit
Nutsfit collected $12.50 from pot
Nutsfit: doesn't show hand
*** SUMMARY ***
Total pot $12.50 | Rake $0
Seat 1: Rabarber77 (big blind) folded before Flop
Seat 2: Nutsfit collected ($12.50)
Seat 3: magorko folded before Flop (didn't bet)
Seat 4: supbigdiaper folded before Flop (didn't bet)
Seat 5: Yaaaazz (button) folded before Flop (didn't bet)
Seat 6: johannes682 (small blind) folded before Flop


PokerStars Hand #222983912434:  Hold'em No Limit ($2.50/$5.00 USD) - 2021/01/23 22:04:59 ET
Table 'Aaltje II' 6-max Seat #6 is the button
Seat 1: Rabarber77 ($1586.26 in chips)
Seat 2: Nutsfit ($949.99 in chips)
Seat 3: magorko ($526.45 in chips)
Seat 4: supbigdiaper ($562.30 in chips)
Seat 5: Yaaaazz ($500 in chips)
Seat 6: johannes682 ($486.30 in chips)
Rabarber77: posts small blind $2.50
Nutsfit: posts big blind $5
*** HOLE CARDS ***
magorko: folds
supbigdiaper: folds
Yaaaazz: folds
johannes682: folds
Rabarber77: folds
Uncalled bet ($2.50) returned to Nutsfit
Nutsfit collected $5 from pot
Nutsfit: doesn't show hand
*** SUMMARY ***
Total pot $5 | Rake $0
Seat 1: Rabarber77 (small blind) folded before Flop
Seat 2: Nutsfit (big blind) collected ($5)
Seat 3: magorko folded before Flop (didn't bet)
Seat 4: supbigdiaper folded before Flop (didn't bet)
Seat 5: Yaaaazz folded before Flop (didn't bet)
Seat 6: johannes682 (button) folded before Flop (didn't bet)


PokerStars Hand #222983916170:  Hold'em No Limit ($2.50/$5.00 USD) - 2021/01/23 22:05:09 ET
Table 'Aaltje II' 6-max Seat #1 is the button
Seat 1: Rabarber77 ($1583.76 in chips)
Seat 2: Nutsfit ($952.49 in chips)
Seat 3: magorko ($526.45 in chips)
Seat 4: supbigdiaper ($562.30 in chips)
Seat 5: Yaaaazz ($500 in chips)
Seat 6: johannes682 ($486.30 in chips)
Nutsfit: posts small blind $2.50
magorko: posts big blind $5
*** HOLE CARDS ***
supbigdiaper: folds
Yaaaazz: folds
johannes682: raises $10 to $15
Rabarber77: calls $15
Nutsfit: folds
magorko: folds
*** FLOP *** [8d 2c 7c]
johannes682: bets $15
Rabarber77: calls $15
*** TURN *** [8d 2c 7c] [9s]
johannes682: checks
Rabarber77: bets $40
johannes682: calls $40
*** RIVER *** [8d 2c 7c 9s] [4c]
johannes682: checks
Rabarber77: bets $90
johannes682: calls $90
*** SHOW DOWN ***
Rabarber77: shows [6h Qh] (high card Queen)
johannes682: shows [9d 8h] (two pair, Nines and Eights)
johannes682 collected $324.50 from pot
*** SUMMARY ***
Total pot $327.50 | Rake $3
Board [8d 2c 7c 9s 4c]
Seat 1: Rabarber77 (button) showed [6h Qh] and lost with high card Queen
Seat 2: Nutsfit (small blind) folded before Flop
Seat 3: magorko (big blind) folded before Flop
Seat 4: supbigdiaper folded before Flop (didn't bet)
Seat 5: Yaaaazz folded before Flop (didn't bet)
Seat 6: johannes682 showed [9d 8h] and won ($324.50) with two pair, Nines and Eights


PokerStars Hand #222983934134:  Hold'em No Limit ($2.50/$5.00 USD) - 2021/01/23 22:05:57 ET
Table 'Aaltje II' 6-max Seat #2 is the button
Seat 1: Rabarber77 ($1423.76 in chips)
Seat 2: Nutsfit ($949.99 in chips)
Seat 3: magorko ($521.45 in chips)
Seat 4: supbigdiaper ($562.30 in chips)
Seat 5: Yaaaazz ($500 in chips)
Seat 6: johannes682 ($650.80 in chips)
magorko: posts small blind $2.50
supbigdiaper: posts big blind $5
*** HOLE CARDS ***
Yaaaazz: folds
johannes682: calls $5
Rabarber77: raises $10 to $15
Nutsfit: raises $30 to $45
magorko: folds
supbigdiaper: folds
johannes682: calls $40
Rabarber77: calls $30
*** FLOP *** [Qd 6h 7d]
johannes682: checks
Rabarber77: checks
Nutsfit: checks
*** TURN *** [Qd 6h 7d] [2h]
johannes682: bets $50
Rabarber77: folds
Nutsfit: calls $50
*** RIVER *** [Qd 6h 7d 2h] [Qc]
johannes682: bets $100
Nutsfit: calls $100
*** SHOW DOWN ***
johannes682: shows [Js Qs] (three of a kind, Queens)
Nutsfit: mucks hand
johannes682 collected $439.50 from pot
*** SUMMARY ***
Total pot $442.50 | Rake $3
Board [Qd 6h 7d 2h Qc]
Seat 1: Rabarber77 folded on the Turn
Seat 2: Nutsfit (button) mucked
Seat 3: magorko (small blind) folded before Flop
Seat 4: supbigdiaper (big blind) folded before Flop
Seat 5: Yaaaazz folded before Flop (didn't bet)
Seat 6: johannes682 showed [Js Qs] and won ($439.50) with three of a kind, Queens


PokerStars Hand #222983961856:  Hold'em No Limit ($2.50/$5.00 USD) - 2021/01/23 22:07:12 ET
Table 'Aaltje II' 6-max Seat #3 is the button
Seat 1: Rabarber77 ($1378.76 in chips)
Seat 2: Nutsfit ($754.99 in chips)
Seat 3: magorko ($518.95 in chips)
Seat 4: supbigdiaper ($557.30 in chips)
Seat 5: Yaaaazz ($500 in chips)
Seat 6: johannes682 ($895.30 in chips)
supbigdiaper: posts small blind $2.50
Yaaaazz: posts big blind $5
*** HOLE CARDS ***
johannes682: folds
johannes682 leaves the table
Rabarber77: raises $10 to $15
Nutsfit: folds
magorko: folds
supbigdiaper: folds
Yaaaazz: folds
Uncalled bet ($10) returned to Rabarber77
Rabarber77 collected $12.50 from pot
Rabarber77: doesn't show hand
*** SUMMARY ***
Total pot $12.50 | Rake $0
Seat 1: Rabarber77 collected ($12.50)
Seat 2: Nutsfit folded before Flop (didn't bet)
Seat 3: magorko (button) folded before Flop (didn't bet)
Seat 4: supbigdiaper (small blind) folded before Flop
Seat 5: Yaaaazz (big blind) folded before Flop
Seat 6: johannes682 folded before Flop (didn't bet)


PokerStars Hand #222983968999:  Hold'em No Limit ($2.50/$5.00 USD) - 2021/01/23 22:07:32 ET
Table 'Aaltje II' 6-max Seat #4 is the button
Seat 1: Rabarber77 ($1386.26 in chips)
Seat 2: Nutsfit ($754.99 in chips)
Seat 3: magorko ($518.95 in chips)
Seat 4: supbigdiaper ($554.80 in chips)
Seat 5: Yaaaazz ($500 in chips)
Yaaaazz: posts small blind $2.50
Rabarber77: posts big blind $5
*** HOLE CARDS ***
Nutsfit: folds
magorko: raises $7.50 to $12.50
supbigdiaper: calls $12.50
Yaaaazz: folds
Rabarber77: calls $7.50
*** FLOP *** [Ks 4c Qh]
777Koresh777 joins the table at seat #6
Rabarber77: checks
magorko: checks
supbigdiaper: checks
*** TURN *** [Ks 4c Qh] [7c]
Rabarber77: bets $25
magorko: folds
supbigdiaper: calls $25
*** RIVER *** [Ks 4c Qh 7c] [8h]
Rabarber77: bets $55
supbigdiaper: calls $55
*** SHOW DOWN ***
Rabarber77: shows [2s Kc] (a pair of Kings)
supbigdiaper: mucks hand
Rabarber77 collected $197 from pot
*** SUMMARY ***
Total pot $200 | Rake $3
Board [Ks 4c Qh 7c 8h]
Seat 1: Rabarber77 (big blind) showed [2s Kc] and won ($197) with a pair of Kings
Seat 2: Nutsfit folded before Flop (didn't bet)
Seat 3: magorko folded on the Turn
Seat 4: supbigdiaper (button) mucked
Seat 5: Yaaaazz (small blind) folded before Flop


PokerStars Hand #222983989021:  Hold'em No Limit ($2.50/$5.00 USD) - 2021/01/23 22:08:26 ET
Table 'Aaltje II' 6-max Seat #5 is the button
Seat 1: Rabarber77 ($1490.76 in chips)
Seat 2: Nutsfit ($754.99 in chips)
Seat 3: magorko ($506.45 in chips)
Seat 4: supbigdiaper ($500 in chips)
Seat 5: Yaaaazz ($500 in chips)
Rabarber77: posts small blind $2.50
Nutsfit: posts big blind $5
*** HOLE CARDS ***
magorko: folds
supbigdiaper: folds
Yaaaazz: folds
Rabarber77: folds
Uncalled bet ($2.50) returned to Nutsfit
Nutsfit collected $5 from pot
Nutsfit: doesn't show hand
*** SUMMARY ***
Total pot $5 | Rake $0
Seat 1: Rabarber77 (small blind) folded before Flop
Seat 2: Nutsfit (big blind) collected ($5)
Seat 3: magorko folded before Flop (didn't bet)
Seat 4: supbigdiaper folded before Flop (didn't bet)
Seat 5: Yaaaazz (button) folded before Flop (didn't bet)


PokerStars Hand #222983995394:  Hold'em No Limit ($2.50/$5.00 USD) - 2021/01/23 22:08:43 ET
Table 'Aaltje II' 6-max Seat #1 is the button
Seat 1: Rabarber77 ($1488.26 in chips)
Seat 2: Nutsfit ($757.49 in chips)
Seat 3: magorko ($506.45 in chips)
Seat 4: supbigdiaper ($500 in chips)
Seat 5: Yaaaazz ($500 in chips)
Nutsfit: posts small blind $2.50
magorko: posts big blind $5
777Koresh777: sits out
*** HOLE CARDS ***
supbigdiaper: folds
Yaaaazz: folds
Rabarber77: folds
Nutsfit: folds
Uncalled bet ($2.50) returned to magorko
magorko collected $5 from pot
magorko: doesn't show hand
*** SUMMARY ***
Total pot $5 | Rake $0
Seat 1: Rabarber77 (button) folded before Flop (didn't bet)
Seat 2: Nutsfit (small blind) folded before Flop
Seat 3: magorko (big blind) collected ($5)
Seat 4: supbigdiaper folded before Flop (didn't bet)
Seat 5: Yaaaazz folded before Flop (didn't bet)


PokerStars Hand #222983998414:  Hold'em No Limit ($2.50/$5.00 USD) - 2021/01/23 22:08:51 ET
Table 'Aaltje II' 6-max Seat #2 is the button
Seat 1: Rabarber77 ($1488.26 in chips)
Seat 2: Nutsfit ($754.99 in chips)
Seat 3: magorko ($508.95 in chips)
Seat 4: supbigdiaper ($500 in chips)
Seat 5: Yaaaazz ($500 in chips)
magorko: posts small blind $2.50
supbigdiaper: posts big blind $5
777Koresh777: sits out
*** HOLE CARDS ***
Yaaaazz has timed out
Yaaaazz: folds
Rabarber77: folds
Nutsfit: folds
magorko: folds
Uncalled bet ($2.50) returned to supbigdiaper
supbigdiaper collected $5 from pot
supbigdiaper: doesn't show hand
*** SUMMARY ***
Total pot $5 | Rake $0
Seat 1: Rabarber77 folded before Flop (didn't bet)
Seat 2: Nutsfit (button) folded before Flop (didn't bet)
Seat 3: magorko (small blind) folded before Flop
Seat 4: supbigdiaper (big blind) collected ($5)
Seat 5: Yaaaazz folded before Flop (didn't bet)


PokerStars Hand #222984006329:  Hold'em No Limit ($2.50/$5.00 USD) - 2021/01/23 22:09:13 ET
Table 'Aaltje II' 6-max Seat #3 is the button
Seat 1: Rabarber77 ($1488.26 in chips)
Seat 2: Nutsfit ($754.99 in chips)
Seat 3: magorko ($506.45 in chips)
Seat 4: supbigdiaper ($502.50 in chips)
Seat 5: Yaaaazz ($500 in chips)
supbigdiaper: posts small blind $2.50
Yaaaazz: posts big blind $5
777Koresh777: sits out
*** HOLE CARDS ***
Rabarber77: folds
Nutsfit: folds
magorko: raises $7.50 to $12.50
supbigdiaper: folds
Yaaaazz: calls $7.50
*** FLOP *** [4d Js 2c]
Yaaaazz: checks
magorko: bets $8.62
Yaaaazz: calls $8.62
*** TURN *** [4d Js 2c] [6h]
Yaaaazz: checks
magorko: bets $21.25
Yaaaazz: calls $21.25
*** RIVER *** [4d Js 2c 6h] [3d]
Yaaaazz: checks
magorko: bets $42.12
Yaaaazz: folds
Uncalled bet ($42.12) returned to magorko
magorko collected $84.24 from pot
magorko: doesn't show hand
*** SUMMARY ***
Total pot $87.24 | Rake $3
Board [4d Js 2c 6h 3d]
Seat 1: Rabarber77 folded before Flop (didn't bet)
Seat 2: Nutsfit folded before Flop (didn't bet)
Seat 3: magorko (button) collected ($84.24)
Seat 4: supbigdiaper (small blind) folded before Flop
Seat 5: Yaaaazz (big blind) folded on the River


PokerStars Hand #222984048067:  Hold'em No Limit ($2.50/$5.00 USD) - 2021/01/23 22:11:07 ET
Table 'Aaltje II' 6-max Seat #4 is the button
Seat 1: Rabarber77 ($1488.26 in chips)
Seat 2: Nutsfit ($754.99 in chips)
Seat 3: magorko ($548.32 in chips)
Seat 4: supbigdiaper ($500 in chips)
Seat 5: Yaaaazz ($500 in chips)
Seat 6: 777Koresh777 ($523.03 in chips)
Yaaaazz: posts small blind $2.50
777Koresh777: posts big blind $5
*** HOLE CARDS ***
Rabarber77: raises $10 to $15
Nutsfit: folds
magorko: folds
supbigdiaper: folds
Yaaaazz: folds
777Koresh777: calls $10
*** FLOP *** [Qs 3d 5c]
777Koresh777: checks
Rabarber77: bets $20
777Koresh777: raises $30 to $50
Rabarber77: calls $30
*** TURN *** [Qs 3d 5c] [Td]
777Koresh777: checks
Rabarber77: bets $65
777Koresh777: folds
Uncalled bet ($65) returned to Rabarber77
Rabarber77 collected $129.50 from pot
Rabarber77: doesn't show hand
*** SUMMARY ***
Total pot $132.50 | Rake $3
Board [Qs 3d 5c Td]
Seat 1: Rabarber77 collected ($129.50)
Seat 2: Nutsfit folded before Flop (didn't bet)
Seat 3: magorko folded before Flop (didn't bet)
Seat 4: supbigdiaper (button) folded before Flop (didn't bet)
Seat 5: Yaaaazz (small blind) folded before Flop
Seat 6: 777Koresh777 (big blind) folded on the Turn


PokerStars Hand #222984066655:  Hold'em No Limit ($2.50/$5.00 USD) - 2021/01/23 22:11:57 ET
Table 'Aaltje II' 6-max Seat #5 is the button
Seat 1: Rabarber77 ($1552.76 in chips)
Seat 2: Nutsfit ($754.99 in chips)
Seat 3: magorko ($548.32 in chips)
Seat 4: supbigdiaper ($500 in chips)
Seat 5: Yaaaazz ($500 in chips)
Seat 6: 777Koresh777 ($500 in chips)
777Koresh777: posts small blind $2.50
Rabarber77: posts big blind $5
*** HOLE CARDS ***
Nutsfit: raises $5.90 to $10.90
magorko: folds
supbigdiaper: folds
Yaaaazz: folds
777Koresh777: calls $8.40
Rabarber77: folds
*** FLOP *** [4d 8h Td]
777Koresh777: checks
Nutsfit: checks
*** TURN *** [4d 8h Td] [9s]
777Koresh777: checks
Nutsfit: checks
*** RIVER *** [4d 8h Td 9s] [2d]
777Koresh777: checks
Nutsfit: checks
*** SHOW DOWN ***
777Koresh777: shows [6s 6d] (a pair of Sixes)
Nutsfit: mucks hand
777Koresh777 collected $25.46 from pot
*** SUMMARY ***
Total pot $26.80 | Rake $1.34
Board [4d 8h Td 9s 2d]
Seat 1: Rabarber77 (big blind) folded before Flop
Seat 2: Nutsfit mucked
Seat 3: magorko folded before Flop (didn't bet)
Seat 4: supbigdiaper folded before Flop (didn't bet)
Seat 5: Yaaaazz (button) folded before Flop (didn't bet)
Seat 6: 777Koresh777 (small blind) showed [6s 6d] and won ($25.46) with a pair of Sixes


PokerStars Hand #222984083324:  Hold'em No Limit ($2.50/$5.00 USD) - 2021/01/23 22:12:43 ET
Table 'Aaltje II' 6-max Seat #6 is the button
Seat 1: Rabarber77 ($1547.76 in chips)
Seat 2: Nutsfit ($744.09 in chips)
Seat 3: magorko ($548.32 in chips)
Seat 4: supbigdiaper ($500 in chips)
Seat 5: Yaaaazz ($500 in chips)
Seat 6: 777Koresh777 ($514.56 in chips)
Rabarber77: posts small blind $2.50
Nutsfit: posts big blind $5
*** HOLE CARDS ***
magorko: folds
supbigdiaper: folds
Yaaaazz: folds
777Koresh777: raises $7.20 to $12.20
Rabarber77: folds
Nutsfit: folds
Uncalled bet ($7.20) returned to 777Koresh777
777Koresh777 collected $12.50 from pot
777Koresh777: doesn't show hand
*** SUMMARY ***
Total pot $12.50 | Rake $0
Seat 1: Rabarber77 (small blind) folded before Flop
Seat 2: Nutsfit (big blind) folded before Flop
Seat 3: magorko folded before Flop (didn't bet)
Seat 4: supbigdiaper folded before Flop (didn't bet)
Seat 5: Yaaaazz folded before Flop (didn't bet)
Seat 6: 777Koresh777 (button) collected ($12.50)


PokerStars Hand #222984092192:  Hold'em No Limit ($2.50/$5.00 USD) - 2021/01/23 22:13:06 ET
Table 'Aaltje II' 6-max Seat #1 is the button
Seat 1: Rabarber77 ($1545.26 in chips)
Seat 2: Nutsfit ($739.09 in chips)
Seat 3: magorko ($548.32 in chips)
Seat 4: supbigdiaper ($500 in chips)
Seat 5: Yaaaazz ($500 in chips)
Seat 6: 777Koresh777 ($522.06 in chips)
Nutsfit: posts small blind $2.50
magorko: posts big blind $5
*** HOLE CARDS ***
supbigdiaper: raises $7.50 to $12.50
Yaaaazz: folds
777Koresh777: folds
Rabarber77: folds
Nutsfit: folds
magorko: folds
Uncalled bet ($7.50) returned to supbigdiaper
supbigdiaper collected $12.50 from pot
supbigdiaper: doesn't show hand
*** SUMMARY ***
Total pot $12.50 | Rake $0
Seat 1: Rabarber77 (button) folded before Flop (didn't bet)
Seat 2: Nutsfit (small blind) folded before Flop
Seat 3: magorko (big blind) folded before Flop
Seat 4: supbigdiaper collected ($12.50)
Seat 5: Yaaaazz folded before Flop (didn't bet)
Seat 6: 777Koresh777 folded before Flop (didn't bet)


PokerStars Hand #222984111885:  Hold'em No Limit ($2.50/$5.00 USD) - 2021/01/23 22:13:36 ET
Table 'Aaltje II' 6-max Seat #2 is the button
Seat 1: Rabarber77 ($1545.26 in chips)
Seat 2: Nutsfit ($736.59 in chips)
Seat 3: magorko ($543.32 in chips)
Seat 4: supbigdiaper ($507.50 in chips)
Seat 5: Yaaaazz ($500 in chips)
Seat 6: 777Koresh777 ($522.06 in chips)
magorko: posts small blind $2.50
supbigdiaper: posts big blind $5
*** HOLE CARDS ***
Yaaaazz: raises $6.25 to $11.25
777Koresh777: folds
Rabarber77: folds
Nutsfit: folds
magorko: folds
supbigdiaper: folds
Uncalled bet ($6.25) returned to Yaaaazz
Yaaaazz collected $12.50 from pot
Yaaaazz: doesn't show hand
*** SUMMARY ***
Total pot $12.50 | Rake $0
Seat 1: Rabarber77 folded before Flop (didn't bet)
Seat 2: Nutsfit (button) folded before Flop (didn't bet)
Seat 3: magorko (small blind) folded before Flop
Seat 4: supbigdiaper (big blind) folded before Flop
Seat 5: Yaaaazz collected ($12.50)
Seat 6: 777Koresh777 folded before Flop (didn't bet)


PokerStars Hand #222984118331:  Hold'em No Limit ($2.50/$5.00 USD) - 2021/01/23 22:13:54 ET
Table 'Aaltje II' 6-max Seat #3 is the button
Seat 1: Rabarber77 ($1545.26 in chips)
Seat 2: Nutsfit ($736.59 in chips)
Seat 3: magorko ($540.82 in chips)
Seat 4: supbigdiaper ($502.50 in chips)
Seat 5: Yaaaazz ($507.50 in chips)
Seat 6: 777Koresh777 ($522.06 in chips)
supbigdiaper: posts small blind $2.50
Yaaaazz: posts big blind $5
*** HOLE CARDS ***
777Koresh777: folds
Rabarber77: folds
Nutsfit: raises $7.50 to $12.50
magorko: raises $25 to $37.50
supbigdiaper: raises $61.05 to $98.55
Yaaaazz: folds
Nutsfit: folds
magorko: folds
Uncalled bet ($61.05) returned to supbigdiaper
supbigdiaper collected $92.50 from pot
supbigdiaper: doesn't show hand
*** SUMMARY ***
Total pot $92.50 | Rake $0
Seat 1: Rabarber77 folded before Flop (didn't bet)
Seat 2: Nutsfit folded before Flop
Seat 3: magorko (button) folded before Flop
Seat 4: supbigdiaper (small blind) collected ($92.50)
Seat 5: Yaaaazz (big blind) folded before Flop
Seat 6: 777Koresh777 folded before Flop (didn't bet)


PokerStars Hand #222984131638:  Hold'em No Limit ($2.50/$5.00 USD) - 2021/01/23 22:14:30 ET
Table 'Aaltje II' 6-max Seat #4 is the button
Seat 1: Rabarber77 ($1545.26 in chips)
Seat 2: Nutsfit ($724.09 in chips)
Seat 3: magorko ($503.32 in chips)
Seat 4: supbigdiaper ($557.50 in chips)
Seat 5: Yaaaazz ($502.50 in chips)
Seat 6: 777Koresh777 ($522.06 in chips)
Yaaaazz: posts small blind $2.50
777Koresh777: posts big blind $5
*** HOLE CARDS ***
Rabarber77: folds
Nutsfit: folds
magorko: raises $7.50 to $12.50
supbigdiaper: folds
Yaaaazz: raises $42.50 to $55
777Koresh777: folds
magorko: folds
Uncalled bet ($42.50) returned to Yaaaazz
Yaaaazz collected $30 from pot
Yaaaazz: doesn't show hand
*** SUMMARY ***
Total pot $30 | Rake $0
Seat 1: Rabarber77 folded before Flop (didn't bet)
Seat 2: Nutsfit folded before Flop (didn't bet)
Seat 3: magorko folded before Flop
Seat 4: supbigdiaper (button) folded before Flop (didn't bet)
Seat 5: Yaaaazz (small blind) collected ($30)
Seat 6: 777Koresh777 (big blind) folded before Flop


PokerStars Hand #222984146814:  Hold'em No Limit ($2.50/$5.00 USD) - 2021/01/23 22:15:11 ET
Table 'Aaltje II' 6-max Seat #5 is the button
Seat 1: Rabarber77 ($1545.26 in chips)
Seat 2: Nutsfit ($724.09 in chips)
Seat 3: magorko ($500 in chips)
Seat 4: supbigdiaper ($557.50 in chips)
Seat 5: Yaaaazz ($520 in chips)
Seat 6: 777Koresh777 ($517.06 in chips)
777Koresh777: posts small blind $2.50
Rabarber77: posts big blind $5
*** HOLE CARDS ***
Nutsfit: raises $5.90 to $10.90
magorko: folds
supbigdiaper: folds
Yaaaazz has timed out
Yaaaazz: folds
777Koresh777: folds
Rabarber77: folds
Uncalled bet ($5.90) returned to Nutsfit
Nutsfit collected $12.50 from pot
Nutsfit: doesn't show hand
*** SUMMARY ***
Total pot $12.50 | Rake $0
Seat 1: Rabarber77 (big blind) folded before Flop
Seat 2: Nutsfit collected ($12.50)
Seat 3: magorko folded before Flop (didn't bet)
Seat 4: supbigdiaper folded before Flop (didn't bet)
Seat 5: Yaaaazz (button) folded before Flop (didn't bet)
Seat 6: 777Koresh777 (small blind) folded before Flop


PokerStars Hand #222984159193:  Hold'em No Limit ($2.50/$5.00 USD) - 2021/01/23 22:15:46 ET
Table 'Aaltje II' 6-max Seat #6 is the button
Seat 1: Rabarber77 ($1540.26 in chips)
Seat 2: Nutsfit ($731.59 in chips)
Seat 3: magorko ($500 in chips)
Seat 4: supbigdiaper ($557.50 in chips)
Seat 5: Yaaaazz ($520 in chips)
Seat 6: 777Koresh777 ($514.56 in chips)
Rabarber77: posts small blind $2.50
Nutsfit: posts big blind $5
*** HOLE CARDS ***
magorko: folds
supbigdiaper: folds
Yaaaazz: folds
777Koresh777: raises $7.20 to $12.20
Rabarber77: calls $9.70
Nutsfit: folds
*** FLOP *** [Kh Jd 9h]
Rabarber77: checks
777Koresh777: checks
*** TURN *** [Kh Jd 9h] [3d]
Rabarber77: bets $13.97
777Koresh777: calls $13.97
*** RIVER *** [Kh Jd 9h 3d] [Jh]
Rabarber77: bets $27.24
777Koresh777: folds
Uncalled bet ($27.24) returned to Rabarber77
Rabarber77 collected $54.47 from pot
Rabarber77: doesn't show hand
*** SUMMARY ***
Total pot $57.34 | Rake $2.87
Board [Kh Jd 9h 3d Jh]
Seat 1: Rabarber77 (small blind) collected ($54.47)
Seat 2: Nutsfit (big blind) folded before Flop
Seat 3: magorko folded before Flop (didn't bet)
Seat 4: supbigdiaper folded before Flop (didn't bet)
Seat 5: Yaaaazz folded before Flop (didn't bet)
Seat 6: 777Koresh777 (button) folded on the River


PokerStars Hand #222984177653:  Hold'em No Limit ($2.50/$5.00 USD) - 2021/01/23 22:16:37 ET
Table 'Aaltje II' 6-max Seat #1 is the button
Seat 1: Rabarber77 ($1568.56 in chips)
Seat 2: Nutsfit ($726.59 in chips)
Seat 3: magorko ($500 in chips)
Seat 4: supbigdiaper ($557.50 in chips)
Seat 5: Yaaaazz ($520 in chips)
Seat 6: 777Koresh777 ($500 in chips)
Nutsfit: posts small blind $2.50
magorko: posts big blind $5
*** HOLE CARDS ***
supbigdiaper: folds
Yaaaazz: folds
777Koresh777: raises $7.20 to $12.20
Rabarber77: folds
Nutsfit: raises $42.80 to $55
magorko: folds
777Koresh777: raises $65 to $120
Nutsfit: calls $65
*** FLOP *** [Jd Qh Ah]
Nutsfit: checks
777Koresh777: bets $79.86
Nutsfit: calls $79.86
*** TURN *** [Jd Qh Ah] [Ts]
Nutsfit: checks
777Koresh777: bets $150
Nutsfit: calls $150
*** RIVER *** [Jd Qh Ah Ts] [Kc]
Nutsfit: checks
777Koresh777: checks
*** SHOW DOWN ***
Nutsfit: shows [Ks As] (a straight, Ten to Ace)
777Koresh777: shows [Ac 5h] (a straight, Ten to Ace)
Nutsfit collected $350.86 from pot
777Koresh777 collected $350.86 from pot
*** SUMMARY ***
Total pot $704.72 | Rake $3
Board [Jd Qh Ah Ts Kc]
Seat 1: Rabarber77 (button) folded before Flop (didn't bet)
Seat 2: Nutsfit (small blind) showed [Ks As] and won ($350.86) with a straight, Ten to Ace
Seat 3: magorko (big blind) folded before Flop
Seat 4: supbigdiaper folded before Flop (didn't bet)
Seat 5: Yaaaazz folded before Flop (didn't bet)
Seat 6: 777Koresh777 showed [Ac 5h] and won ($350.86) with a straight, Ten to Ace


PokerStars Hand #222984219559:  Hold'em No Limit ($2.50/$5.00 USD) - 2021/01/23 22:18:33 ET
Table 'Aaltje II' 6-max Seat #2 is the button
Seat 1: Rabarber77 ($1568.56 in chips)
Seat 2: Nutsfit ($727.59 in chips)
Seat 3: magorko ($500 in chips)
Seat 4: supbigdiaper ($557.50 in chips)
Seat 5: Yaaaazz ($520 in chips)
Seat 6: 777Koresh777 ($501 in chips)
magorko: posts small blind $2.50
supbigdiaper: posts big blind $5
*** HOLE CARDS ***
Yaaaazz: raises $6.25 to $11.25
777Koresh777: folds
Rabarber77: folds
Nutsfit: folds
magorko: folds
supbigdiaper: folds
Uncalled bet ($6.25) returned to Yaaaazz
Yaaaazz collected $12.50 from pot
Yaaaazz: doesn't show hand
*** SUMMARY ***
Total pot $12.50 | Rake $0
Seat 1: Rabarber77 folded before Flop (didn't bet)
Seat 2: Nutsfit (button) folded before Flop (didn't bet)
Seat 3: magorko (small blind) folded before Flop
Seat 4: supbigdiaper (big blind) folded before Flop
Seat 5: Yaaaazz collected ($12.50)
Seat 6: 777Koresh777 folded before Flop (didn't bet)


PokerStars Hand #222984224034:  Hold'em No Limit ($2.50/$5.00 USD) - 2021/01/23 22:18:46 ET
Table 'Aaltje II' 6-max Seat #3 is the button
Seat 1: Rabarber77 ($1568.56 in chips)
Seat 2: Nutsfit ($727.59 in chips)
Seat 3: magorko ($500 in chips)
Seat 4: supbigdiaper ($552.50 in chips)
Seat 5: Yaaaazz ($527.50 in chips)
Seat 6: 777Koresh777 ($501 in chips)
supbigdiaper: posts small blind $2.50
Yaaaazz: posts big blind $5
*** HOLE CARDS ***
777Koresh777: raises $7.20 to $12.20
Rabarber77: calls $12.20
Nutsfit: folds
magorko: folds
supbigdiaper: folds
Yaaaazz: folds
*** FLOP *** [9h 7s 8h]
777Koresh777: checks
Rabarber77: bets $25
777Koresh777: folds
Uncalled bet ($25) returned to Rabarber77
Rabarber77 collected $30.30 from pot
Rabarber77: doesn't show hand
*** SUMMARY ***
Total pot $31.90 | Rake $1.60
Board [9h 7s 8h]
Seat 1: Rabarber77 collected ($30.30)
Seat 2: Nutsfit folded before Flop (didn't bet)
Seat 3: magorko (button) folded before Flop (didn't bet)
Seat 4: supbigdiaper (small blind) folded before Flop
Seat 5: Yaaaazz (big blind) folded before Flop
Seat 6: 777Koresh777 folded on the Flop


PokerStars Hand #222984242874:  Hold'em No Limit ($2.50/$5.00 USD) - 2021/01/23 22:19:38 ET
Table 'Aaltje II' 6-max Seat #4 is the button
Seat 1: Rabarber77 ($1586.66 in chips)
Seat 2: Nutsfit ($727.59 in chips)
Seat 3: magorko ($500 in chips)
Seat 4: supbigdiaper ($550 in chips)
Seat 5: Yaaaazz ($522.50 in chips)
Seat 6: 777Koresh777 ($500 in chips)
Yaaaazz: posts small blind $2.50
777Koresh777: posts big blind $5
*** HOLE CARDS ***
Rabarber77: raises $10 to $15
Nutsfit: folds
magorko: folds
supbigdiaper: raises $37.88 to $52.88
Yaaaazz: folds
777Koresh777: folds
Rabarber77: calls $37.88
*** FLOP *** [Js Kd 4h]
Rabarber77: checks
supbigdiaper: bets $55.13
Rabarber77: calls $55.13
*** TURN *** [Js Kd 4h] [7s]
Rabarber77: checks
supbigdiaper: checks
*** RIVER *** [Js Kd 4h 7s] [7h]
Rabarber77: bets $110.26
supbigdiaper: folds
Uncalled bet ($110.26) returned to Rabarber77
Rabarber77 collected $220.52 from pot
Rabarber77: doesn't show hand
*** SUMMARY ***
Total pot $223.52 | Rake $3
Board [Js Kd 4h 7s 7h]
Seat 1: Rabarber77 collected ($220.52)
Seat 2: Nutsfit folded before Flop (didn't bet)
Seat 3: magorko folded before Flop (didn't bet)
Seat 4: supbigdiaper (button) folded on the River
Seat 5: Yaaaazz (small blind) folded before Flop
Seat 6: 777Koresh777 (big blind) folded before Flop


PokerStars Hand #222984263237:  Hold'em No Limit ($2.50/$5.00 USD) - 2021/01/23 22:20:34 ET
Table 'Aaltje II' 6-max Seat #5 is the button
Seat 1: Rabarber77 ($1699.17 in chips)
Seat 2: Nutsfit ($727.59 in chips)
Seat 3: magorko ($500 in chips)
Seat 4: supbigdiaper ($500 in chips)
Seat 5: Yaaaazz ($520 in chips)
Seat 6: 777Koresh777 ($500 in chips)
777Koresh777: posts small blind $2.50
Rabarber77: posts big blind $5
*** HOLE CARDS ***
Nutsfit: raises $5.90 to $10.90
magorko: folds
supbigdiaper: folds
Yaaaazz: folds
777Koresh777: folds
Rabarber77: calls $5.90
*** FLOP *** [5h 6d 2s]
Rabarber77: checks
Nutsfit: checks
*** TURN *** [5h 6d 2s] [As]
Rabarber77: checks
Nutsfit: bets $18
Rabarber77: raises $42 to $60
Nutsfit: calls $42
*** RIVER *** [5h 6d 2s As] [3h]
Rabarber77: bets $70
Nutsfit has timed out
Nutsfit: folds
Uncalled bet ($70) returned to Rabarber77
Rabarber77 collected $141.30 from pot
Rabarber77: doesn't show hand
*** SUMMARY ***
Total pot $144.30 | Rake $3
Board [5h 6d 2s As 3h]
Seat 1: Rabarber77 (big blind) collected ($141.30)
Seat 2: Nutsfit folded on the River
Seat 3: magorko folded before Flop (didn't bet)
Seat 4: supbigdiaper folded before Flop (didn't bet)
Seat 5: Yaaaazz (button) folded before Flop (didn't bet)
Seat 6: 777Koresh777 (small blind) folded before Flop


PokerStars Hand #222984295891:  Hold'em No Limit ($2.50/$5.00 USD) - 2021/01/23 22:22:05 ET
Table 'Aaltje II' 6-max Seat #6 is the button
Seat 1: Rabarber77 ($1769.57 in chips)
Seat 2: Nutsfit ($656.69 in chips)
Seat 3: magorko ($500 in chips)
Seat 4: supbigdiaper ($500 in chips)
Seat 5: Yaaaazz ($520 in chips)
Seat 6: 777Koresh777 ($500 in chips)
Rabarber77: posts small blind $2.50
Nutsfit: posts big blind $5
*** HOLE CARDS ***
magorko: folds
supbigdiaper: raises $7.50 to $12.50
Yaaaazz: folds
777Koresh777: folds
Rabarber77: calls $10
Nutsfit: folds
*** FLOP *** [Ad Ac 9s]
Rabarber77: checks
supbigdiaper: bets $9.41
Rabarber77: folds
Uncalled bet ($9.41) returned to supbigdiaper
supbigdiaper collected $28.50 from pot
supbigdiaper: doesn't show hand
*** SUMMARY ***
Total pot $30 | Rake $1.50
Board [Ad Ac 9s]
Seat 1: Rabarber77 (small blind) folded on the Flop
Seat 2: Nutsfit (big blind) folded before Flop
Seat 3: magorko folded before Flop (didn't bet)
Seat 4: supbigdiaper collected ($28.50)
Seat 5: Yaaaazz folded before Flop (didn't bet)
Seat 6: 777Koresh777 (button) folded before Flop (didn't bet)


PokerStars Hand #222984305699:  Hold'em No Limit ($2.50/$5.00 USD) - 2021/01/23 22:22:33 ET
Table 'Aaltje II' 6-max Seat #1 is the button
Seat 1: Rabarber77 ($1757.07 in chips)
Seat 2: Nutsfit ($651.69 in chips)
Seat 3: magorko ($500 in chips)
Seat 4: supbigdiaper ($516 in chips)
Seat 5: Yaaaazz ($520 in chips)
Seat 6: 777Koresh777 ($500 in chips)
Nutsfit: posts small blind $2.50
magorko: posts big blind $5
*** HOLE CARDS ***
supbigdiaper: folds
Yaaaazz: folds
777Koresh777: folds
Rabarber77: raises $10 to $15
Nutsfit: folds
magorko: folds
Uncalled bet ($10) returned to Rabarber77
Rabarber77 collected $12.50 from pot
Rabarber77: doesn't show hand
*** SUMMARY ***
Total pot $12.50 | Rake $0
Seat 1: Rabarber77 (button) collected ($12.50)
Seat 2: Nutsfit (small blind) folded before Flop
Seat 3: magorko (big blind) folded before Flop
Seat 4: supbigdiaper folded before Flop (didn't bet)
Seat 5: Yaaaazz folded before Flop (didn't bet)
Seat 6: 777Koresh777 folded before Flop (didn't bet)


PokerStars Hand #222984310932:  Hold'em No Limit ($2.50/$5.00 USD) - 2021/01/23 22:22:47 ET
Table 'Aaltje II' 6-max Seat #2 is the button
Seat 1: Rabarber77 ($1764.57 in chips)
Seat 2: Nutsfit ($649.19 in chips)
Seat 3: magorko ($500 in chips)
Seat 4: supbigdiaper ($516 in chips)
Seat 5: Yaaaazz ($520 in chips)
Seat 6: 777Koresh777 ($500 in chips)
magorko: posts small blind $2.50
supbigdiaper: posts big blind $5
*** HOLE CARDS ***
Yaaaazz: folds
777Koresh777: folds
Rabarber77: folds
Nutsfit: folds
magorko: raises $7.50 to $12.50
supbigdiaper: calls $7.50
*** FLOP *** [6d 3s Js]
magorko: bets $6.30
supbigdiaper: calls $6.30
*** TURN *** [6d 3s Js] [7h]
magorko: bets $11.79
supbigdiaper: raises $59.89 to $71.68
magorko: calls $59.89
*** RIVER *** [6d 3s Js 7h] [Ad]
magorko: checks
supbigdiaper: checks
*** SHOW DOWN ***
magorko: shows [Jh 4h] (a pair of Jacks)
supbigdiaper: shows [Jd Ks] (a pair of Jacks - Ace+King kicker)
supbigdiaper collected $177.96 from pot
*** SUMMARY ***
Total pot $180.96 | Rake $3
Board [6d 3s Js 7h Ad]
Seat 1: Rabarber77 folded before Flop (didn't bet)
Seat 2: Nutsfit (button) folded before Flop (didn't bet)
Seat 3: magorko (small blind) showed [Jh 4h] and lost with a pair of Jacks
Seat 4: supbigdiaper (big blind) showed [Jd Ks] and won ($177.96) with a pair of Jacks
Seat 5: Yaaaazz folded before Flop (didn't bet)
Seat 6: 777Koresh777 folded before Flop (didn't bet)


PokerStars Hand #222984337164:  Hold'em No Limit ($2.50/$5.00 USD) - 2021/01/23 22:24:02 ET
Table 'Aaltje II' 6-max Seat #3 is the button
Seat 1: Rabarber77 ($1764.57 in chips)
Seat 2: Nutsfit ($649.19 in chips)
Seat 3: magorko ($500 in chips)
Seat 4: supbigdiaper ($603.48 in chips)
Seat 5: Yaaaazz ($520 in chips)
Seat 6: 777Koresh777 ($500 in chips)
supbigdiaper: posts small blind $2.50
Yaaaazz: posts big blind $5
*** HOLE CARDS ***
777Koresh777: raises $7.20 to $12.20
Rabarber77: folds
Nutsfit: folds
magorko: folds
supbigdiaper: folds
Yaaaazz: folds
Uncalled bet ($7.20) returned to 777Koresh777
777Koresh777 collected $12.50 from pot
777Koresh777: doesn't show hand
*** SUMMARY ***
Total pot $12.50 | Rake $0
Seat 1: Rabarber77 folded before Flop (didn't bet)
Seat 2: Nutsfit folded before Flop (didn't bet)
Seat 3: magorko (button) folded before Flop (didn't bet)
Seat 4: supbigdiaper (small blind) folded before Flop
Seat 5: Yaaaazz (big blind) folded before Flop
Seat 6: 777Koresh777 collected ($12.50)


PokerStars Hand #222984347269:  Hold'em No Limit ($2.50/$5.00 USD) - 2021/01/23 22:24:30 ET
Table 'Aaltje II' 6-max Seat #4 is the button
Seat 1: Rabarber77 ($1764.57 in chips)
Seat 2: Nutsfit ($649.19 in chips)
Seat 3: magorko ($500 in chips)
Seat 4: supbigdiaper ($600.98 in chips)
Seat 5: Yaaaazz ($515 in chips)
Seat 6: 777Koresh777 ($507.50 in chips)
Yaaaazz: posts small blind $2.50
777Koresh777: posts big blind $5
*** HOLE CARDS ***
Rabarber77: folds
Nutsfit: folds
magorko: folds
supbigdiaper: folds
Yaaaazz: folds
Uncalled bet ($2.50) returned to 777Koresh777
777Koresh777 collected $5 from pot
777Koresh777: doesn't show hand
*** SUMMARY ***
Total pot $5 | Rake $0
Seat 1: Rabarber77 folded before Flop (didn't bet)
Seat 2: Nutsfit folded before Flop (didn't bet)
Seat 3: magorko folded before Flop (didn't bet)
Seat 4: supbigdiaper (button) folded before Flop (didn't bet)
Seat 5: Yaaaazz (small blind) folded before Flop
Seat 6: 777Koresh777 (big blind) collected ($5)


PokerStars Hand #222984354210:  Hold'em No Limit ($2.50/$5.00 USD) - 2021/01/23 22:24:50 ET
Table 'Aaltje II' 6-max Seat #5 is the button
Seat 1: Rabarber77 ($1764.57 in chips)
Seat 2: Nutsfit ($649.19 in chips)
Seat 3: magorko ($500 in chips)
Seat 4: supbigdiaper ($600.98 in chips)
Seat 5: Yaaaazz ($512.50 in chips)
Seat 6: 777Koresh777 ($510 in chips)
777Koresh777: posts small blind $2.50
Rabarber77: posts big blind $5
*** HOLE CARDS ***
Nutsfit: folds
magorko: folds
supbigdiaper: folds
Yaaaazz: folds
777Koresh777: raises $7.20 to $12.20
Rabarber77: raises $17.80 to $30
777Koresh777: folds
Uncalled bet ($17.80) returned to Rabarber77
Rabarber77 collected $24.40 from pot
Rabarber77: doesn't show hand
*** SUMMARY ***
Total pot $24.40 | Rake $0
Seat 1: Rabarber77 (big blind) collected ($24.40)
Seat 2: Nutsfit folded before Flop (didn't bet)
Seat 3: magorko folded before Flop (didn't bet)
Seat 4: supbigdiaper folded before Flop (didn't bet)
Seat 5: Yaaaazz (button) folded before Flop (didn't bet)
Seat 6: 777Koresh777 (small blind) folded before Flop


PokerStars Hand #222984370001:  Hold'em No Limit ($2.50/$5.00 USD) - 2021/01/23 22:25:27 ET
Table 'Aaltje II' 6-max Seat #6 is the button
Seat 1: Rabarber77 ($1776.77 in chips)
Seat 2: Nutsfit ($649.19 in chips)
Seat 3: magorko ($500 in chips)
Seat 4: supbigdiaper ($600.98 in chips)
Seat 5: Yaaaazz ($512.50 in chips)
Seat 6: 777Koresh777 ($500 in chips)
Rabarber77: posts small blind $2.50
Nutsfit: posts big blind $5
*** HOLE CARDS ***
magorko: raises $7.50 to $12.50
supbigdiaper: folds
Yaaaazz: folds
777Koresh777: folds
Rabarber77: calls $10
Nutsfit: folds
*** FLOP *** [9c 7s 9h]
Rabarber77: checks
magorko: checks
*** TURN *** [9c 7s 9h] [Ac]
Rabarber77: checks
magorko: bets $23.05
Rabarber77: calls $23.05
*** RIVER *** [9c 7s 9h Ac] [4s]
Rabarber77: checks
magorko: bets $59.10
Rabarber77: calls $59.10
*** SHOW DOWN ***
magorko: shows [Jh Ad] (two pair, Aces and Nines)
Rabarber77: mucks hand
magorko collected $191.30 from pot
*** SUMMARY ***
Total pot $194.30 | Rake $3
Board [9c 7s 9h Ac 4s]
Seat 1: Rabarber77 (small blind) mucked
Seat 2: Nutsfit (big blind) folded before Flop
Seat 3: magorko showed [Jh Ad] and won ($191.30) with two pair, Aces and Nines
Seat 4: supbigdiaper folded before Flop (didn't bet)
Seat 5: Yaaaazz folded before Flop (didn't bet)
Seat 6: 777Koresh777 (button) folded before Flop (didn't bet)


PokerStars Hand #222984392771:  Hold'em No Limit ($2.50/$5.00 USD) - 2021/01/23 22:26:31 ET
Table 'Aaltje II' 6-max Seat #1 is the button
Seat 1: Rabarber77 ($1682.12 in chips)
Seat 2: Nutsfit ($644.19 in chips)
Seat 3: magorko ($596.65 in chips)
Seat 4: supbigdiaper ($600.98 in chips)
Seat 5: Yaaaazz ($512.50 in chips)
Seat 6: 777Koresh777 ($500 in chips)
Nutsfit: posts small blind $2.50
magorko: posts big blind $5
*** HOLE CARDS ***
supbigdiaper: folds
Yaaaazz: folds
777Koresh777: folds
Rabarber77: raises $10 to $15
Nutsfit: raises $47.50 to $62.50
magorko: folds
Rabarber77: folds
Uncalled bet ($47.50) returned to Nutsfit
Nutsfit collected $35 from pot
Nutsfit: doesn't show hand
*** SUMMARY ***
Total pot $35 | Rake $0
Seat 1: Rabarber77 (button) folded before Flop
Seat 2: Nutsfit (small blind) collected ($35)
Seat 3: magorko (big blind) folded before Flop
Seat 4: supbigdiaper folded before Flop (didn't bet)
Seat 5: Yaaaazz folded before Flop (didn't bet)
Seat 6: 777Koresh777 folded before Flop (didn't bet)


PokerStars Hand #222984426961:  Hold'em No Limit ($2.50/$5.00 USD) - 2021/01/23 22:27:55 ET
Table 'Aaltje II' 6-max Seat #3 is the button
Seat 1: Rabarber77 ($1667.12 in chips)
Seat 2: Nutsfit ($664.19 in chips)
Seat 3: magorko ($589.15 in chips)
Seat 4: supbigdiaper ($552.23 in chips)
Seat 5: Yaaaazz ($563.75 in chips)
Seat 6: 777Koresh777 ($500 in chips)
supbigdiaper: posts small blind $2.50
Yaaaazz: posts big blind $5
*** HOLE CARDS ***
777Koresh777: folds
Rabarber77: folds
Nutsfit: folds
magorko: folds
supbigdiaper: folds
Uncalled bet ($2.50) returned to Yaaaazz
Yaaaazz collected $5 from pot
Yaaaazz: doesn't show hand
*** SUMMARY ***
Total pot $5 | Rake $0
Seat 1: Rabarber77 folded before Flop (didn't bet)
Seat 2: Nutsfit folded before Flop (didn't bet)
Seat 3: magorko (button) folded before Flop (didn't bet)
Seat 4: supbigdiaper (small blind) folded before Flop
Seat 5: Yaaaazz (big blind) collected ($5)
Seat 6: 777Koresh777 folded before Flop (didn't bet)


PokerStars Hand #222984405350:  Hold'em No Limit ($2.50/$5.00 USD) - 2021/01/23 22:27:07 ET
Table 'Aaltje II' 6-max Seat #2 is the button
Seat 1: Rabarber77 ($1667.12 in chips)
Seat 2: Nutsfit ($664.19 in chips)
Seat 3: magorko ($591.65 in chips)
Seat 4: supbigdiaper ($600.98 in chips)
Seat 5: Yaaaazz ($512.50 in chips)
Seat 6: 777Koresh777 ($500 in chips)
magorko: posts small blind $2.50
supbigdiaper: posts big blind $5
*** HOLE CARDS ***
Yaaaazz: raises $6.25 to $11.25
777Koresh777: folds
Rabarber77: folds
Nutsfit: folds
magorko: folds
supbigdiaper: raises $37.50 to $48.75
Yaaaazz: raises $71.25 to $120
supbigdiaper: folds
Uncalled bet ($71.25) returned to Yaaaazz
Yaaaazz collected $100 from pot
Yaaaazz: doesn't show hand
*** SUMMARY ***
Total pot $100 | Rake $0
Seat 1: Rabarber77 folded before Flop (didn't bet)
Seat 2: Nutsfit (button) folded before Flop (didn't bet)
Seat 3: magorko (small blind) folded before Flop
Seat 4: supbigdiaper (big blind) folded before Flop
Seat 5: Yaaaazz collected ($100)
Seat 6: 777Koresh777 folded before Flop (didn't bet)


PokerStars Hand #222984429874:  Hold'em No Limit ($2.50/$5.00 USD) - 2021/01/23 22:28:03 ET
Table 'Aaltje II' 6-max Seat #4 is the button
Seat 1: Rabarber77 ($1667.12 in chips)
Seat 2: Nutsfit ($664.19 in chips)
Seat 3: magorko ($589.15 in chips)
Seat 4: supbigdiaper ($549.73 in chips)
Seat 5: Yaaaazz ($566.25 in chips)
Seat 6: 777Koresh777 ($500 in chips)
Yaaaazz: posts small blind $2.50
777Koresh777: posts big blind $5
*** HOLE CARDS ***
Rabarber77: folds
Nutsfit: folds
magorko: raises $7.50 to $12.50
supbigdiaper: folds
Yaaaazz: folds
777Koresh777: folds
Uncalled bet ($7.50) returned to magorko
magorko collected $12.50 from pot
magorko: doesn't show hand
*** SUMMARY ***
Total pot $12.50 | Rake $0
Seat 1: Rabarber77 folded before Flop (didn't bet)
Seat 2: Nutsfit folded before Flop (didn't bet)
Seat 3: magorko collected ($12.50)
Seat 4: supbigdiaper (button) folded before Flop (didn't bet)
Seat 5: Yaaaazz (small blind) folded before Flop
Seat 6: 777Koresh777 (big blind) folded before Flop


PokerStars Hand #222984438079:  Hold'em No Limit ($2.50/$5.00 USD) - 2021/01/23 22:28:27 ET
Table 'Aaltje II' 6-max Seat #5 is the button
Seat 1: Rabarber77 ($1667.12 in chips)
Seat 2: Nutsfit ($664.19 in chips)
Seat 3: magorko ($596.65 in chips)
Seat 4: supbigdiaper ($549.73 in chips)
Seat 5: Yaaaazz ($563.75 in chips)
Seat 6: 777Koresh777 ($500 in chips)
777Koresh777: posts small blind $2.50
Rabarber77: posts big blind $5
*** HOLE CARDS ***
Nutsfit: folds
magorko: folds
supbigdiaper: raises $7.50 to $12.50
Yaaaazz: folds
777Koresh777: calls $10
Rabarber77: raises $32.50 to $45
supbigdiaper: calls $32.50
777Koresh777: folds
*** FLOP *** [Qc 9h 2s]
Rabarber77: bets $60
supbigdiaper: calls $60
*** TURN *** [Qc 9h 2s] [Ad]
Rabarber77: bets $120
supbigdiaper: folds
Uncalled bet ($120) returned to Rabarber77
Rabarber77 collected $219.50 from pot
Rabarber77: doesn't show hand
*** SUMMARY ***
Total pot $222.50 | Rake $3
Board [Qc 9h 2s Ad]
Seat 1: Rabarber77 (big blind) collected ($219.50)
Seat 2: Nutsfit folded before Flop (didn't bet)
Seat 3: magorko folded before Flop (didn't bet)
Seat 4: supbigdiaper folded on the Turn
Seat 5: Yaaaazz (button) folded before Flop (didn't bet)
Seat 6: 777Koresh777 (small blind) folded before Flop


PokerStars Hand #222984463003:  Hold'em No Limit ($2.50/$5.00 USD) - 2021/01/23 22:29:38 ET
Table 'Aaltje II' 6-max Seat #6 is the button
Seat 1: Rabarber77 ($1781.62 in chips)
Seat 2: Nutsfit ($664.19 in chips)
Seat 3: magorko ($596.65 in chips)
Seat 4: supbigdiaper ($500 in chips)
Seat 5: Yaaaazz ($563.75 in chips)
Seat 6: 777Koresh777 ($500 in chips)
Rabarber77: posts small blind $2.50
Nutsfit: posts big blind $5
*** HOLE CARDS ***
magorko: folds
supbigdiaper: raises $7.50 to $12.50
Yaaaazz: folds
777Koresh777: folds
Rabarber77: folds
Nutsfit: folds
Uncalled bet ($7.50) returned to supbigdiaper
supbigdiaper collected $12.50 from pot
supbigdiaper: doesn't show hand
*** SUMMARY ***
Total pot $12.50 | Rake $0
Seat 1: Rabarber77 (small blind) folded before Flop
Seat 2: Nutsfit (big blind) folded before Flop
Seat 3: magorko folded before Flop (didn't bet)
Seat 4: supbigdiaper collected ($12.50)
Seat 5: Yaaaazz folded before Flop (didn't bet)
Seat 6: 777Koresh777 (button) folded before Flop (didn't bet)


PokerStars Hand #222984468563:  Hold'em No Limit ($2.50/$5.00 USD) - 2021/01/23 22:29:54 ET
Table 'Aaltje II' 6-max Seat #1 is the button
Seat 1: Rabarber77 ($1779.12 in chips)
Seat 2: Nutsfit ($659.19 in chips)
Seat 3: magorko ($596.65 in chips)
Seat 4: supbigdiaper ($507.50 in chips)
Seat 5: Yaaaazz ($563.75 in chips)
Seat 6: 777Koresh777 ($500 in chips)
Nutsfit: posts small blind $2.50
magorko: posts big blind $5
*** HOLE CARDS ***
supbigdiaper: folds
Yaaaazz has timed out
Yaaaazz: folds
777Koresh777: folds
Rabarber77: folds
Nutsfit: folds
Uncalled bet ($2.50) returned to magorko
magorko collected $5 from pot
magorko: doesn't show hand
*** SUMMARY ***
Total pot $5 | Rake $0
Seat 1: Rabarber77 (button) folded before Flop (didn't bet)
Seat 2: Nutsfit (small blind) folded before Flop
Seat 3: magorko (big blind) collected ($5)
Seat 4: supbigdiaper folded before Flop (didn't bet)
Seat 5: Yaaaazz folded before Flop (didn't bet)
Seat 6: 777Koresh777 folded before Flop (didn't bet)


PokerStars Hand #222984476066:  Hold'em No Limit ($2.50/$5.00 USD) - 2021/01/23 22:30:15 ET
Table 'Aaltje II' 6-max Seat #2 is the button
Seat 1: Rabarber77 ($1779.12 in chips)
Seat 2: Nutsfit ($656.69 in chips)
Seat 3: magorko ($599.15 in chips)
Seat 4: supbigdiaper ($507.50 in chips)
Seat 5: Yaaaazz ($563.75 in chips)
Seat 6: 777Koresh777 ($500 in chips)
magorko: posts small blind $2.50
supbigdiaper: posts big blind $5
*** HOLE CARDS ***
Yaaaazz: folds
777Koresh777: folds
Rabarber77: folds
Nutsfit: folds
magorko: raises $7.50 to $12.50
supbigdiaper: calls $7.50
*** FLOP *** [5s 7h Td]
magorko: checks
supbigdiaper: checks
*** TURN *** [5s 7h Td] [9c]
magorko: bets $17.81
supbigdiaper: calls $17.81
*** RIVER *** [5s 7h Td 9c] [6h]
magorko: checks
supbigdiaper: bets $43.22
magorko: calls $43.22
*** SHOW DOWN ***
supbigdiaper: shows [8s Kh] (a straight, Six to Ten)
magorko: mucks hand
supbigdiaper collected $144.06 from pot
*** SUMMARY ***
Total pot $147.06 | Rake $3
Board [5s 7h Td 9c 6h]
Seat 1: Rabarber77 folded before Flop (didn't bet)
Seat 2: Nutsfit (button) folded before Flop (didn't bet)
Seat 3: magorko (small blind) mucked
Seat 4: supbigdiaper (big blind) showed [8s Kh] and won ($144.06) with a straight, Six to Ten
Seat 5: Yaaaazz folded before Flop (didn't bet)
Seat 6: 777Koresh777 folded before Flop (didn't bet)


PokerStars Hand #222984509978:  Hold'em No Limit ($2.50/$5.00 USD) - 2021/01/23 22:31:54 ET
Table 'Aaltje II' 6-max Seat #3 is the button
Seat 1: Rabarber77 ($1779.12 in chips)
Seat 2: Nutsfit ($656.69 in chips)
Seat 3: magorko ($525.62 in chips)
Seat 4: supbigdiaper ($578.03 in chips)
Seat 5: Yaaaazz ($563.75 in chips)
Seat 6: 777Koresh777 ($500 in chips)
supbigdiaper: posts small blind $2.50
Yaaaazz: posts big blind $5
*** HOLE CARDS ***
777Koresh777: folds
Rabarber77: folds
Nutsfit: folds
magorko: folds
supbigdiaper: folds
Uncalled bet ($2.50) returned to Yaaaazz
Yaaaazz collected $5 from pot
Yaaaazz: doesn't show hand
*** SUMMARY ***
Total pot $5 | Rake $0
Seat 1: Rabarber77 folded before Flop (didn't bet)
Seat 2: Nutsfit folded before Flop (didn't bet)
Seat 3: magorko (button) folded before Flop (didn't bet)
Seat 4: supbigdiaper (small blind) folded before Flop
Seat 5: Yaaaazz (big blind) collected ($5)
Seat 6: 777Koresh777 folded before Flop (didn't bet)


PokerStars Hand #222984516448:  Hold'em No Limit ($2.50/$5.00 USD) - 2021/01/23 22:32:13 ET
Table 'Aaltje II' 6-max Seat #4 is the button
Seat 1: Rabarber77 ($1779.12 in chips)
Seat 2: Nutsfit ($656.69 in chips)
Seat 3: magorko ($525.62 in chips)
Seat 4: supbigdiaper ($575.53 in chips)
Seat 5: Yaaaazz ($566.25 in chips)
Seat 6: 777Koresh777 ($500 in chips)
Yaaaazz: posts small blind $2.50
777Koresh777: posts big blind $5
*** HOLE CARDS ***
Rabarber77: raises $10 to $15
Nutsfit: folds
magorko: folds
supbigdiaper: folds
Yaaaazz: folds
777Koresh777: calls $10
*** FLOP *** [6c 7c 4c]
777Koresh777: bets $10.19
Rabarber77: calls $10.19
*** TURN *** [6c 7c 4c] [6d]
777Koresh777: checks
Rabarber77: bets $25.12
777Koresh777: folds
Uncalled bet ($25.12) returned to Rabarber77
Rabarber77 collected $50.24 from pot
Rabarber77: doesn't show hand
*** SUMMARY ***
Total pot $52.88 | Rake $2.64
Board [6c 7c 4c 6d]
Seat 1: Rabarber77 collected ($50.24)
Seat 2: Nutsfit folded before Flop (didn't bet)
Seat 3: magorko folded before Flop (didn't bet)
Seat 4: supbigdiaper (button) folded before Flop (didn't bet)
Seat 5: Yaaaazz (small blind) folded before Flop
Seat 6: 777Koresh777 (big blind) folded on the Turn


PokerStars Hand #222984551152:  Hold'em No Limit ($2.50/$5.00 USD) - 2021/01/23 22:33:54 ET
Table 'Aaltje II' 6-max Seat #5 is the button
Seat 1: Rabarber77 ($1804.17 in chips)
Seat 2: Nutsfit ($656.69 in chips)
Seat 3: magorko ($525.62 in chips)
Seat 4: supbigdiaper ($575.53 in chips)
Seat 5: Yaaaazz ($563.75 in chips)
Seat 6: 777Koresh777 ($500 in chips)
777Koresh777: posts small blind $2.50
Rabarber77: posts big blind $5
*** HOLE CARDS ***
Nutsfit: folds
magorko: folds
supbigdiaper: folds
Yaaaazz: folds
777Koresh777: raises $7.20 to $12.20
Rabarber77: calls $7.20
*** FLOP *** [Ks 8d Td]
777Koresh777: checks
Rabarber77: checks
*** TURN *** [Ks 8d Td] [6d]
777Koresh777: bets $12.29
Rabarber77: raises $37.29 to $49.58
777Koresh777: calls $37.29
*** RIVER *** [Ks 8d Td 6d] [4h]
777Koresh777: checks
Rabarber77: bets $80
777Koresh777: folds
Uncalled bet ($80) returned to Rabarber77
Rabarber77 collected $120.56 from pot
Rabarber77: doesn't show hand
*** SUMMARY ***
Total pot $123.56 | Rake $3
Board [Ks 8d Td 6d 4h]
Seat 1: Rabarber77 (big blind) collected ($120.56)
Seat 2: Nutsfit folded before Flop (didn't bet)
Seat 3: magorko folded before Flop (didn't bet)
Seat 4: supbigdiaper folded before Flop (didn't bet)
Seat 5: Yaaaazz (button) folded before Flop (didn't bet)
Seat 6: 777Koresh777 (small blind) folded on the River


PokerStars Hand #222984590108:  Hold'em No Limit ($2.50/$5.00 USD) - 2021/01/23 22:35:30 ET
Table 'Aaltje II' 6-max Seat #6 is the button
Seat 1: Rabarber77 ($1862.95 in chips)
Seat 2: Nutsfit ($656.69 in chips)
Seat 3: magorko ($525.62 in chips)
Seat 4: supbigdiaper ($575.53 in chips)
Seat 5: Yaaaazz ($563.75 in chips)
Seat 6: 777Koresh777 ($500 in chips)
Rabarber77: posts small blind $2.50
Nutsfit: posts big blind $5
*** HOLE CARDS ***
magorko: folds
supbigdiaper: folds
Yaaaazz: folds
777Koresh777: raises $7.20 to $12.20
Rabarber77: folds
Nutsfit: calls $7.20
*** FLOP *** [Jh 3c Qd]
Nutsfit: checks
777Koresh777: bets $19.68
Nutsfit: folds
Uncalled bet ($19.68) returned to 777Koresh777
777Koresh777 collected $25.56 from pot
777Koresh777: doesn't show hand
*** SUMMARY ***
Total pot $26.90 | Rake $1.34
Board [Jh 3c Qd]
Seat 1: Rabarber77 (small blind) folded before Flop
Seat 2: Nutsfit (big blind) folded on the Flop
Seat 3: magorko folded before Flop (didn't bet)
Seat 4: supbigdiaper folded before Flop (didn't bet)
Seat 5: Yaaaazz folded before Flop (didn't bet)
Seat 6: 777Koresh777 (button) collected ($25.56)


PokerStars Hand #222984602726:  Hold'em No Limit ($2.50/$5.00 USD) - 2021/01/23 22:36:08 ET
Table 'Aaltje II' 6-max Seat #1 is the button
Seat 1: Rabarber77 ($1860.45 in chips)
Seat 2: Nutsfit ($644.49 in chips)
Seat 3: magorko ($525.62 in chips)
Seat 4: supbigdiaper ($575.53 in chips)
Seat 5: Yaaaazz ($563.75 in chips)
Seat 6: 777Koresh777 ($513.36 in chips)
Nutsfit: posts small blind $2.50
magorko: posts big blind $5
*** HOLE CARDS ***
supbigdiaper: raises $7.50 to $12.50
Yaaaazz: folds
777Koresh777: folds
Rabarber77: folds
Nutsfit: folds
magorko: folds
Uncalled bet ($7.50) returned to supbigdiaper
supbigdiaper collected $12.50 from pot
supbigdiaper: doesn't show hand
*** SUMMARY ***
Total pot $12.50 | Rake $0
Seat 1: Rabarber77 (button) folded before Flop (didn't bet)
Seat 2: Nutsfit (small blind) folded before Flop
Seat 3: magorko (big blind) folded before Flop
Seat 4: supbigdiaper collected ($12.50)
Seat 5: Yaaaazz folded before Flop (didn't bet)
Seat 6: 777Koresh777 folded before Flop (didn't bet)


PokerStars Hand #222984612358:  Hold'em No Limit ($2.50/$5.00 USD) - 2021/01/23 22:36:36 ET
Table 'Aaltje II' 6-max Seat #2 is the button
Seat 1: Rabarber77 ($1860.45 in chips)
Seat 2: Nutsfit ($641.99 in chips)
Seat 3: magorko ($520.62 in chips)
Seat 4: supbigdiaper ($583.03 in chips)
Seat 5: Yaaaazz ($563.75 in chips)
Seat 6: 777Koresh777 ($513.36 in chips)
magorko: posts small blind $2.50
supbigdiaper: posts big blind $5
*** HOLE CARDS ***
Yaaaazz: folds
777Koresh777: folds
Rabarber77: folds
Nutsfit: folds
magorko: raises $7.50 to $12.50
supbigdiaper: folds
Uncalled bet ($7.50) returned to magorko
magorko collected $10 from pot
magorko: doesn't show hand
*** SUMMARY ***
Total pot $10 | Rake $0
Seat 1: Rabarber77 folded before Flop (didn't bet)
Seat 2: Nutsfit (button) folded before Flop (didn't bet)
Seat 3: magorko (small blind) collected ($10)
Seat 4: supbigdiaper (big blind) folded before Flop
Seat 5: Yaaaazz folded before Flop (didn't bet)
Seat 6: 777Koresh777 folded before Flop (didn't bet)


PokerStars Hand #222984620633:  Hold'em No Limit ($2.50/$5.00 USD) - 2021/01/23 22:37:01 ET
Table 'Aaltje II' 6-max Seat #3 is the button
Seat 1: Rabarber77 ($1860.45 in chips)
Seat 2: Nutsfit ($641.99 in chips)
Seat 3: magorko ($525.62 in chips)
Seat 4: supbigdiaper ($578.03 in chips)
Seat 5: Yaaaazz ($563.75 in chips)
Seat 6: 777Koresh777 ($513.36 in chips)
supbigdiaper: posts small blind $2.50
Yaaaazz: posts big blind $5
*** HOLE CARDS ***
777Koresh777: folds
Rabarber77: folds
Nutsfit: folds
magorko: raises $7.50 to $12.50
supbigdiaper: folds
Yaaaazz: folds
Uncalled bet ($7.50) returned to magorko
magorko collected $12.50 from pot
magorko: doesn't show hand
*** SUMMARY ***
Total pot $12.50 | Rake $0
Seat 1: Rabarber77 folded before Flop (didn't bet)
Seat 2: Nutsfit folded before Flop (didn't bet)
Seat 3: magorko (button) collected ($12.50)
Seat 4: supbigdiaper (small blind) folded before Flop
Seat 5: Yaaaazz (big blind) folded before Flop
Seat 6: 777Koresh777 folded before Flop (didn't bet)


PokerStars Hand #222984631049:  Hold'em No Limit ($2.50/$5.00 USD) - 2021/01/23 22:37:23 ET
Table 'Aaltje II' 6-max Seat #4 is the button
Seat 1: Rabarber77 ($1860.45 in chips)
Seat 2: Nutsfit ($641.99 in chips)
Seat 3: magorko ($533.12 in chips)
Seat 4: supbigdiaper ($575.53 in chips)
Seat 5: Yaaaazz ($558.75 in chips)
Yaaaazz: posts small blind $2.50
777Koresh777: is sitting out
Rabarber77: posts big blind $5
*** HOLE CARDS ***
777Koresh777 leaves the table
Nutsfit has timed out
Nutsfit: folds
magorko: folds
supbigdiaper: folds
Yaaaazz: folds
Uncalled bet ($2.50) returned to Rabarber77
sacachispa19 joins the table at seat #6
Rabarber77 collected $5 from pot
Rabarber77: doesn't show hand
*** SUMMARY ***
Total pot $5 | Rake $0
Seat 1: Rabarber77 (big blind) collected ($5)
Seat 2: Nutsfit folded before Flop (didn't bet)
Seat 3: magorko folded before Flop (didn't bet)
Seat 4: supbigdiaper (button) folded before Flop (didn't bet)
Seat 5: Yaaaazz (small blind) folded before Flop


PokerStars Hand #222984637671:  Hold'em No Limit ($2.50/$5.00 USD) - 2021/01/23 22:37:43 ET
Table 'Aaltje II' 6-max Seat #5 is the button
Seat 1: Rabarber77 ($1862.95 in chips)
Seat 2: Nutsfit ($641.99 in chips)
Seat 3: magorko ($533.12 in chips)
Seat 4: supbigdiaper ($575.53 in chips)
Seat 5: Yaaaazz ($556.25 in chips)
Rabarber77: posts small blind $2.50
Nutsfit: posts big blind $5
*** HOLE CARDS ***
magorko: folds
supbigdiaper: raises $7.50 to $12.50
Yaaaazz: raises $25 to $37.50
Rabarber77: folds
Nutsfit: folds
supbigdiaper: raises $61.88 to $99.38
Yaaaazz: calls $61.88
*** FLOP *** [Qd 9h Ks]
supbigdiaper: bets $67.08
Yaaaazz: calls $67.08
*** TURN *** [Qd 9h Ks] [8s]
supbigdiaper: bets $409.07 and is all-in
Yaaaazz: calls $389.79 and is all-in
Uncalled bet ($19.28) returned to supbigdiaper
*** FIRST RIVER *** [Qd 9h Ks 8s] [Kh]
*** SECOND RIVER *** [Qd 9h Ks 8s] [2d]
*** FIRST SHOW DOWN ***
supbigdiaper: shows [Ad Ac] (two pair, Aces and Kings)
Yaaaazz: shows [As Qs] (two pair, Kings and Queens)
supbigdiaper collected $558.50 from pot
*** SECOND SHOW DOWN ***
supbigdiaper: shows [Ad Ac] (a pair of Aces)
Yaaaazz: shows [As Qs] (a pair of Queens)
supbigdiaper collected $558.50 from pot
*** SUMMARY ***
Total pot $1120 | Rake $3
Hand was run twice
FIRST Board [Qd 9h Ks 8s Kh]
SECOND Board [Qd 9h Ks 8s 2d]
Seat 1: Rabarber77 (small blind) folded before Flop
Seat 2: Nutsfit (big blind) folded before Flop
Seat 3: magorko folded before Flop (didn't bet)
Seat 4: supbigdiaper showed [Ad Ac] and won ($558.50) with two pair, Aces and Kings, and won ($558.50) with a pair of Aces
Seat 5: Yaaaazz (button) showed [As Qs] and lost with two pair, Kings and Queens, and lost with a pair of Queens


PokerStars Hand #222984673421:  Hold'em No Limit ($2.50/$5.00 USD) - 2021/01/23 22:39:29 ET
Table 'Aaltje II' 6-max Seat #1 is the button
Seat 1: Rabarber77 ($1860.45 in chips)
Seat 2: Nutsfit ($636.99 in chips)
Seat 3: magorko ($533.12 in chips)
Seat 4: supbigdiaper ($1136.28 in chips)
Seat 5: Yaaaazz ($500 in chips)
Nutsfit: posts small blind $2.50
magorko: posts big blind $5
sacachispa19: sits out
*** HOLE CARDS ***
supbigdiaper: folds
Yaaaazz: raises $6.25 to $11.25
Rabarber77: calls $11.25
Nutsfit: folds
magorko: folds
*** FLOP *** [4c 6s 6d]
Yaaaazz: bets $9.41
Rabarber77: calls $9.41
*** TURN *** [4c 6s 6d] [2d]
Yaaaazz: bets $69.57
Rabarber77: folds
Uncalled bet ($69.57) returned to Yaaaazz
Yaaaazz collected $46.38 from pot
Yaaaazz: doesn't show hand
*** SUMMARY ***
Total pot $48.82 | Rake $2.44
Board [4c 6s 6d 2d]
Seat 1: Rabarber77 (button) folded on the Turn
Seat 2: Nutsfit (small blind) folded before Flop
Seat 3: magorko (big blind) folded before Flop
Seat 4: supbigdiaper folded before Flop (didn't bet)
Seat 5: Yaaaazz collected ($46.38)


PokerStars Hand #222984688726:  Hold'em No Limit ($2.50/$5.00 USD) - 2021/01/23 22:40:15 ET
Table 'Aaltje II' 6-max Seat #2 is the button
Seat 1: Rabarber77 ($1839.79 in chips)
Seat 2: Nutsfit ($634.49 in chips)
Seat 3: magorko ($528.12 in chips)
Seat 4: supbigdiaper ($1136.28 in chips)
Seat 5: Yaaaazz ($525.72 in chips)
magorko: posts small blind $2.50
supbigdiaper: posts big blind $5
sacachispa19: sits out
*** HOLE CARDS ***
Yaaaazz: folds
Rabarber77: raises $10 to $15
Nutsfit: folds
magorko: folds
supbigdiaper: folds
Uncalled bet ($10) returned to Rabarber77
Rabarber77 collected $12.50 from pot
Rabarber77: doesn't show hand
*** SUMMARY ***
Total pot $12.50 | Rake $0
Seat 1: Rabarber77 collected ($12.50)
Seat 2: Nutsfit (button) folded before Flop (didn't bet)
Seat 3: magorko (small blind) folded before Flop
Seat 4: supbigdiaper (big blind) folded before Flop
Seat 5: Yaaaazz folded before Flop (didn't bet)


PokerStars Hand #222984695514:  Hold'em No Limit ($2.50/$5.00 USD) - 2021/01/23 22:40:35 ET
Table 'Aaltje II' 6-max Seat #3 is the button
Seat 1: Rabarber77 ($1847.29 in chips)
Seat 2: Nutsfit ($634.49 in chips)
Seat 3: magorko ($525.62 in chips)
Seat 4: supbigdiaper ($1131.28 in chips)
Seat 5: Yaaaazz ($525.72 in chips)
supbigdiaper: posts small blind $2.50
Yaaaazz: posts big blind $5
sacachispa19: sits out
*** HOLE CARDS ***
Rabarber77: folds
Nutsfit: folds
magorko: folds
supbigdiaper: folds
Uncalled bet ($2.50) returned to Yaaaazz
Yaaaazz collected $5 from pot
Yaaaazz: doesn't show hand
*** SUMMARY ***
Total pot $5 | Rake $0
Seat 1: Rabarber77 folded before Flop (didn't bet)
Seat 2: Nutsfit folded before Flop (didn't bet)
Seat 3: magorko (button) folded before Flop (didn't bet)
Seat 4: supbigdiaper (small blind) folded before Flop
Seat 5: Yaaaazz (big blind) collected ($5)


PokerStars Hand #222984699046:  Hold'em No Limit ($2.50/$5.00 USD) - 2021/01/23 22:40:46 ET
Table 'Aaltje II' 6-max Seat #4 is the button
Seat 1: Rabarber77 ($1847.29 in chips)
Seat 2: Nutsfit ($634.49 in chips)
Seat 3: magorko ($525.62 in chips)
Seat 4: supbigdiaper ($1128.78 in chips)
Seat 5: Yaaaazz ($528.22 in chips)
Seat 6: sacachispa19 ($500 in chips)
Yaaaazz: posts small blind $2.50
sacachispa19: posts big blind $5
*** HOLE CARDS ***
Rabarber77: folds
Nutsfit: folds
magorko: raises $7.50 to $12.50
supbigdiaper: raises $32.83 to $45.33
Yaaaazz: folds
sacachispa19: folds
magorko: folds
Uncalled bet ($32.83) returned to supbigdiaper
supbigdiaper collected $32.50 from pot
supbigdiaper: doesn't show hand
*** SUMMARY ***
Total pot $32.50 | Rake $0
Seat 1: Rabarber77 folded before Flop (didn't bet)
Seat 2: Nutsfit folded before Flop (didn't bet)
Seat 3: magorko folded before Flop
Seat 4: supbigdiaper (button) collected ($32.50)
Seat 5: Yaaaazz (small blind) folded before Flop
Seat 6: sacachispa19 (big blind) folded before Flop


PokerStars Hand #222984710098:  Hold'em No Limit ($2.50/$5.00 USD) - 2021/01/23 22:41:19 ET
Table 'Aaltje II' 6-max Seat #5 is the button
Seat 1: Rabarber77 ($1847.29 in chips)
Seat 2: Nutsfit ($634.49 in chips)
Seat 3: magorko ($513.12 in chips)
Seat 4: supbigdiaper ($1148.78 in chips)
Seat 5: Yaaaazz ($525.72 in chips)
Seat 6: sacachispa19 ($500 in chips)
sacachispa19: posts small blind $2.50
Rabarber77: posts big blind $5
*** HOLE CARDS ***
Nutsfit: folds
magorko: raises $7.50 to $12.50
supbigdiaper: folds
Yaaaazz: folds
sacachispa19: folds
Rabarber77: folds
Uncalled bet ($7.50) returned to magorko
magorko collected $12.50 from pot
magorko: doesn't show hand
*** SUMMARY ***
Total pot $12.50 | Rake $0
Seat 1: Rabarber77 (big blind) folded before Flop
Seat 2: Nutsfit folded before Flop (didn't bet)
Seat 3: magorko collected ($12.50)
Seat 4: supbigdiaper folded before Flop (didn't bet)
Seat 5: Yaaaazz (button) folded before Flop (didn't bet)
Seat 6: sacachispa19 (small blind) folded before Flop


PokerStars Hand #222984717823:  Hold'em No Limit ($2.50/$5.00 USD) - 2021/01/23 22:41:42 ET
Table 'Aaltje II' 6-max Seat #6 is the button
Seat 1: Rabarber77 ($1842.29 in chips)
Seat 2: Nutsfit ($634.49 in chips)
Seat 3: magorko ($520.62 in chips)
Seat 4: supbigdiaper ($1148.78 in chips)
Seat 5: Yaaaazz ($525.72 in chips)
Seat 6: sacachispa19 ($500 in chips)
Rabarber77: posts small blind $2.50
Nutsfit: posts big blind $5
*** HOLE CARDS ***
magorko: folds
supbigdiaper: folds
Yaaaazz: folds
sacachispa19: folds
Rabarber77: raises $10 to $15
Nutsfit: calls $10
*** FLOP *** [Td 8h 2s]
Rabarber77: bets $20
Nutsfit: folds
Uncalled bet ($20) returned to Rabarber77
Rabarber77 collected $28.50 from pot
Rabarber77: doesn't show hand
*** SUMMARY ***
Total pot $30 | Rake $1.50
Board [Td 8h 2s]
Seat 1: Rabarber77 (small blind) collected ($28.50)
Seat 2: Nutsfit (big blind) folded on the Flop
Seat 3: magorko folded before Flop (didn't bet)
Seat 4: supbigdiaper folded before Flop (didn't bet)
Seat 5: Yaaaazz folded before Flop (didn't bet)
Seat 6: sacachispa19 (button) folded before Flop (didn't bet)


PokerStars Hand #222984726958:  Hold'em No Limit ($2.50/$5.00 USD) - 2021/01/23 22:42:10 ET
Table 'Aaltje II' 6-max Seat #1 is the button
Seat 1: Rabarber77 ($1855.79 in chips)
Seat 2: Nutsfit ($619.49 in chips)
Seat 3: magorko ($520.62 in chips)
Seat 4: supbigdiaper ($1148.78 in chips)
Seat 5: Yaaaazz ($525.72 in chips)
Seat 6: sacachispa19 ($500 in chips)
Nutsfit: posts small blind $2.50
magorko: posts big blind $5
*** HOLE CARDS ***
supbigdiaper: folds
Yaaaazz: folds
sacachispa19: raises $7.50 to $12.50
Rabarber77: calls $12.50
Nutsfit: folds
magorko: calls $7.50
*** FLOP *** [Ah 7h Ad]
magorko: checks
sacachispa19: bets $12.54
Rabarber77: raises $17.46 to $30
magorko: folds
sacachispa19: calls $17.46
*** TURN *** [Ah 7h Ad] [7c]
sacachispa19: checks
Rabarber77: bets $45
sacachispa19: calls $45
*** RIVER *** [Ah 7h Ad 7c] [2c]
sacachispa19: checks
Rabarber77: checks
*** SHOW DOWN ***
sacachispa19: shows [Ts As] (a full house, Aces full of Sevens)
Rabarber77: mucks hand
sacachispa19 collected $187 from pot
*** SUMMARY ***
Total pot $190 | Rake $3
Board [Ah 7h Ad 7c 2c]
Seat 1: Rabarber77 (button) mucked
Seat 2: Nutsfit (small blind) folded before Flop
Seat 3: magorko (big blind) folded on the Flop
Seat 4: supbigdiaper folded before Flop (didn't bet)
Seat 5: Yaaaazz folded before Flop (didn't bet)
Seat 6: sacachispa19 showed [Ts As] and won ($187) with a full house, Aces full of Sevens


PokerStars Hand #222984749502:  Hold'em No Limit ($2.50/$5.00 USD) - 2021/01/23 22:43:17 ET
Table 'Aaltje II' 6-max Seat #2 is the button
Seat 1: Rabarber77 ($1768.29 in chips)
Seat 2: Nutsfit ($616.99 in chips)
Seat 3: magorko ($508.12 in chips)
Seat 4: supbigdiaper ($1148.78 in chips)
Seat 5: Yaaaazz ($525.72 in chips)
Seat 6: sacachispa19 ($599.50 in chips)
magorko: posts small blind $2.50
supbigdiaper: posts big blind $5
*** HOLE CARDS ***
Yaaaazz: folds
sacachispa19: raises $7.50 to $12.50
Rabarber77: calls $12.50
Nutsfit: folds
magorko: raises $56.25 to $68.75
supbigdiaper: folds
sacachispa19: folds
Rabarber77: folds
Uncalled bet ($56.25) returned to magorko
magorko collected $42.50 from pot
magorko: doesn't show hand
*** SUMMARY ***
Total pot $42.50 | Rake $0
Seat 1: Rabarber77 folded before Flop
Seat 2: Nutsfit (button) folded before Flop (didn't bet)
Seat 3: magorko (small blind) collected ($42.50)
Seat 4: supbigdiaper (big blind) folded before Flop
Seat 5: Yaaaazz folded before Flop (didn't bet)
Seat 6: sacachispa19 folded before Flop


PokerStars Hand #222984757214:  Hold'em No Limit ($2.50/$5.00 USD) - 2021/01/23 22:43:41 ET
Table 'Aaltje II' 6-max Seat #3 is the button
Seat 1: Rabarber77 ($1755.79 in chips)
Seat 2: Nutsfit ($616.99 in chips)
Seat 3: magorko ($538.12 in chips)
Seat 4: supbigdiaper ($1143.78 in chips)
Seat 5: Yaaaazz ($525.72 in chips)
Seat 6: sacachispa19 ($587 in chips)
supbigdiaper: posts small blind $2.50
Yaaaazz: posts big blind $5
*** HOLE CARDS ***
sacachispa19: folds
Rabarber77: folds
Nutsfit: folds
magorko: raises $7.50 to $12.50
supbigdiaper: folds
Yaaaazz: folds
Uncalled bet ($7.50) returned to magorko
magorko collected $12.50 from pot
magorko: doesn't show hand
*** SUMMARY ***
Total pot $12.50 | Rake $0
Seat 1: Rabarber77 folded before Flop (didn't bet)
Seat 2: Nutsfit folded before Flop (didn't bet)
Seat 3: magorko (button) collected ($12.50)
Seat 4: supbigdiaper (small blind) folded before Flop
Seat 5: Yaaaazz (big blind) folded before Flop
Seat 6: sacachispa19 folded before Flop (didn't bet)


PokerStars Hand #222984762117:  Hold'em No Limit ($2.50/$5.00 USD) - 2021/01/23 22:43:56 ET
Table 'Aaltje II' 6-max Seat #4 is the button
Seat 1: Rabarber77 ($1755.79 in chips)
Seat 2: Nutsfit ($616.99 in chips)
Seat 3: magorko ($545.62 in chips)
Seat 4: supbigdiaper ($1141.28 in chips)
Seat 5: Yaaaazz ($520.72 in chips)
Seat 6: sacachispa19 ($587 in chips)
Yaaaazz: posts small blind $2.50
sacachispa19: posts big blind $5
*** HOLE CARDS ***
Rabarber77: raises $10 to $15
Nutsfit: folds
magorko: folds
supbigdiaper: raises $37.88 to $52.88
Yaaaazz: folds
sacachispa19: folds
Rabarber77: calls $37.88
*** FLOP *** [4c 6d 9d]
Rabarber77: checks
supbigdiaper: bets $36.39
Rabarber77: calls $36.39
*** TURN *** [4c 6d 9d] [8s]
Rabarber77: checks
supbigdiaper: checks
*** RIVER *** [4c 6d 9d 8s] [7d]
Rabarber77: checks
supbigdiaper: checks
*** SHOW DOWN ***
Rabarber77: shows [Ac Qh] (high card Ace)
supbigdiaper: shows [As Qc] (high card Ace)
Rabarber77 collected $91.52 from pot
supbigdiaper collected $91.52 from pot
*** SUMMARY ***
Total pot $186.04 | Rake $3
Board [4c 6d 9d 8s 7d]
Seat 1: Rabarber77 showed [Ac Qh] and won ($91.52) with high card Ace
Seat 2: Nutsfit folded before Flop (didn't bet)
Seat 3: magorko folded before Flop (didn't bet)
Seat 4: supbigdiaper (button) showed [As Qc] and won ($91.52) with high card Ace
Seat 5: Yaaaazz (small blind) folded before Flop
Seat 6: sacachispa19 (big blind) folded before Flop


PokerStars Hand #222984781801:  Hold'em No Limit ($2.50/$5.00 USD) - 2021/01/23 22:44:55 ET
Table 'Aaltje II' 6-max Seat #5 is the button
Seat 1: Rabarber77 ($1758.04 in chips)
Seat 2: Nutsfit ($616.99 in chips)
Seat 3: magorko ($545.62 in chips)
Seat 4: supbigdiaper ($1143.53 in chips)
Seat 5: Yaaaazz ($518.22 in chips)
Seat 6: sacachispa19 ($582 in chips)
sacachispa19: posts small blind $2.50
Rabarber77: posts big blind $5
*** HOLE CARDS ***
Nutsfit: raises $5.90 to $10.90
magorko: folds
supbigdiaper: raises $29.59 to $40.49
Yaaaazz: folds
sacachispa19: folds
Rabarber77: folds
Nutsfit: folds
Uncalled bet ($29.59) returned to supbigdiaper
supbigdiaper collected $29.30 from pot
supbigdiaper: doesn't show hand
*** SUMMARY ***
Total pot $29.30 | Rake $0
Seat 1: Rabarber77 (big blind) folded before Flop
Seat 2: Nutsfit folded before Flop
Seat 3: magorko folded before Flop (didn't bet)
Seat 4: supbigdiaper collected ($29.30)
Seat 5: Yaaaazz (button) folded before Flop (didn't bet)
Seat 6: sacachispa19 (small blind) folded before Flop


PokerStars Hand #222984792581:  Hold'em No Limit ($2.50/$5.00 USD) - 2021/01/23 22:45:28 ET
Table 'Aaltje II' 6-max Seat #6 is the button
Seat 1: Rabarber77 ($1753.04 in chips)
Seat 2: Nutsfit ($606.09 in chips)
Seat 3: magorko ($545.62 in chips)
Seat 4: supbigdiaper ($1161.93 in chips)
Seat 5: Yaaaazz ($518.22 in chips)
Seat 6: sacachispa19 ($579.50 in chips)
Rabarber77: posts small blind $2.50
Nutsfit: posts big blind $5
*** HOLE CARDS ***
magorko: folds
supbigdiaper: folds
Yaaaazz: folds
sacachispa19: folds
Rabarber77: folds
Uncalled bet ($2.50) returned to Nutsfit
Nutsfit collected $5 from pot
Nutsfit: doesn't show hand
*** SUMMARY ***
Total pot $5 | Rake $0
Seat 1: Rabarber77 (small blind) folded before Flop
Seat 2: Nutsfit (big blind) collected ($5)
Seat 3: magorko folded before Flop (didn't bet)
Seat 4: supbigdiaper folded before Flop (didn't bet)
Seat 5: Yaaaazz folded before Flop (didn't bet)
Seat 6: sacachispa19 (button) folded before Flop (didn't bet)


PokerStars Hand #222984799282:  Hold'em No Limit ($2.50/$5.00 USD) - 2021/01/23 22:45:48 ET
Table 'Aaltje II' 6-max Seat #1 is the button
Seat 1: Rabarber77 ($1750.54 in chips)
Seat 2: Nutsfit ($608.59 in chips)
Seat 3: magorko ($545.62 in chips)
Seat 4: supbigdiaper ($1161.93 in chips)
Seat 5: Yaaaazz ($518.22 in chips)
Seat 6: sacachispa19 ($579.50 in chips)
Nutsfit: posts small blind $2.50
magorko: posts big blind $5
*** HOLE CARDS ***
supbigdiaper: folds
Yaaaazz: raises $6.25 to $11.25
sacachispa19: folds
Rabarber77: folds
Nutsfit: folds
magorko: folds
Uncalled bet ($6.25) returned to Yaaaazz
Yaaaazz collected $12.50 from pot
Yaaaazz: doesn't show hand
*** SUMMARY ***
Total pot $12.50 | Rake $0
Seat 1: Rabarber77 (button) folded before Flop (didn't bet)
Seat 2: Nutsfit (small blind) folded before Flop
Seat 3: magorko (big blind) folded before Flop
Seat 4: supbigdiaper folded before Flop (didn't bet)
Seat 5: Yaaaazz collected ($12.50)
Seat 6: sacachispa19 folded before Flop (didn't bet)


PokerStars Hand #222984805290:  Hold'em No Limit ($2.50/$5.00 USD) - 2021/01/23 22:46:07 ET
Table 'Aaltje II' 6-max Seat #2 is the button
Seat 1: Rabarber77 ($1750.54 in chips)
Seat 2: Nutsfit ($606.09 in chips)
Seat 3: magorko ($540.62 in chips)
Seat 4: supbigdiaper ($1161.93 in chips)
Seat 5: Yaaaazz ($525.72 in chips)
Seat 6: sacachispa19 ($579.50 in chips)
magorko: posts small blind $2.50
supbigdiaper: posts big blind $5
*** HOLE CARDS ***
Yaaaazz: folds
sacachispa19: folds
Rabarber77: raises $10 to $15
Nutsfit: raises $30 to $45
magorko: folds
supbigdiaper: folds
Rabarber77: calls $30
*** FLOP *** [Td 8h Qd]
Rabarber77: checks
Nutsfit: checks
*** TURN *** [Td 8h Qd] [7d]
Rabarber77: bets $47.25
Nutsfit: calls $47.25
*** RIVER *** [Td 8h Qd 7d] [As]
Rabarber77: checks
Nutsfit: checks
*** SHOW DOWN ***
Rabarber77: shows [2d 2h] (a pair of Deuces)
Nutsfit: shows [Jh Js] (a pair of Jacks)
Nutsfit collected $189 from pot
*** SUMMARY ***
Total pot $192 | Rake $3
Board [Td 8h Qd 7d As]
Seat 1: Rabarber77 showed [2d 2h] and lost with a pair of Deuces
Seat 2: Nutsfit (button) showed [Jh Js] and won ($189) with a pair of Jacks
Seat 3: magorko (small blind) folded before Flop
Seat 4: supbigdiaper (big blind) folded before Flop
Seat 5: Yaaaazz folded before Flop (didn't bet)
Seat 6: sacachispa19 folded before Flop (didn't bet)


PokerStars Hand #222984820011:  Hold'em No Limit ($2.50/$5.00 USD) - 2021/01/23 22:46:46 ET
Table 'Aaltje II' 6-max Seat #3 is the button
Seat 1: Rabarber77 ($1658.29 in chips)
Seat 2: Nutsfit ($702.84 in chips)
Seat 3: magorko ($538.12 in chips)
Seat 4: supbigdiaper ($1156.93 in chips)
Seat 5: Yaaaazz ($525.72 in chips)
Seat 6: sacachispa19 ($579.50 in chips)
supbigdiaper: posts small blind $2.50
Yaaaazz: posts big blind $5
*** HOLE CARDS ***
sacachispa19: folds
Rabarber77: folds
Nutsfit: folds
magorko: folds
supbigdiaper: raises $7.50 to $12.50
Yaaaazz: calls $7.50
*** FLOP *** [2c 8s Th]
supbigdiaper: bets $7.84
Yaaaazz: folds
Uncalled bet ($7.84) returned to supbigdiaper
supbigdiaper collected $23.75 from pot
supbigdiaper: doesn't show hand
*** SUMMARY ***
Total pot $25 | Rake $1.25
Board [2c 8s Th]
Seat 1: Rabarber77 folded before Flop (didn't bet)
Seat 2: Nutsfit folded before Flop (didn't bet)
Seat 3: magorko (button) folded before Flop (didn't bet)
Seat 4: supbigdiaper (small blind) collected ($23.75)
Seat 5: Yaaaazz (big blind) folded on the Flop
Seat 6: sacachispa19 folded before Flop (didn't bet)


PokerStars Hand #222984831449:  Hold'em No Limit ($2.50/$5.00 USD) - 2021/01/23 22:47:21 ET
Table 'Aaltje II' 6-max Seat #4 is the button
Seat 1: Rabarber77 ($1658.29 in chips)
Seat 2: Nutsfit ($702.84 in chips)
Seat 3: magorko ($538.12 in chips)
Seat 4: supbigdiaper ($1168.18 in chips)
Seat 5: Yaaaazz ($513.22 in chips)
Seat 6: sacachispa19 ($579.50 in chips)
Yaaaazz: posts small blind $2.50
sacachispa19: posts big blind $5
*** HOLE CARDS ***
Rabarber77: folds
Nutsfit: folds
magorko: raises $7.50 to $12.50
supbigdiaper: folds
Yaaaazz: folds
sacachispa19: calls $7.50
*** FLOP *** [8c Js Th]
sacachispa19: checks
magorko: bets $6.20
sacachispa19: calls $6.20
*** TURN *** [8c Js Th] [7s]
sacachispa19: checks
magorko: bets $28.43
sacachispa19: folds
Uncalled bet ($28.43) returned to magorko
magorko collected $37.90 from pot
magorko: doesn't show hand
*** SUMMARY ***
Total pot $39.90 | Rake $2
Board [8c Js Th 7s]
Seat 1: Rabarber77 folded before Flop (didn't bet)
Seat 2: Nutsfit folded before Flop (didn't bet)
Seat 3: magorko collected ($37.90)
Seat 4: supbigdiaper (button) folded before Flop (didn't bet)
Seat 5: Yaaaazz (small blind) folded before Flop
Seat 6: sacachispa19 (big blind) folded on the Turn


PokerStars Hand #222984851896:  Hold'em No Limit ($2.50/$5.00 USD) - 2021/01/23 22:48:23 ET
Table 'Aaltje II' 6-max Seat #5 is the button
Seat 1: Rabarber77 ($1658.29 in chips)
Seat 2: Nutsfit ($702.84 in chips)
Seat 3: magorko ($557.32 in chips)
Seat 4: supbigdiaper ($1168.18 in chips)
Seat 5: Yaaaazz ($510.72 in chips)
Seat 6: sacachispa19 ($560.80 in chips)
sacachispa19: posts small blind $2.50
Rabarber77: posts big blind $5
*** HOLE CARDS ***
Nutsfit: folds
magorko: folds
supbigdiaper: raises $7.50 to $12.50
Yaaaazz: raises $25 to $37.50
sacachispa19: folds
Rabarber77: folds
supbigdiaper: calls $25
*** FLOP *** [9d 6s Qc]
supbigdiaper: checks
Yaaaazz: bets $26.24
supbigdiaper: folds
Uncalled bet ($26.24) returned to Yaaaazz
Yaaaazz collected $79.50 from pot
Yaaaazz: doesn't show hand
*** SUMMARY ***
Total pot $82.50 | Rake $3
Board [9d 6s Qc]
Seat 1: Rabarber77 (big blind) folded before Flop
Seat 2: Nutsfit folded before Flop (didn't bet)
Seat 3: magorko folded before Flop (didn't bet)
Seat 4: supbigdiaper folded on the Flop
Seat 5: Yaaaazz (button) collected ($79.50)
Seat 6: sacachispa19 (small blind) folded before Flop


PokerStars Hand #222984861000:  Hold'em No Limit ($2.50/$5.00 USD) - 2021/01/23 22:48:51 ET
Table 'Aaltje II' 6-max Seat #1 is the button
Seat 1: Rabarber77 ($1653.29 in chips)
Seat 2: Nutsfit ($702.84 in chips)
Seat 3: magorko ($557.32 in chips)
Seat 4: supbigdiaper ($1130.68 in chips)
Seat 5: Yaaaazz ($552.72 in chips)
Nutsfit: posts small blind $2.50
magorko: posts big blind $5
*** HOLE CARDS ***
supbigdiaper: folds
Yaaaazz: folds
Rabarber77: raises $10 to $15
Nutsfit: folds
magorko: calls $10
*** FLOP *** [3d Ts 9s]
magorko: checks
Rabarber77: bets $15.44
magorko: folds
Uncalled bet ($15.44) returned to Rabarber77
Rabarber77 collected $30.88 from pot
Rabarber77: doesn't show hand
*** SUMMARY ***
Total pot $32.50 | Rake $1.62
Board [3d Ts 9s]
Seat 1: Rabarber77 (button) collected ($30.88)
Seat 2: Nutsfit (small blind) folded before Flop
Seat 3: magorko (big blind) folded on the Flop
Seat 4: supbigdiaper folded before Flop (didn't bet)
Seat 5: Yaaaazz folded before Flop (didn't bet)


PokerStars Hand #222984867841:  Hold'em No Limit ($2.50/$5.00 USD) - 2021/01/23 22:49:12 ET
Table 'Aaltje II' 6-max Seat #2 is the button
Seat 1: Rabarber77 ($1669.17 in chips)
Seat 2: Nutsfit ($700.34 in chips)
Seat 3: magorko ($542.32 in chips)
Seat 4: supbigdiaper ($1130.68 in chips)
Seat 5: Yaaaazz ($552.72 in chips)
magorko: posts small blind $2.50
supbigdiaper: posts big blind $5
*** HOLE CARDS ***
Yaaaazz: folds
Rabarber77: folds
Nutsfit: raises $7.50 to $12.50
magorko: raises $43.75 to $56.25
supbigdiaper: folds
Nutsfit: raises $66.25 to $122.50
magorko: folds
Uncalled bet ($66.25) returned to Nutsfit
Nutsfit collected $117.50 from pot
Nutsfit: doesn't show hand
*** SUMMARY ***
Total pot $117.50 | Rake $0
Seat 1: Rabarber77 folded before Flop (didn't bet)
Seat 2: Nutsfit (button) collected ($117.50)
Seat 3: magorko (small blind) folded before Flop
Seat 4: supbigdiaper (big blind) folded before Flop
Seat 5: Yaaaazz folded before Flop (didn't bet)


PokerStars Hand #222984887817:  Hold'em No Limit ($2.50/$5.00 USD) - 2021/01/23 22:49:53 ET
Table 'Aaltje II' 6-max Seat #3 is the button
Seat 1: Rabarber77 ($1669.17 in chips)
Seat 2: Nutsfit ($761.59 in chips)
Seat 3: magorko ($500 in chips)
Seat 4: supbigdiaper ($1125.68 in chips)
Seat 5: Yaaaazz ($552.72 in chips)
supbigdiaper: posts small blind $2.50
Yaaaazz: posts big blind $5
*** HOLE CARDS ***
Rabarber77: folds
Nutsfit: folds
magorko: raises $7.50 to $12.50
supbigdiaper: folds
Yaaaazz: calls $7.50
*** FLOP *** [5c Jc Ks]
Yaaaazz: checks
magorko: checks
*** TURN *** [5c Jc Ks] [5h]
Yaaaazz: checks
magorko: bets $17.15
Yaaaazz: folds
Uncalled bet ($17.15) returned to magorko
magorko collected $26.12 from pot
magorko: doesn't show hand
*** SUMMARY ***
Total pot $27.50 | Rake $1.38
Board [5c Jc Ks 5h]
Seat 1: Rabarber77 folded before Flop (didn't bet)
Seat 2: Nutsfit folded before Flop (didn't bet)
Seat 3: magorko (button) collected ($26.12)
Seat 4: supbigdiaper (small blind) folded before Flop
Seat 5: Yaaaazz (big blind) folded on the Turn


PokerStars Hand #222984916356:  Hold'em No Limit ($2.50/$5.00 USD) - 2021/01/23 22:50:56 ET
Table 'Aaltje II' 6-max Seat #4 is the button
Seat 1: Rabarber77 ($1669.17 in chips)
Seat 2: Nutsfit ($761.59 in chips)
Seat 3: magorko ($513.62 in chips)
Seat 4: supbigdiaper ($1123.18 in chips)
Seat 5: Yaaaazz ($540.22 in chips)
Yaaaazz: posts small blind $2.50
Rabarber77: posts big blind $5
*** HOLE CARDS ***
Nutsfit: raises $6.25 to $11.25
magorko: folds
supbigdiaper: calls $11.25
Yaaaazz: folds
Rabarber77: folds
*** FLOP *** [Ts 9s 2d]
Nutsfit: checks
supbigdiaper: bets $14.25
Nutsfit: calls $14.25
*** TURN *** [Ts 9s 2d] [Jh]
Nutsfit: checks
supbigdiaper: checks
*** RIVER *** [Ts 9s 2d Jh] [4s]
Nutsfit: checks
supbigdiaper: bets $69.48
Nutsfit: folds
Uncalled bet ($69.48) returned to supbigdiaper
supbigdiaper collected $55.58 from pot
supbigdiaper: doesn't show hand
*** SUMMARY ***
Total pot $58.50 | Rake $2.92
Board [Ts 9s 2d Jh 4s]
Seat 1: Rabarber77 (big blind) folded before Flop
Seat 2: Nutsfit folded on the River
Seat 3: magorko folded before Flop (didn't bet)
Seat 4: supbigdiaper (button) collected ($55.58)
Seat 5: Yaaaazz (small blind) folded before Flop


PokerStars Hand #222984944787:  Hold'em No Limit ($2.50/$5.00 USD) - 2021/01/23 22:52:25 ET
Table 'Aaltje II' 6-max Seat #5 is the button
Seat 1: Rabarber77 ($1664.17 in chips)
Seat 2: Nutsfit ($736.09 in chips)
Seat 3: magorko ($513.62 in chips)
Seat 4: supbigdiaper ($1153.26 in chips)
Seat 5: Yaaaazz ($537.72 in chips)
Rabarber77: posts small blind $2.50
Nutsfit: posts big blind $5
*** HOLE CARDS ***
magorko: folds
supbigdiaper: raises $7.50 to $12.50
Yaaaazz: folds
Rabarber77: calls $10
Nutsfit: folds
*** FLOP *** [2s 8h 8c]
Rabarber77: bets $14.25
supbigdiaper: calls $14.25
*** TURN *** [2s 8h 8c] [Qc]
Rabarber77: checks
supbigdiaper: checks
*** RIVER *** [2s 8h 8c Qc] [7s]
Rabarber77: bets $27.79
supbigdiaper: calls $27.79
*** SHOW DOWN ***
Rabarber77: shows [As 6s] (a pair of Eights)
supbigdiaper: shows [Ac Js] (a pair of Eights - Ace+Queen+Jack kicker)
supbigdiaper collected $111.08 from pot
*** SUMMARY ***
Total pot $114.08 | Rake $3
Board [2s 8h 8c Qc 7s]
Seat 1: Rabarber77 (small blind) showed [As 6s] and lost with a pair of Eights
Seat 2: Nutsfit (big blind) folded before Flop
Seat 3: magorko folded before Flop (didn't bet)
Seat 4: supbigdiaper showed [Ac Js] and won ($111.08) with a pair of Eights
Seat 5: Yaaaazz (button) folded before Flop (didn't bet)


PokerStars Hand #222984959266:  Hold'em No Limit ($2.50/$5.00 USD) - 2021/01/23 22:53:10 ET
Table 'Aaltje II' 6-max Seat #1 is the button
Seat 1: Rabarber77 ($1609.63 in chips)
Seat 2: Nutsfit ($731.09 in chips)
Seat 3: magorko ($513.62 in chips)
Seat 4: supbigdiaper ($1209.80 in chips)
Seat 5: Yaaaazz ($537.72 in chips)
Nutsfit: posts small blind $2.50
magorko: posts big blind $5
sacachispa19: sits out
*** HOLE CARDS ***
supbigdiaper: raises $7.50 to $12.50
Yaaaazz: folds
Rabarber77: folds
Nutsfit: folds
magorko: folds
Uncalled bet ($7.50) returned to supbigdiaper
supbigdiaper collected $12.50 from pot
supbigdiaper: doesn't show hand
*** SUMMARY ***
Total pot $12.50 | Rake $0
Seat 1: Rabarber77 (button) folded before Flop (didn't bet)
Seat 2: Nutsfit (small blind) folded before Flop
Seat 3: magorko (big blind) folded before Flop
Seat 4: supbigdiaper collected ($12.50)
Seat 5: Yaaaazz folded before Flop (didn't bet)


PokerStars Hand #222984962933:  Hold'em No Limit ($2.50/$5.00 USD) - 2021/01/23 22:53:21 ET
Table 'Aaltje II' 6-max Seat #2 is the button
Seat 1: Rabarber77 ($1609.63 in chips)
Seat 2: Nutsfit ($728.59 in chips)
Seat 3: magorko ($508.62 in chips)
Seat 4: supbigdiaper ($1217.30 in chips)
Seat 5: Yaaaazz ($537.72 in chips)
magorko: posts small blind $2.50
supbigdiaper: posts big blind $5
sacachispa19: sits out
*** HOLE CARDS ***
Yaaaazz: folds
Rabarber77: folds
Nutsfit: raises $7.50 to $12.50
magorko: folds
supbigdiaper: folds
Uncalled bet ($7.50) returned to Nutsfit
Nutsfit collected $12.50 from pot
Nutsfit: doesn't show hand
*** SUMMARY ***
Total pot $12.50 | Rake $0
Seat 1: Rabarber77 folded before Flop (didn't bet)
Seat 2: Nutsfit (button) collected ($12.50)
Seat 3: magorko (small blind) folded before Flop
Seat 4: supbigdiaper (big blind) folded before Flop
Seat 5: Yaaaazz folded before Flop (didn't bet)


PokerStars Hand #222984968231:  Hold'em No Limit ($2.50/$5.00 USD) - 2021/01/23 22:53:38 ET
Table 'Aaltje II' 6-max Seat #3 is the button
Seat 1: Rabarber77 ($1609.63 in chips)
Seat 2: Nutsfit ($736.09 in chips)
Seat 3: magorko ($506.12 in chips)
Seat 4: supbigdiaper ($1212.30 in chips)
Seat 5: Yaaaazz ($537.72 in chips)
supbigdiaper: posts small blind $2.50
Yaaaazz: posts big blind $5
sacachispa19: sits out
*** HOLE CARDS ***
Rabarber77: raises $10 to $15
Nutsfit: folds
magorko: raises $30 to $45
supbigdiaper: folds
Yaaaazz: folds
Rabarber77: calls $30
*** FLOP *** [9s Ad Ks]
Rabarber77: checks
magorko: bets $31.19
Rabarber77: calls $31.19
*** TURN *** [9s Ad Ks] [2c]
Rabarber77: checks
magorko: bets $117.66
Rabarber77: raises $1415.78 to $1533.44 and is all-in
magorko: folds
Uncalled bet ($1415.78) returned to Rabarber77
Rabarber77 collected $392.20 from pot
Rabarber77: doesn't show hand
*** SUMMARY ***
Total pot $395.20 | Rake $3
Board [9s Ad Ks 2c]
Seat 1: Rabarber77 collected ($392.20)
Seat 2: Nutsfit folded before Flop (didn't bet)
Seat 3: magorko (button) folded on the Turn
Seat 4: supbigdiaper (small blind) folded before Flop
Seat 5: Yaaaazz (big blind) folded before Flop


PokerStars Hand #222984985163:  Hold'em No Limit ($2.50/$5.00 USD) - 2021/01/23 22:54:31 ET
Table 'Aaltje II' 6-max Seat #4 is the button
Seat 1: Rabarber77 ($1807.98 in chips)
Seat 2: Nutsfit ($736.09 in chips)
Seat 3: magorko ($500 in chips)
Seat 4: supbigdiaper ($1209.80 in chips)
Seat 5: Yaaaazz ($532.72 in chips)
Seat 6: sacachispa19 ($558.30 in chips)
Yaaaazz: posts small blind $2.50
sacachispa19: posts big blind $5
*** HOLE CARDS ***
Rabarber77: folds
Nutsfit: folds
magorko: raises $7.50 to $12.50
supbigdiaper: folds
Yaaaazz: folds
sacachispa19: folds
Uncalled bet ($7.50) returned to magorko
magorko collected $12.50 from pot
magorko: doesn't show hand
*** SUMMARY ***
Total pot $12.50 | Rake $0
Seat 1: Rabarber77 folded before Flop (didn't bet)
Seat 2: Nutsfit folded before Flop (didn't bet)
Seat 3: magorko collected ($12.50)
Seat 4: supbigdiaper (button) folded before Flop (didn't bet)
Seat 5: Yaaaazz (small blind) folded before Flop
Seat 6: sacachispa19 (big blind) folded before Flop


PokerStars Hand #222984989329:  Hold'em No Limit ($2.50/$5.00 USD) - 2021/01/23 22:54:45 ET
Table 'Aaltje II' 6-max Seat #5 is the button
Seat 1: Rabarber77 ($1807.98 in chips)
Seat 2: Nutsfit ($736.09 in chips)
Seat 3: magorko ($507.50 in chips)
Seat 4: supbigdiaper ($1209.80 in chips)
Seat 5: Yaaaazz ($530.22 in chips)
Seat 6: sacachispa19 ($553.30 in chips)
sacachispa19: posts small blind $2.50
Rabarber77: posts big blind $5
*** HOLE CARDS ***
Nutsfit: folds
magorko: folds
supbigdiaper: folds
Yaaaazz: folds
sacachispa19: folds
Uncalled bet ($2.50) returned to Rabarber77
Rabarber77 collected $5 from pot
Rabarber77: doesn't show hand
*** SUMMARY ***
Total pot $5 | Rake $0
Seat 1: Rabarber77 (big blind) collected ($5)
Seat 2: Nutsfit folded before Flop (didn't bet)
Seat 3: magorko folded before Flop (didn't bet)
Seat 4: supbigdiaper folded before Flop (didn't bet)
Seat 5: Yaaaazz (button) folded before Flop (didn't bet)
Seat 6: sacachispa19 (small blind) folded before Flop


PokerStars Hand #222984997226:  Hold'em No Limit ($2.50/$5.00 USD) - 2021/01/23 22:55:09 ET
Table 'Aaltje II' 6-max Seat #6 is the button
Seat 1: Rabarber77 ($1810.48 in chips)
Seat 2: Nutsfit ($736.09 in chips)
Seat 3: magorko ($507.50 in chips)
Seat 4: supbigdiaper ($1209.80 in chips)
Seat 5: Yaaaazz ($530.22 in chips)
Seat 6: sacachispa19 ($550.80 in chips)
Rabarber77: posts small blind $2.50
Nutsfit: posts big blind $5
*** HOLE CARDS ***
magorko: folds
supbigdiaper: folds
Yaaaazz: folds
sacachispa19: folds
Rabarber77: raises $10 to $15
Nutsfit: calls $10
*** FLOP *** [4s Jc 7s]
Rabarber77: bets $15
Nutsfit: calls $15
*** TURN *** [4s Jc 7s] [Ad]
Rabarber77: bets $25
Nutsfit: calls $25
*** RIVER *** [4s Jc 7s Ad] [6h]
Rabarber77: bets $53.50
Nutsfit: folds
Uncalled bet ($53.50) returned to Rabarber77
Rabarber77 collected $107 from pot
Rabarber77: doesn't show hand
*** SUMMARY ***
Total pot $110 | Rake $3
Board [4s Jc 7s Ad 6h]
Seat 1: Rabarber77 (small blind) collected ($107)
Seat 2: Nutsfit (big blind) folded on the River
Seat 3: magorko folded before Flop (didn't bet)
Seat 4: supbigdiaper folded before Flop (didn't bet)
Seat 5: Yaaaazz folded before Flop (didn't bet)
Seat 6: sacachispa19 (button) folded before Flop (didn't bet)


PokerStars Hand #222985019116:  Hold'em No Limit ($2.50/$5.00 USD) - 2021/01/23 22:56:38 ET
Table 'Aaltje II' 6-max Seat #1 is the button
Seat 1: Rabarber77 ($1862.48 in chips)
Seat 2: Nutsfit ($681.09 in chips)
Seat 3: magorko ($507.50 in chips)
Seat 4: supbigdiaper ($1209.80 in chips)
Seat 5: Yaaaazz ($530.22 in chips)
Seat 6: sacachispa19 ($550.80 in chips)
Nutsfit: posts small blind $2.50
magorko: posts big blind $5
*** HOLE CARDS ***
supbigdiaper: folds
Yaaaazz: folds
sacachispa19: folds
Rabarber77: folds
Nutsfit: folds
Uncalled bet ($2.50) returned to magorko
magorko collected $5 from pot
magorko: doesn't show hand
*** SUMMARY ***
Total pot $5 | Rake $0
Seat 1: Rabarber77 (button) folded before Flop (didn't bet)
Seat 2: Nutsfit (small blind) folded before Flop
Seat 3: magorko (big blind) collected ($5)
Seat 4: supbigdiaper folded before Flop (didn't bet)
Seat 5: Yaaaazz folded before Flop (didn't bet)
Seat 6: sacachispa19 folded before Flop (didn't bet)


PokerStars Hand #222985022876:  Hold'em No Limit ($2.50/$5.00 USD) - 2021/01/23 22:56:53 ET
Table 'Aaltje II' 6-max Seat #2 is the button
Seat 1: Rabarber77 ($1862.48 in chips)
Seat 2: Nutsfit ($678.59 in chips)
Seat 3: magorko ($510 in chips)
Seat 4: supbigdiaper ($1209.80 in chips)
Seat 5: Yaaaazz ($530.22 in chips)
Seat 6: sacachispa19 ($550.80 in chips)
magorko: posts small blind $2.50
supbigdiaper: posts big blind $5
*** HOLE CARDS ***
Yaaaazz: folds
sacachispa19: folds
Rabarber77: raises $10 to $15
Nutsfit: folds
magorko: folds
supbigdiaper: folds
Uncalled bet ($10) returned to Rabarber77
Rabarber77 collected $12.50 from pot
Rabarber77: doesn't show hand
*** SUMMARY ***
Total pot $12.50 | Rake $0
Seat 1: Rabarber77 collected ($12.50)
Seat 2: Nutsfit (button) folded before Flop (didn't bet)
Seat 3: magorko (small blind) folded before Flop
Seat 4: supbigdiaper (big blind) folded before Flop
Seat 5: Yaaaazz folded before Flop (didn't bet)
Seat 6: sacachispa19 folded before Flop (didn't bet)


PokerStars Hand #222985029303:  Hold'em No Limit ($2.50/$5.00 USD) - 2021/01/23 22:57:20 ET
Table 'Aaltje II' 6-max Seat #3 is the button
Seat 1: Rabarber77 ($1869.98 in chips)
Seat 2: Nutsfit ($678.59 in chips)
Seat 3: magorko ($507.50 in chips)
Seat 4: supbigdiaper ($1204.80 in chips)
Seat 5: Yaaaazz ($530.22 in chips)
Seat 6: sacachispa19 ($550.80 in chips)
supbigdiaper: posts small blind $2.50
Yaaaazz: posts big blind $5
*** HOLE CARDS ***
sacachispa19: folds
Rabarber77: raises $5 to $10
Nutsfit: folds
magorko: folds
supbigdiaper: folds
Yaaaazz: folds
Uncalled bet ($5) returned to Rabarber77
Rabarber77 collected $12.50 from pot
Rabarber77: doesn't show hand
*** SUMMARY ***
Total pot $12.50 | Rake $0
Seat 1: Rabarber77 collected ($12.50)
Seat 2: Nutsfit folded before Flop (didn't bet)
Seat 3: magorko (button) folded before Flop (didn't bet)
Seat 4: supbigdiaper (small blind) folded before Flop
Seat 5: Yaaaazz (big blind) folded before Flop
Seat 6: sacachispa19 folded before Flop (didn't bet)


PokerStars Hand #222985033625:  Hold'em No Limit ($2.50/$5.00 USD) - 2021/01/23 22:57:37 ET
Table 'Aaltje II' 6-max Seat #4 is the button
Seat 1: Rabarber77 ($1877.48 in chips)
Seat 2: Nutsfit ($678.59 in chips)
Seat 3: magorko ($507.50 in chips)
Seat 4: supbigdiaper ($1202.30 in chips)
Seat 5: Yaaaazz ($525.22 in chips)
Seat 6: sacachispa19 ($550.80 in chips)
Yaaaazz: posts small blind $2.50
sacachispa19: posts big blind $5
*** HOLE CARDS ***
Rabarber77: folds
Nutsfit: folds
magorko: raises $7.50 to $12.50
supbigdiaper: folds
Yaaaazz: folds
sacachispa19: folds
Uncalled bet ($7.50) returned to magorko
magorko collected $12.50 from pot
magorko: doesn't show hand
*** SUMMARY ***
Total pot $12.50 | Rake $0
Seat 1: Rabarber77 folded before Flop (didn't bet)
Seat 2: Nutsfit folded before Flop (didn't bet)
Seat 3: magorko collected ($12.50)
Seat 4: supbigdiaper (button) folded before Flop (didn't bet)
Seat 5: Yaaaazz (small blind) folded before Flop
Seat 6: sacachispa19 (big blind) folded before Flop


PokerStars Hand #222985040314:  Hold'em No Limit ($2.50/$5.00 USD) - 2021/01/23 22:58:05 ET
Table 'Aaltje II' 6-max Seat #5 is the button
Seat 1: Rabarber77 ($1877.48 in chips)
Seat 2: Nutsfit ($678.59 in chips)
Seat 3: magorko ($515 in chips)
Seat 4: supbigdiaper ($1202.30 in chips)
Seat 5: Yaaaazz ($522.72 in chips)
Seat 6: sacachispa19 ($545.80 in chips)
sacachispa19: posts small blind $2.50
Rabarber77: posts big blind $5
*** HOLE CARDS ***
Nutsfit: folds
magorko: folds
supbigdiaper: folds
Yaaaazz: raises $7.50 to $12.50
sacachispa19: folds
Rabarber77: calls $7.50
*** FLOP *** [9c 6s 6d]
Rabarber77: checks
Yaaaazz: checks
*** TURN *** [9c 6s 6d] [3c]
Rabarber77: bets $15
Yaaaazz: folds
Uncalled bet ($15) returned to Rabarber77
Rabarber77 collected $26.12 from pot
Rabarber77: doesn't show hand
*** SUMMARY ***
Total pot $27.50 | Rake $1.38
Board [9c 6s 6d 3c]
Seat 1: Rabarber77 (big blind) collected ($26.12)
Seat 2: Nutsfit folded before Flop (didn't bet)
Seat 3: magorko folded before Flop (didn't bet)
Seat 4: supbigdiaper folded before Flop (didn't bet)
Seat 5: Yaaaazz (button) folded on the Turn
Seat 6: sacachispa19 (small blind) folded before Flop


PokerStars Hand #222985051453:  Hold'em No Limit ($2.50/$5.00 USD) - 2021/01/23 22:58:51 ET
Table 'Aaltje II' 6-max Seat #6 is the button
Seat 1: Rabarber77 ($1891.10 in chips)
Seat 2: Nutsfit ($678.59 in chips)
Seat 3: magorko ($515 in chips)
Seat 4: supbigdiaper ($1202.30 in chips)
Seat 5: Yaaaazz ($510.22 in chips)
Seat 6: sacachispa19 ($543.30 in chips)
Rabarber77: posts small blind $2.50
Nutsfit: posts big blind $5
*** HOLE CARDS ***
magorko: raises $7.50 to $12.50
supbigdiaper: folds
Yaaaazz: folds
sacachispa19: folds
Rabarber77: calls $10
Nutsfit: folds
*** FLOP *** [4c 9s Kd]
Rabarber77: checks
magorko: checks
*** TURN *** [4c 9s Kd] [Jc]
Rabarber77: checks
magorko: checks
*** RIVER *** [4c 9s Kd Jc] [Td]
Rabarber77: checks
magorko: bets $30.20
Rabarber77: folds
Uncalled bet ($30.20) returned to magorko
magorko collected $28.50 from pot
magorko: doesn't show hand
*** SUMMARY ***
Total pot $30 | Rake $1.50
Board [4c 9s Kd Jc Td]
Seat 1: Rabarber77 (small blind) folded on the River
Seat 2: Nutsfit (big blind) folded before Flop
Seat 3: magorko collected ($28.50)
Seat 4: supbigdiaper folded before Flop (didn't bet)
Seat 5: Yaaaazz folded before Flop (didn't bet)
Seat 6: sacachispa19 (button) folded before Flop (didn't bet)


PokerStars Hand #222985065110:  Hold'em No Limit ($2.50/$5.00 USD) - 2021/01/23 22:59:47 ET
Table 'Aaltje II' 6-max Seat #1 is the button
Seat 1: Rabarber77 ($1878.60 in chips)
Seat 2: Nutsfit ($673.59 in chips)
Seat 3: magorko ($531 in chips)
Seat 4: supbigdiaper ($1202.30 in chips)
Seat 5: Yaaaazz ($510.22 in chips)
Seat 6: sacachispa19 ($543.30 in chips)
Nutsfit: posts small blind $2.50
magorko: posts big blind $5
*** HOLE CARDS ***
supbigdiaper: folds
Yaaaazz: folds
sacachispa19: raises $7.50 to $12.50
Rabarber77: folds
Nutsfit: folds
magorko: raises $50 to $62.50
sacachispa19: folds
Uncalled bet ($50) returned to magorko
magorko collected $27.50 from pot
magorko: doesn't show hand
*** SUMMARY ***
Total pot $27.50 | Rake $0
Seat 1: Rabarber77 (button) folded before Flop (didn't bet)
Seat 2: Nutsfit (small blind) folded before Flop
Seat 3: magorko (big blind) collected ($27.50)
Seat 4: supbigdiaper folded before Flop (didn't bet)
Seat 5: Yaaaazz folded before Flop (didn't bet)
Seat 6: sacachispa19 folded before Flop


PokerStars Hand #222985071172:  Hold'em No Limit ($2.50/$5.00 USD) - 2021/01/23 23:00:11 ET
Table 'Aaltje II' 6-max Seat #2 is the button
Seat 1: Rabarber77 ($1878.60 in chips)
Seat 2: Nutsfit ($671.09 in chips)
Seat 3: magorko ($546 in chips)
Seat 4: supbigdiaper ($1202.30 in chips)
Seat 5: Yaaaazz ($510.22 in chips)
Seat 6: sacachispa19 ($530.80 in chips)
magorko: posts small blind $2.50
supbigdiaper: posts big blind $5
*** HOLE CARDS ***
Yaaaazz: folds
sacachispa19: folds
Rabarber77: folds
Nutsfit: folds
magorko: raises $7.50 to $12.50
supbigdiaper: raises $25.25 to $37.75
magorko: raises $71.60 to $109.35
supbigdiaper: raises $1092.95 to $1202.30 and is all-in
magorko: calls $436.65 and is all-in
Uncalled bet ($656.30) returned to supbigdiaper
*** FLOP *** [6s 8c Ac]
*** TURN *** [6s 8c Ac] [Ts]
*** RIVER *** [6s 8c Ac Ts] [2h]
*** SHOW DOWN ***
magorko: shows [Ah Kc] (a pair of Aces)
supbigdiaper: shows [5s As] (a pair of Aces - lower kicker)
magorko collected $1089 from pot
*** SUMMARY ***
Total pot $1092 | Rake $3
Board [6s 8c Ac Ts 2h]
Seat 1: Rabarber77 folded before Flop (didn't bet)
Seat 2: Nutsfit (button) folded before Flop (didn't bet)
Seat 3: magorko (small blind) showed [Ah Kc] and won ($1089) with a pair of Aces
Seat 4: supbigdiaper (big blind) showed [5s As] and lost with a pair of Aces
Seat 5: Yaaaazz folded before Flop (didn't bet)
Seat 6: sacachispa19 folded before Flop (didn't bet)


PokerStars Hand #222985090729:  Hold'em No Limit ($2.50/$5.00 USD) - 2021/01/23 23:01:19 ET
Table 'Aaltje II' 6-max Seat #3 is the button
Seat 1: Rabarber77 ($1878.60 in chips)
Seat 2: Nutsfit ($671.09 in chips)
Seat 3: magorko ($1089 in chips)
Seat 4: supbigdiaper ($656.30 in chips)
Seat 5: Yaaaazz ($510.22 in chips)
Seat 6: sacachispa19 ($530.80 in chips)
supbigdiaper: posts small blind $2.50
Yaaaazz: posts big blind $5
*** HOLE CARDS ***
sacachispa19: folds
Rabarber77: folds
Nutsfit: folds
magorko: raises $7.50 to $12.50
supbigdiaper: folds
Yaaaazz: calls $7.50
*** FLOP *** [8h Td 4c]
Yaaaazz: checks
magorko: bets $8.62
Yaaaazz: raises $21.68 to $30.30
magorko: calls $21.68
*** TURN *** [8h Td 4c] [9d]
Yaaaazz: checks
magorko: checks
*** RIVER *** [8h Td 4c 9d] [Kh]
Yaaaazz: bets $68.08
magorko: folds
Uncalled bet ($68.08) returned to Yaaaazz
Yaaaazz collected $85.10 from pot
Yaaaazz: doesn't show hand
*** SUMMARY ***
Total pot $88.10 | Rake $3
Board [8h Td 4c 9d Kh]
Seat 1: Rabarber77 folded before Flop (didn't bet)
Seat 2: Nutsfit folded before Flop (didn't bet)
Seat 3: magorko (button) folded on the River
Seat 4: supbigdiaper (small blind) folded before Flop
Seat 5: Yaaaazz (big blind) collected ($85.10)
Seat 6: sacachispa19 folded before Flop (didn't bet)


PokerStars Hand #222985116634:  Hold'em No Limit ($2.50/$5.00 USD) - 2021/01/23 23:02:42 ET
Table 'Aaltje II' 6-max Seat #4 is the button
Seat 1: Rabarber77 ($1878.60 in chips)
Seat 2: Nutsfit ($671.09 in chips)
Seat 3: magorko ($1046.20 in chips)
Seat 4: supbigdiaper ($653.80 in chips)
Seat 5: Yaaaazz ($552.52 in chips)
Seat 6: sacachispa19 ($530.80 in chips)
Yaaaazz: posts small blind $2.50
sacachispa19: posts big blind $5
*** HOLE CARDS ***
Rabarber77: folds
Nutsfit: raises $5.90 to $10.90
magorko: folds
supbigdiaper: folds
Yaaaazz: folds
sacachispa19: folds
Uncalled bet ($5.90) returned to Nutsfit
Nutsfit collected $12.50 from pot
Nutsfit: doesn't show hand
*** SUMMARY ***
Total pot $12.50 | Rake $0
Seat 1: Rabarber77 folded before Flop (didn't bet)
Seat 2: Nutsfit collected ($12.50)
Seat 3: magorko folded before Flop (didn't bet)
Seat 4: supbigdiaper (button) folded before Flop (didn't bet)
Seat 5: Yaaaazz (small blind) folded before Flop
Seat 6: sacachispa19 (big blind) folded before Flop


PokerStars Hand #222985123524:  Hold'em No Limit ($2.50/$5.00 USD) - 2021/01/23 23:02:58 ET
Table 'Aaltje II' 6-max Seat #5 is the button
Seat 1: Rabarber77 ($1878.60 in chips)
Seat 2: Nutsfit ($678.59 in chips)
Seat 3: magorko ($1046.20 in chips)
Seat 4: supbigdiaper ($653.80 in chips)
Seat 5: Yaaaazz ($550.02 in chips)
Seat 6: sacachispa19 ($525.80 in chips)
sacachispa19: posts small blind $2.50
Rabarber77: posts big blind $5
*** HOLE CARDS ***
Nutsfit: folds
magorko: folds
supbigdiaper: folds
Yaaaazz: raises $7.50 to $12.50
sacachispa19: folds
Rabarber77: calls $7.50
*** FLOP *** [9h Td 4s]
Rabarber77: checks
Yaaaazz: checks
*** TURN *** [9h Td 4s] [5d]
Rabarber77: bets $15
Yaaaazz: folds
Uncalled bet ($15) returned to Rabarber77
Rabarber77 collected $26.12 from pot
Rabarber77: doesn't show hand
*** SUMMARY ***
Total pot $27.50 | Rake $1.38
Board [9h Td 4s 5d]
Seat 1: Rabarber77 (big blind) collected ($26.12)
Seat 2: Nutsfit folded before Flop (didn't bet)
Seat 3: magorko folded before Flop (didn't bet)
Seat 4: supbigdiaper folded before Flop (didn't bet)
Seat 5: Yaaaazz (button) folded on the Turn
Seat 6: sacachispa19 (small blind) folded before Flop


PokerStars Hand #222985141232:  Hold'em No Limit ($2.50/$5.00 USD) - 2021/01/23 23:03:54 ET
Table 'Aaltje II' 6-max Seat #6 is the button
Seat 1: Rabarber77 ($1892.22 in chips)
Seat 2: Nutsfit ($678.59 in chips)
Seat 3: magorko ($1046.20 in chips)
Seat 4: supbigdiaper ($653.80 in chips)
Seat 5: Yaaaazz ($537.52 in chips)
Seat 6: sacachispa19 ($523.30 in chips)
Rabarber77: posts small blind $2.50
Nutsfit: posts big blind $5
*** HOLE CARDS ***
magorko: folds
supbigdiaper: raises $7.50 to $12.50
Yaaaazz: folds
sacachispa19: folds
Rabarber77: folds
Nutsfit: folds
Uncalled bet ($7.50) returned to supbigdiaper
supbigdiaper collected $12.50 from pot
supbigdiaper: doesn't show hand
*** SUMMARY ***
Total pot $12.50 | Rake $0
Seat 1: Rabarber77 (small blind) folded before Flop
Seat 2: Nutsfit (big blind) folded before Flop
Seat 3: magorko folded before Flop (didn't bet)
Seat 4: supbigdiaper collected ($12.50)
Seat 5: Yaaaazz folded before Flop (didn't bet)
Seat 6: sacachispa19 (button) folded before Flop (didn't bet)


PokerStars Hand #222985144851:  Hold'em No Limit ($2.50/$5.00 USD) - 2021/01/23 23:04:06 ET
Table 'Aaltje II' 6-max Seat #1 is the button
Seat 1: Rabarber77 ($1889.72 in chips)
Seat 2: Nutsfit ($673.59 in chips)
Seat 3: magorko ($1046.20 in chips)
Seat 4: supbigdiaper ($661.30 in chips)
Seat 5: Yaaaazz ($537.52 in chips)
Seat 6: sacachispa19 ($523.30 in chips)
Nutsfit: posts small blind $2.50
magorko: posts big blind $5
*** HOLE CARDS ***
supbigdiaper: folds
Yaaaazz: folds
sacachispa19: folds
Rabarber77: raises $10 to $15
Nutsfit: folds
magorko: folds
Uncalled bet ($10) returned to Rabarber77
Rabarber77 collected $12.50 from pot
Rabarber77: doesn't show hand
*** SUMMARY ***
Total pot $12.50 | Rake $0
Seat 1: Rabarber77 (button) collected ($12.50)
Seat 2: Nutsfit (small blind) folded before Flop
Seat 3: magorko (big blind) folded before Flop
Seat 4: supbigdiaper folded before Flop (didn't bet)
Seat 5: Yaaaazz folded before Flop (didn't bet)
Seat 6: sacachispa19 folded before Flop (didn't bet)


PokerStars Hand #222985156470:  Hold'em No Limit ($2.50/$5.00 USD) - 2021/01/23 23:04:43 ET
Table 'Aaltje II' 6-max Seat #2 is the button
Seat 1: Rabarber77 ($1897.22 in chips)
Seat 2: Nutsfit ($671.09 in chips)
Seat 3: magorko ($1041.20 in chips)
Seat 4: supbigdiaper ($661.30 in chips)
Seat 5: Yaaaazz ($537.52 in chips)
Seat 6: sacachispa19 ($523.30 in chips)
magorko: posts small blind $2.50
supbigdiaper: posts big blind $5
*** HOLE CARDS ***
Yaaaazz: folds
sacachispa19: folds
Rabarber77: raises $10 to $15
Nutsfit: folds
magorko: raises $45 to $60
supbigdiaper: folds
Rabarber77: calls $45
*** FLOP *** [Qh Qd Ts]
magorko: bets $95.15
Rabarber77: calls $95.15
*** TURN *** [Qh Qd Ts] [7d]
magorko: bets $252.80
Rabarber77: folds
Uncalled bet ($252.80) returned to magorko
magorko collected $312.30 from pot
magorko: doesn't show hand
*** SUMMARY ***
Total pot $315.30 | Rake $3
Board [Qh Qd Ts 7d]
Seat 1: Rabarber77 folded on the Turn
Seat 2: Nutsfit (button) folded before Flop (didn't bet)
Seat 3: magorko (small blind) collected ($312.30)
Seat 4: supbigdiaper (big blind) folded before Flop
Seat 5: Yaaaazz folded before Flop (didn't bet)
Seat 6: sacachispa19 folded before Flop (didn't bet)


PokerStars Hand #222985173887:  Hold'em No Limit ($2.50/$5.00 USD) - 2021/01/23 23:05:39 ET
Table 'Aaltje II' 6-max Seat #3 is the button
Seat 1: Rabarber77 ($1742.07 in chips)
Seat 2: Nutsfit ($671.09 in chips)
Seat 3: magorko ($1198.35 in chips)
Seat 4: supbigdiaper ($656.30 in chips)
Seat 5: Yaaaazz ($537.52 in chips)
Seat 6: sacachispa19 ($523.30 in chips)
supbigdiaper: posts small blind $2.50
Yaaaazz: posts big blind $5
*** HOLE CARDS ***
sacachispa19: raises $7.50 to $12.50
Rabarber77: folds
Nutsfit: folds
magorko: folds
supbigdiaper: folds
Yaaaazz: raises $52.50 to $65
sacachispa19: folds
Uncalled bet ($52.50) returned to Yaaaazz
Yaaaazz collected $27.50 from pot
Yaaaazz: doesn't show hand
*** SUMMARY ***
Total pot $27.50 | Rake $0
Seat 1: Rabarber77 folded before Flop (didn't bet)
Seat 2: Nutsfit folded before Flop (didn't bet)
Seat 3: magorko (button) folded before Flop (didn't bet)
Seat 4: supbigdiaper (small blind) folded before Flop
Seat 5: Yaaaazz (big blind) collected ($27.50)
Seat 6: sacachispa19 folded before Flop


PokerStars Hand #222985181333:  Hold'em No Limit ($2.50/$5.00 USD) - 2021/01/23 23:06:03 ET
Table 'Aaltje II' 6-max Seat #4 is the button
Seat 1: Rabarber77 ($1742.07 in chips)
Seat 2: Nutsfit ($671.09 in chips)
Seat 3: magorko ($1198.35 in chips)
Seat 4: supbigdiaper ($653.80 in chips)
Seat 5: Yaaaazz ($552.52 in chips)
Seat 6: sacachispa19 ($510.80 in chips)
Yaaaazz: posts small blind $2.50
sacachispa19: posts big blind $5
*** HOLE CARDS ***
Rabarber77: raises $10 to $15
Nutsfit: folds
magorko: folds
supbigdiaper: folds
Yaaaazz: raises $50 to $65
sacachispa19: folds
Rabarber77: calls $50
*** FLOP *** [Qc Jd Jh]
Yaaaazz: bets $43.56
Rabarber77: calls $43.56
*** TURN *** [Qc Jd Jh] [2c]
Yaaaazz: bets $72.31
Rabarber77: calls $72.31
*** RIVER *** [Qc Jd Jh 2c] [9c]
Yaaaazz: bets $120.03
Rabarber77: calls $120.03
*** SHOW DOWN ***
Yaaaazz: shows [Ad Ac] (two pair, Aces and Jacks)
Rabarber77: mucks hand
Yaaaazz collected $603.80 from pot
*** SUMMARY ***
Total pot $606.80 | Rake $3
Board [Qc Jd Jh 2c 9c]
Seat 1: Rabarber77 mucked
Seat 2: Nutsfit folded before Flop (didn't bet)
Seat 3: magorko folded before Flop (didn't bet)
Seat 4: supbigdiaper (button) folded before Flop (didn't bet)
Seat 5: Yaaaazz (small blind) showed [Ad Ac] and won ($603.80) with two pair, Aces and Jacks
Seat 6: sacachispa19 (big blind) folded before Flop


PokerStars Hand #222985202453:  Hold'em No Limit ($2.50/$5.00 USD) - 2021/01/23 23:06:48 ET
Table 'Aaltje II' 6-max Seat #5 is the button
Seat 1: Rabarber77 ($1441.17 in chips)
Seat 2: Nutsfit ($671.09 in chips)
Seat 3: magorko ($1198.35 in chips)
Seat 4: supbigdiaper ($653.80 in chips)
Seat 5: Yaaaazz ($855.42 in chips)
Seat 6: sacachispa19 ($505.80 in chips)
sacachispa19: posts small blind $2.50
Rabarber77: posts big blind $5
*** HOLE CARDS ***
Nutsfit: folds
magorko: folds
supbigdiaper: folds
Yaaaazz: folds
sacachispa19: raises $7.50 to $12.50
Rabarber77: folds
Uncalled bet ($7.50) returned to sacachispa19
sacachispa19 collected $10 from pot
sacachispa19: doesn't show hand
*** SUMMARY ***
Total pot $10 | Rake $0
Seat 1: Rabarber77 (big blind) folded before Flop
Seat 2: Nutsfit folded before Flop (didn't bet)
Seat 3: magorko folded before Flop (didn't bet)
Seat 4: supbigdiaper folded before Flop (didn't bet)
Seat 5: Yaaaazz (button) folded before Flop (didn't bet)
Seat 6: sacachispa19 (small blind) collected ($10)


PokerStars Hand #222985210652:  Hold'em No Limit ($2.50/$5.00 USD) - 2021/01/23 23:07:15 ET
Table 'Aaltje II' 6-max Seat #6 is the button
Seat 1: Rabarber77 ($1436.17 in chips)
Seat 2: Nutsfit ($671.09 in chips)
Seat 3: magorko ($1198.35 in chips)
Seat 4: supbigdiaper ($653.80 in chips)
Seat 5: Yaaaazz ($855.42 in chips)
Seat 6: sacachispa19 ($510.80 in chips)
Rabarber77: posts small blind $2.50
Nutsfit: posts big blind $5
*** HOLE CARDS ***
magorko: folds
supbigdiaper: folds
Yaaaazz: folds
sacachispa19: raises $7.50 to $12.50
Rabarber77: raises $32.50 to $45
Nutsfit: folds
sacachispa19: folds
Uncalled bet ($32.50) returned to Rabarber77
Rabarber77 collected $30 from pot
Rabarber77: doesn't show hand
*** SUMMARY ***
Total pot $30 | Rake $0
Seat 1: Rabarber77 (small blind) collected ($30)
Seat 2: Nutsfit (big blind) folded before Flop
Seat 3: magorko folded before Flop (didn't bet)
Seat 4: supbigdiaper folded before Flop (didn't bet)
Seat 5: Yaaaazz folded before Flop (didn't bet)
Seat 6: sacachispa19 (button) folded before Flop


PokerStars Hand #222985218994:  Hold'em No Limit ($2.50/$5.00 USD) - 2021/01/23 23:07:42 ET
Table 'Aaltje II' 6-max Seat #1 is the button
Seat 1: Rabarber77 ($1453.67 in chips)
Seat 2: Nutsfit ($666.09 in chips)
Seat 3: magorko ($1198.35 in chips)
Seat 4: supbigdiaper ($653.80 in chips)
Seat 5: Yaaaazz ($855.42 in chips)
Seat 6: sacachispa19 ($500 in chips)
Nutsfit: posts small blind $2.50
magorko: posts big blind $5
*** HOLE CARDS ***
supbigdiaper: folds
Yaaaazz: folds
sacachispa19: raises $7.50 to $12.50
Rabarber77: calls $12.50
Nutsfit: folds
magorko: calls $7.50
*** FLOP *** [6d 9d 4d]
magorko: checks
sacachispa19: checks
Rabarber77: bets $19
magorko: folds
sacachispa19: folds
Uncalled bet ($19) returned to Rabarber77
Rabarber77 collected $38 from pot
Rabarber77: doesn't show hand
*** SUMMARY ***
Total pot $40 | Rake $2
Board [6d 9d 4d]
Seat 1: Rabarber77 (button) collected ($38)
Seat 2: Nutsfit (small blind) folded before Flop
Seat 3: magorko (big blind) folded on the Flop
Seat 4: supbigdiaper folded before Flop (didn't bet)
Seat 5: Yaaaazz folded before Flop (didn't bet)
Seat 6: sacachispa19 folded on the Flop


PokerStars Hand #222985230097:  Hold'em No Limit ($2.50/$5.00 USD) - 2021/01/23 23:08:19 ET
Table 'Aaltje II' 6-max Seat #2 is the button
Seat 1: Rabarber77 ($1479.17 in chips)
Seat 2: Nutsfit ($663.59 in chips)
Seat 3: magorko ($1185.85 in chips)
Seat 4: supbigdiaper ($653.80 in chips)
Seat 5: Yaaaazz ($855.42 in chips)
Seat 6: sacachispa19 ($500 in chips)
magorko: posts small blind $2.50
supbigdiaper: posts big blind $5
*** HOLE CARDS ***
Yaaaazz: folds
sacachispa19: folds
Rabarber77: raises $10 to $15
Nutsfit: folds
magorko: folds
supbigdiaper: calls $10
*** FLOP *** [Jd Jc 7s]
supbigdiaper: checks
Rabarber77: bets $20
supbigdiaper: folds
Uncalled bet ($20) returned to Rabarber77
Rabarber77 collected $30.88 from pot
Rabarber77: doesn't show hand
*** SUMMARY ***
Total pot $32.50 | Rake $1.62
Board [Jd Jc 7s]
Seat 1: Rabarber77 collected ($30.88)
Seat 2: Nutsfit (button) folded before Flop (didn't bet)
Seat 3: magorko (small blind) folded before Flop
Seat 4: supbigdiaper (big blind) folded on the Flop
Seat 5: Yaaaazz folded before Flop (didn't bet)
Seat 6: sacachispa19 folded before Flop (didn't bet)


PokerStars Hand #222985239002:  Hold'em No Limit ($2.50/$5.00 USD) - 2021/01/23 23:08:48 ET
Table 'Aaltje II' 6-max Seat #3 is the button
Seat 1: Rabarber77 ($1495.05 in chips)
Seat 2: Nutsfit ($663.59 in chips)
Seat 3: magorko ($1183.35 in chips)
Seat 4: supbigdiaper ($638.80 in chips)
Seat 5: Yaaaazz ($855.42 in chips)
Seat 6: sacachispa19 ($500 in chips)
supbigdiaper: posts small blind $2.50
Yaaaazz: posts big blind $5
*** HOLE CARDS ***
sacachispa19: folds
Rabarber77: raises $10 to $15
Nutsfit: raises $30 to $45
magorko: folds
supbigdiaper: folds
Yaaaazz: folds
Rabarber77: calls $30
*** FLOP *** [Qd 5s Ah]
Rabarber77: checks
Nutsfit: checks
*** TURN *** [Qd 5s Ah] [8h]
Rabarber77: bets $47.25
Nutsfit: calls $47.25
*** RIVER *** [Qd 5s Ah 8h] [5d]
Rabarber77: checks
Nutsfit: checks
*** SHOW DOWN ***
Rabarber77: shows [Td Js] (a pair of Fives)
Nutsfit: shows [Kc Qc] (two pair, Queens and Fives)
Nutsfit collected $189 from pot
*** SUMMARY ***
Total pot $192 | Rake $3
Board [Qd 5s Ah 8h 5d]
Seat 1: Rabarber77 showed [Td Js] and lost with a pair of Fives
Seat 2: Nutsfit showed [Kc Qc] and won ($189) with two pair, Queens and Fives
Seat 3: magorko (button) folded before Flop (didn't bet)
Seat 4: supbigdiaper (small blind) folded before Flop
Seat 5: Yaaaazz (big blind) folded before Flop
Seat 6: sacachispa19 folded before Flop (didn't bet)


PokerStars Hand #222985254423:  Hold'em No Limit ($2.50/$5.00 USD) - 2021/01/23 23:09:38 ET
Table 'Aaltje II' 6-max Seat #4 is the button
Seat 1: Rabarber77 ($1402.80 in chips)
Seat 2: Nutsfit ($760.34 in chips)
Seat 3: magorko ($1183.35 in chips)
Seat 4: supbigdiaper ($636.30 in chips)
Seat 5: Yaaaazz ($850.42 in chips)
Seat 6: sacachispa19 ($500 in chips)
Yaaaazz: posts small blind $2.50
sacachispa19: posts big blind $5
*** HOLE CARDS ***
Rabarber77: folds
Nutsfit: folds
magorko: raises $7.50 to $12.50
supbigdiaper: folds
Yaaaazz: folds
sacachispa19: folds
Uncalled bet ($7.50) returned to magorko
magorko collected $12.50 from pot
magorko: doesn't show hand
*** SUMMARY ***
Total pot $12.50 | Rake $0
Seat 1: Rabarber77 folded before Flop (didn't bet)
Seat 2: Nutsfit folded before Flop (didn't bet)
Seat 3: magorko collected ($12.50)
Seat 4: supbigdiaper (button) folded before Flop (didn't bet)
Seat 5: Yaaaazz (small blind) folded before Flop
Seat 6: sacachispa19 (big blind) folded before Flop


PokerStars Hand #222985260110:  Hold'em No Limit ($2.50/$5.00 USD) - 2021/01/23 23:09:57 ET
Table 'Aaltje II' 6-max Seat #5 is the button
Seat 1: Rabarber77 ($1402.80 in chips)
Seat 2: Nutsfit ($760.34 in chips)
Seat 3: magorko ($1190.85 in chips)
Seat 4: supbigdiaper ($636.30 in chips)
Seat 5: Yaaaazz ($847.92 in chips)
Seat 6: sacachispa19 ($500 in chips)
sacachispa19: posts small blind $2.50
Rabarber77: posts big blind $5
*** HOLE CARDS ***
Nutsfit: folds
magorko: folds
supbigdiaper: raises $7.50 to $12.50
Yaaaazz: folds
sacachispa19: folds
Rabarber77: calls $7.50
*** FLOP *** [Jh Ts 8h]
Rabarber77: checks
supbigdiaper: bets $8.62
Rabarber77: folds
Uncalled bet ($8.62) returned to supbigdiaper
supbigdiaper collected $26.12 from pot
supbigdiaper: doesn't show hand
*** SUMMARY ***
Total pot $27.50 | Rake $1.38
Board [Jh Ts 8h]
Seat 1: Rabarber77 (big blind) folded on the Flop
Seat 2: Nutsfit folded before Flop (didn't bet)
Seat 3: magorko folded before Flop (didn't bet)
Seat 4: supbigdiaper collected ($26.12)
Seat 5: Yaaaazz (button) folded before Flop (didn't bet)
Seat 6: sacachispa19 (small blind) folded before Flop


PokerStars Hand #222985265440:  Hold'em No Limit ($2.50/$5.00 USD) - 2021/01/23 23:10:14 ET
Table 'Aaltje II' 6-max Seat #6 is the button
Seat 1: Rabarber77 ($1390.30 in chips)
Seat 2: Nutsfit ($760.34 in chips)
Seat 3: magorko ($1190.85 in chips)
Seat 4: supbigdiaper ($649.92 in chips)
Seat 5: Yaaaazz ($847.92 in chips)
Seat 6: sacachispa19 ($500 in chips)
Rabarber77: posts small blind $2.50
Nutsfit: posts big blind $5
*** HOLE CARDS ***
magorko: raises $7.50 to $12.50
supbigdiaper: folds
Yaaaazz: folds
sacachispa19: calls $12.50
Rabarber77: folds
Nutsfit: folds
*** FLOP *** [8h 5d Ts]
magorko: checks
sacachispa19: checks
*** TURN *** [8h 5d Ts] [9h]
magorko: bets $23.16
sacachispa19: raises $54.34 to $77.50
magorko: folds
Uncalled bet ($54.34) returned to sacachispa19
sacachispa19 collected $75.82 from pot
sacachispa19: doesn't show hand
*** SUMMARY ***
Total pot $78.82 | Rake $3
Board [8h 5d Ts 9h]
Seat 1: Rabarber77 (small blind) folded before Flop
Seat 2: Nutsfit (big blind) folded before Flop
Seat 3: magorko folded on the Turn
Seat 4: supbigdiaper folded before Flop (didn't bet)
Seat 5: Yaaaazz folded before Flop (didn't bet)
Seat 6: sacachispa19 (button) collected ($75.82)


PokerStars Hand #222985279236:  Hold'em No Limit ($2.50/$5.00 USD) - 2021/01/23 23:11:00 ET
Table 'Aaltje II' 6-max Seat #1 is the button
Seat 1: Rabarber77 ($1387.80 in chips)
Seat 2: Nutsfit ($755.34 in chips)
Seat 3: magorko ($1155.19 in chips)
Seat 4: supbigdiaper ($649.92 in chips)
Seat 5: Yaaaazz ($847.92 in chips)
Seat 6: sacachispa19 ($540.16 in chips)
Nutsfit: posts small blind $2.50
magorko: posts big blind $5
*** HOLE CARDS ***
supbigdiaper: folds
Yaaaazz: folds
sacachispa19: folds
Rabarber77: folds
Nutsfit: folds
Uncalled bet ($2.50) returned to magorko
magorko collected $5 from pot
magorko: doesn't show hand
*** SUMMARY ***
Total pot $5 | Rake $0
Seat 1: Rabarber77 (button) folded before Flop (didn't bet)
Seat 2: Nutsfit (small blind) folded before Flop
Seat 3: magorko (big blind) collected ($5)
Seat 4: supbigdiaper folded before Flop (didn't bet)
Seat 5: Yaaaazz folded before Flop (didn't bet)
Seat 6: sacachispa19 folded before Flop (didn't bet)


PokerStars Hand #222985282237:  Hold'em No Limit ($2.50/$5.00 USD) - 2021/01/23 23:11:10 ET
Table 'Aaltje II' 6-max Seat #2 is the button
Seat 1: Rabarber77 ($1387.80 in chips)
Seat 2: Nutsfit ($752.84 in chips)
Seat 3: magorko ($1157.69 in chips)
Seat 4: supbigdiaper ($649.92 in chips)
Seat 5: Yaaaazz ($847.92 in chips)
Seat 6: sacachispa19 ($540.16 in chips)
magorko: posts small blind $2.50
supbigdiaper: posts big blind $5
*** HOLE CARDS ***
Yaaaazz: folds
sacachispa19: folds
Rabarber77: folds
Nutsfit: folds
magorko: raises $7.50 to $12.50
supbigdiaper: folds
Uncalled bet ($7.50) returned to magorko
magorko collected $10 from pot
magorko: doesn't show hand
*** SUMMARY ***
Total pot $10 | Rake $0
Seat 1: Rabarber77 folded before Flop (didn't bet)
Seat 2: Nutsfit (button) folded before Flop (didn't bet)
Seat 3: magorko (small blind) collected ($10)
Seat 4: supbigdiaper (big blind) folded before Flop
Seat 5: Yaaaazz folded before Flop (didn't bet)
Seat 6: sacachispa19 folded before Flop (didn't bet)


PokerStars Hand #222985291343:  Hold'em No Limit ($2.50/$5.00 USD) - 2021/01/23 23:11:40 ET
Table 'Aaltje II' 6-max Seat #3 is the button
Seat 1: Rabarber77 ($1387.80 in chips)
Seat 2: Nutsfit ($752.84 in chips)
Seat 3: magorko ($1162.69 in chips)
Seat 4: supbigdiaper ($644.92 in chips)
Seat 5: Yaaaazz ($847.92 in chips)
Seat 6: sacachispa19 ($540.16 in chips)
supbigdiaper: posts small blind $2.50
Yaaaazz: posts big blind $5
*** HOLE CARDS ***
sacachispa19: raises $7.50 to $12.50
Rabarber77: folds
Nutsfit: folds
magorko: folds
supbigdiaper: folds
Yaaaazz: folds
Uncalled bet ($7.50) returned to sacachispa19
sacachispa19 collected $12.50 from pot
sacachispa19: doesn't show hand
*** SUMMARY ***
Total pot $12.50 | Rake $0
Seat 1: Rabarber77 folded before Flop (didn't bet)
Seat 2: Nutsfit folded before Flop (didn't bet)
Seat 3: magorko (button) folded before Flop (didn't bet)
Seat 4: supbigdiaper (small blind) folded before Flop
Seat 5: Yaaaazz (big blind) folded before Flop
Seat 6: sacachispa19 collected ($12.50)


PokerStars Hand #222985296976:  Hold'em No Limit ($2.50/$5.00 USD) - 2021/01/23 23:11:58 ET
Table 'Aaltje II' 6-max Seat #4 is the button
Seat 1: Rabarber77 ($1387.80 in chips)
Seat 2: Nutsfit ($752.84 in chips)
Seat 3: magorko ($1162.69 in chips)
Seat 4: supbigdiaper ($642.42 in chips)
Seat 5: Yaaaazz ($842.92 in chips)
Seat 6: sacachispa19 ($547.66 in chips)
Yaaaazz: posts small blind $2.50
sacachispa19: posts big blind $5
*** HOLE CARDS ***
Rabarber77: raises $10 to $15
Nutsfit: folds
magorko: folds
supbigdiaper: folds
Yaaaazz: folds
sacachispa19: folds
Uncalled bet ($10) returned to Rabarber77
Rabarber77 collected $12.50 from pot
Rabarber77: doesn't show hand
*** SUMMARY ***
Total pot $12.50 | Rake $0
Seat 1: Rabarber77 collected ($12.50)
Seat 2: Nutsfit folded before Flop (didn't bet)
Seat 3: magorko folded before Flop (didn't bet)
Seat 4: supbigdiaper (button) folded before Flop (didn't bet)
Seat 5: Yaaaazz (small blind) folded before Flop
Seat 6: sacachispa19 (big blind) folded before Flop


PokerStars Hand #222985304447:  Hold'em No Limit ($2.50/$5.00 USD) - 2021/01/23 23:12:23 ET
Table 'Aaltje II' 6-max Seat #5 is the button
Seat 1: Rabarber77 ($1395.30 in chips)
Seat 2: Nutsfit ($752.84 in chips)
Seat 3: magorko ($1162.69 in chips)
Seat 4: supbigdiaper ($642.42 in chips)
Seat 5: Yaaaazz ($840.42 in chips)
Seat 6: sacachispa19 ($542.66 in chips)
sacachispa19: posts small blind $2.50
Rabarber77: posts big blind $5
*** HOLE CARDS ***
Nutsfit: raises $5.90 to $10.90
magorko: folds
supbigdiaper: folds
Yaaaazz: folds
sacachispa19: folds
Rabarber77: raises $39.10 to $50
Nutsfit: calls $39.10
*** FLOP *** [6h Qh 6d]
Rabarber77: bets $70
Nutsfit: calls $70
*** TURN *** [6h Qh 6d] [Js]
Rabarber77: bets $130
Nutsfit: folds
Uncalled bet ($130) returned to Rabarber77
Rabarber77 collected $239.50 from pot
Rabarber77: doesn't show hand
*** SUMMARY ***
Total pot $242.50 | Rake $3
Board [6h Qh 6d Js]
Seat 1: Rabarber77 (big blind) collected ($239.50)
Seat 2: Nutsfit folded on the Turn
Seat 3: magorko folded before Flop (didn't bet)
Seat 4: supbigdiaper folded before Flop (didn't bet)
Seat 5: Yaaaazz (button) folded before Flop (didn't bet)
Seat 6: sacachispa19 (small blind) folded before Flop


PokerStars Hand #222985321713:  Hold'em No Limit ($2.50/$5.00 USD) - 2021/01/23 23:13:20 ET
Table 'Aaltje II' 6-max Seat #6 is the button
Seat 1: Rabarber77 ($1514.80 in chips)
Seat 2: Nutsfit ($632.84 in chips)
Seat 3: magorko ($1162.69 in chips)
Seat 4: supbigdiaper ($642.42 in chips)
Seat 5: Yaaaazz ($840.42 in chips)
Seat 6: sacachispa19 ($540.16 in chips)
Rabarber77: posts small blind $2.50
Nutsfit: posts big blind $5
*** HOLE CARDS ***
magorko: raises $7.50 to $12.50
supbigdiaper: folds
Yaaaazz: folds
sacachispa19: folds
Rabarber77: folds
Nutsfit: folds
Uncalled bet ($7.50) returned to magorko
magorko collected $12.50 from pot
magorko: doesn't show hand
*** SUMMARY ***
Total pot $12.50 | Rake $0
Seat 1: Rabarber77 (small blind) folded before Flop
Seat 2: Nutsfit (big blind) folded before Flop
Seat 3: magorko collected ($12.50)
Seat 4: supbigdiaper folded before Flop (didn't bet)
Seat 5: Yaaaazz folded before Flop (didn't bet)
Seat 6: sacachispa19 (button) folded before Flop (didn't bet)


PokerStars Hand #222985325245:  Hold'em No Limit ($2.50/$5.00 USD) - 2021/01/23 23:13:31 ET
Table 'Aaltje II' 6-max Seat #1 is the button
Seat 1: Rabarber77 ($1512.30 in chips)
Seat 2: Nutsfit ($627.84 in chips)
Seat 3: magorko ($1170.19 in chips)
Seat 4: supbigdiaper ($642.42 in chips)
Seat 5: Yaaaazz ($840.42 in chips)
Seat 6: sacachispa19 ($540.16 in chips)
Nutsfit: posts small blind $2.50
magorko: posts big blind $5
*** HOLE CARDS ***
supbigdiaper: folds
Yaaaazz: folds
sacachispa19: folds
Rabarber77: raises $10 to $15
Nutsfit: folds
magorko: calls $10
*** FLOP *** [6s 3c 4d]
magorko: checks
Rabarber77: bets $20
magorko: calls $20
*** TURN *** [6s 3c 4d] [2d]
magorko: bets $56.20
Rabarber77: raises $56.20 to $112.40
magorko: calls $56.20
*** RIVER *** [6s 3c 4d 2d] [9s]
magorko: checks
Rabarber77: checks
*** SHOW DOWN ***
magorko: shows [5d 6d] (a straight, Deuce to Six)
Rabarber77: mucks hand
magorko collected $294.30 from pot
*** SUMMARY ***
Total pot $297.30 | Rake $3
Board [6s 3c 4d 2d 9s]
Seat 1: Rabarber77 (button) mucked
Seat 2: Nutsfit (small blind) folded before Flop
Seat 3: magorko (big blind) showed [5d 6d] and won ($294.30) with a straight, Deuce to Six
Seat 4: supbigdiaper folded before Flop (didn't bet)
Seat 5: Yaaaazz folded before Flop (didn't bet)
Seat 6: sacachispa19 folded before Flop (didn't bet)


PokerStars Hand #222985344224:  Hold'em No Limit ($2.50/$5.00 USD) - 2021/01/23 23:14:34 ET
Table 'Aaltje II' 6-max Seat #2 is the button
Seat 1: Rabarber77 ($1364.90 in chips)
Seat 2: Nutsfit ($625.34 in chips)
Seat 3: magorko ($1317.09 in chips)
Seat 4: supbigdiaper ($642.42 in chips)
Seat 5: Yaaaazz ($840.42 in chips)
Seat 6: sacachispa19 ($540.16 in chips)
magorko: posts small blind $2.50
supbigdiaper: posts big blind $5
*** HOLE CARDS ***
Yaaaazz: folds
sacachispa19: raises $7.50 to $12.50
Rabarber77: folds
Nutsfit: folds
magorko: folds
supbigdiaper: folds
Uncalled bet ($7.50) returned to sacachispa19
sacachispa19 collected $12.50 from pot
sacachispa19: doesn't show hand
*** SUMMARY ***
Total pot $12.50 | Rake $0
Seat 1: Rabarber77 folded before Flop (didn't bet)
Seat 2: Nutsfit (button) folded before Flop (didn't bet)
Seat 3: magorko (small blind) folded before Flop
Seat 4: supbigdiaper (big blind) folded before Flop
Seat 5: Yaaaazz folded before Flop (didn't bet)
Seat 6: sacachispa19 collected ($12.50)


PokerStars Hand #222985349822:  Hold'em No Limit ($2.50/$5.00 USD) - 2021/01/23 23:14:53 ET
Table 'Aaltje II' 6-max Seat #3 is the button
Seat 1: Rabarber77 ($1364.90 in chips)
Seat 2: Nutsfit ($625.34 in chips)
Seat 3: magorko ($1314.59 in chips)
Seat 4: supbigdiaper ($637.42 in chips)
Seat 5: Yaaaazz ($840.42 in chips)
Seat 6: sacachispa19 ($547.66 in chips)
supbigdiaper: posts small blind $2.50
Yaaaazz: posts big blind $5
*** HOLE CARDS ***
sacachispa19: folds
Rabarber77: folds
Nutsfit: folds
magorko: raises $7.50 to $12.50
supbigdiaper: folds
Yaaaazz: calls $7.50
*** FLOP *** [As Qh 2s]
Yaaaazz: checks
magorko: bets $50
Yaaaazz: folds
Uncalled bet ($50) returned to magorko
magorko collected $26.12 from pot
magorko: doesn't show hand
*** SUMMARY ***
Total pot $27.50 | Rake $1.38
Board [As Qh 2s]
Seat 1: Rabarber77 folded before Flop (didn't bet)
Seat 2: Nutsfit folded before Flop (didn't bet)
Seat 3: magorko (button) collected ($26.12)
Seat 4: supbigdiaper (small blind) folded before Flop
Seat 5: Yaaaazz (big blind) folded on the Flop
Seat 6: sacachispa19 folded before Flop (didn't bet)


PokerStars Hand #222985364487:  Hold'em No Limit ($2.50/$5.00 USD) - 2021/01/23 23:15:41 ET
Table 'Aaltje II' 6-max Seat #4 is the button
Seat 1: Rabarber77 ($1364.90 in chips)
Seat 2: Nutsfit ($625.34 in chips)
Seat 3: magorko ($1328.21 in chips)
Seat 4: supbigdiaper ($634.92 in chips)
Seat 5: Yaaaazz ($827.92 in chips)
Yaaaazz: posts small blind $2.50
Rabarber77: posts big blind $5
*** HOLE CARDS ***
Nutsfit: folds
magorko: raises $7.50 to $12.50
supbigdiaper: folds
Yaaaazz: raises $42.50 to $55
Rabarber77: folds
magorko: calls $42.50
*** FLOP *** [2d 5d Jc]
Yaaaazz: bets $36.96
magorko: calls $36.96
*** TURN *** [2d 5d Jc] [Jd]
Yaaaazz: checks
magorko: checks
*** RIVER *** [2d 5d Jc Jd] [Tc]
Yaaaazz: checks
magorko: checks
*** SHOW DOWN ***
Yaaaazz: shows [Ah 5h] (two pair, Jacks and Fives)
magorko: mucks hand
Yaaaazz collected $185.92 from pot
*** SUMMARY ***
Total pot $188.92 | Rake $3
Board [2d 5d Jc Jd Tc]
Seat 1: Rabarber77 (big blind) folded before Flop
Seat 2: Nutsfit folded before Flop (didn't bet)
Seat 3: magorko mucked
Seat 4: supbigdiaper (button) folded before Flop (didn't bet)
Seat 5: Yaaaazz (small blind) showed [Ah 5h] and won ($185.92) with two pair, Jacks and Fives


PokerStars Hand #222985387580:  Hold'em No Limit ($2.50/$5.00 USD) - 2021/01/23 23:16:56 ET
Table 'Aaltje II' 6-max Seat #1 is the button
Seat 1: Rabarber77 ($1357.40 in chips)
Seat 2: Nutsfit ($620.34 in chips)
Seat 3: magorko ($1236.25 in chips)
Seat 4: supbigdiaper ($642.42 in chips)
Seat 5: Yaaaazz ($921.88 in chips)
Nutsfit: posts small blind $2.50
magorko: posts big blind $5
*** HOLE CARDS ***
supbigdiaper: folds
Yaaaazz: folds
Rabarber77: folds
Nutsfit: folds
Uncalled bet ($2.50) returned to magorko
magorko collected $5 from pot
magorko: doesn't show hand
*** SUMMARY ***
Total pot $5 | Rake $0
Seat 1: Rabarber77 (button) folded before Flop (didn't bet)
Seat 2: Nutsfit (small blind) folded before Flop
Seat 3: magorko (big blind) collected ($5)
Seat 4: supbigdiaper folded before Flop (didn't bet)
Seat 5: Yaaaazz folded before Flop (didn't bet)


PokerStars Hand #222985380488:  Hold'em No Limit ($2.50/$5.00 USD) - 2021/01/23 23:16:33 ET
Table 'Aaltje II' 6-max Seat #5 is the button
Seat 1: Rabarber77 ($1359.90 in chips)
Seat 2: Nutsfit ($625.34 in chips)
Seat 3: magorko ($1236.25 in chips)
Seat 4: supbigdiaper ($634.92 in chips)
Seat 5: Yaaaazz ($921.88 in chips)
Rabarber77: posts small blind $2.50
Nutsfit: posts big blind $5
*** HOLE CARDS ***
magorko: folds
supbigdiaper: raises $7.50 to $12.50
Yaaaazz: folds
Rabarber77: folds
Nutsfit: folds
Uncalled bet ($7.50) returned to supbigdiaper
supbigdiaper collected $12.50 from pot
supbigdiaper: doesn't show hand
*** SUMMARY ***
Total pot $12.50 | Rake $0
Seat 1: Rabarber77 (small blind) folded before Flop
Seat 2: Nutsfit (big blind) folded before Flop
Seat 3: magorko folded before Flop (didn't bet)
Seat 4: supbigdiaper collected ($12.50)
Seat 5: Yaaaazz (button) folded before Flop (didn't bet)


PokerStars Hand #222985389995:  Hold'em No Limit ($2.50/$5.00 USD) - 2021/01/23 23:17:04 ET
Table 'Aaltje II' 6-max Seat #2 is the button
Seat 1: Rabarber77 ($1357.40 in chips)
Seat 2: Nutsfit ($617.84 in chips)
Seat 3: magorko ($1238.75 in chips)
Seat 4: supbigdiaper ($642.42 in chips)
Seat 5: Yaaaazz ($921.88 in chips)
magorko: posts small blind $2.50
supbigdiaper: posts big blind $5
*** HOLE CARDS ***
Yaaaazz: folds
Rabarber77: raises $10 to $15
Nutsfit: folds
magorko: folds
supbigdiaper: calls $10
*** FLOP *** [4c Ad 2h]
supbigdiaper: checks
Rabarber77: bets $20
supbigdiaper: folds
Uncalled bet ($20) returned to Rabarber77
Rabarber77 collected $30.88 from pot
Rabarber77: doesn't show hand
*** SUMMARY ***
Total pot $32.50 | Rake $1.62
Board [4c Ad 2h]
Seat 1: Rabarber77 collected ($30.88)
Seat 2: Nutsfit (button) folded before Flop (didn't bet)
Seat 3: magorko (small blind) folded before Flop
Seat 4: supbigdiaper (big blind) folded on the Flop
Seat 5: Yaaaazz folded before Flop (didn't bet)


PokerStars Hand #222985398343:  Hold'em No Limit ($2.50/$5.00 USD) - 2021/01/23 23:17:32 ET
Table 'Aaltje II' 6-max Seat #3 is the button
Seat 1: Rabarber77 ($1373.28 in chips)
Seat 2: Nutsfit ($617.84 in chips)
Seat 3: magorko ($1236.25 in chips)
Seat 4: supbigdiaper ($627.42 in chips)
Seat 5: Yaaaazz ($921.88 in chips)
supbigdiaper: posts small blind $2.50
Yaaaazz: posts big blind $5
*** HOLE CARDS ***
Rabarber77: raises $10 to $15
Nutsfit: folds
magorko: calls $15
supbigdiaper: folds
Yaaaazz: folds
*** FLOP *** [8c Kh Ac]
Rabarber77: bets $30
magorko: calls $30
*** TURN *** [8c Kh Ac] [Js]
Rabarber77: bets $50
magorko: folds
Uncalled bet ($50) returned to Rabarber77
Rabarber77 collected $94.50 from pot
Rabarber77: doesn't show hand
*** SUMMARY ***
Total pot $97.50 | Rake $3
Board [8c Kh Ac Js]
Seat 1: Rabarber77 collected ($94.50)
Seat 2: Nutsfit folded before Flop (didn't bet)
Seat 3: magorko (button) folded on the Turn
Seat 4: supbigdiaper (small blind) folded before Flop
Seat 5: Yaaaazz (big blind) folded before Flop


PokerStars Hand #222985410574:  Hold'em No Limit ($2.50/$5.00 USD) - 2021/01/23 23:18:12 ET
Table 'Aaltje II' 6-max Seat #4 is the button
Seat 1: Rabarber77 ($1422.78 in chips)
Seat 2: Nutsfit ($617.84 in chips)
Seat 3: magorko ($1191.25 in chips)
Seat 4: supbigdiaper ($624.92 in chips)
Seat 5: Yaaaazz ($916.88 in chips)
Yaaaazz: posts small blind $2.50
Rabarber77: posts big blind $5
*** HOLE CARDS ***
Nutsfit: folds
magorko: folds
supbigdiaper: raises $7.50 to $12.50
Yaaaazz: folds
Rabarber77: calls $7.50
*** FLOP *** [Ks Ah Qs]
Rabarber77: checks
supbigdiaper: checks
*** TURN *** [Ks Ah Qs] [As]
Rabarber77: checks
supbigdiaper: checks
*** RIVER *** [Ks Ah Qs As] [2d]
Rabarber77: bets $26.12
supbigdiaper: calls $26.12
*** SHOW DOWN ***
Rabarber77: shows [Ad 9d] (three of a kind, Aces)
supbigdiaper: mucks hand
Rabarber77 collected $76.74 from pot
*** SUMMARY ***
Total pot $79.74 | Rake $3
Board [Ks Ah Qs As 2d]
Seat 1: Rabarber77 (big blind) showed [Ad 9d] and won ($76.74) with three of a kind, Aces
Seat 2: Nutsfit folded before Flop (didn't bet)
Seat 3: magorko folded before Flop (didn't bet)
Seat 4: supbigdiaper (button) mucked
Seat 5: Yaaaazz (small blind) folded before Flop


PokerStars Hand #222985418550:  Hold'em No Limit ($2.50/$5.00 USD) - 2021/01/23 23:18:37 ET
Table 'Aaltje II' 6-max Seat #5 is the button
Seat 1: Rabarber77 ($1460.90 in chips)
Seat 2: Nutsfit ($617.84 in chips)
Seat 3: magorko ($1191.25 in chips)
Seat 4: supbigdiaper ($586.30 in chips)
Seat 5: Yaaaazz ($914.38 in chips)
Rabarber77: posts small blind $2.50
Nutsfit: posts big blind $5
*** HOLE CARDS ***
magorko: folds
supbigdiaper: raises $7.50 to $12.50
Yaaaazz: folds
Rabarber77: calls $10
Nutsfit: calls $7.50
*** FLOP *** [2d 5d 3s]
Rabarber77: bets $35.62
Nutsfit: folds
supbigdiaper: raises $80.15 to $115.77
Rabarber77: raises $1332.63 to $1448.40 and is all-in
supbigdiaper: calls $458.03 and is all-in
Uncalled bet ($874.60) returned to Rabarber77
*** TURN *** [2d 5d 3s] [5c]
*** RIVER *** [2d 5d 3s 5c] [2s]
*** SHOW DOWN ***
Rabarber77: shows [Ad 4h] (a straight, Ace to Five)
supbigdiaper: shows [4s Ah] (a straight, Ace to Five)
Rabarber77 collected $591.05 from pot
supbigdiaper collected $591.05 from pot
*** SUMMARY ***
Total pot $1185.10 | Rake $3
Board [2d 5d 3s 5c 2s]
Seat 1: Rabarber77 (small blind) showed [Ad 4h] and won ($591.05) with a straight, Ace to Five
Seat 2: Nutsfit (big blind) folded on the Flop
Seat 3: magorko folded before Flop (didn't bet)
Seat 4: supbigdiaper showed [4s Ah] and won ($591.05) with a straight, Ace to Five
Seat 5: Yaaaazz (button) folded before Flop (didn't bet)


PokerStars Hand #222985433724:  Hold'em No Limit ($2.50/$5.00 USD) - 2021/01/23 23:19:25 ET
Table 'Aaltje II' 6-max Seat #1 is the button
Seat 1: Rabarber77 ($1465.65 in chips)
Seat 2: Nutsfit ($605.34 in chips)
Seat 3: magorko ($1191.25 in chips)
Seat 4: supbigdiaper ($591.05 in chips)
Seat 5: Yaaaazz ($914.38 in chips)
Nutsfit: posts small blind $2.50
magorko: posts big blind $5
*** HOLE CARDS ***
supbigdiaper: folds
Yaaaazz: folds
Rabarber77: raises $10 to $15
Nutsfit: folds
magorko: raises $45 to $60
Rabarber77: calls $45
*** FLOP *** [2c 4s 4h]
magorko: bets $59.75
Rabarber77: raises $119.50 to $179.25
magorko: folds
Uncalled bet ($119.50) returned to Rabarber77
Rabarber77 collected $239 from pot
Rabarber77: doesn't show hand
*** SUMMARY ***
Total pot $242 | Rake $3
Board [2c 4s 4h]
Seat 1: Rabarber77 (button) collected ($239)
Seat 2: Nutsfit (small blind) folded before Flop
Seat 3: magorko (big blind) folded on the Flop
Seat 4: supbigdiaper folded before Flop (didn't bet)
Seat 5: Yaaaazz folded before Flop (didn't bet)


PokerStars Hand #222985445007:  Hold'em No Limit ($2.50/$5.00 USD) - 2021/01/23 23:20:02 ET
Table 'Aaltje II' 6-max Seat #2 is the button
Seat 1: Rabarber77 ($1584.90 in chips)
Seat 2: Nutsfit ($602.84 in chips)
Seat 3: magorko ($1071.50 in chips)
Seat 4: supbigdiaper ($591.05 in chips)
Seat 5: Yaaaazz ($914.38 in chips)
magorko: posts small blind $2.50
supbigdiaper: posts big blind $5
*** HOLE CARDS ***
Yaaaazz: folds
Rabarber77: raises $10 to $15
Nutsfit: folds
magorko: folds
supbigdiaper: calls $10
*** FLOP *** [4d 2h 7c]
supbigdiaper: checks
Rabarber77: bets $15.44
supbigdiaper: folds
Uncalled bet ($15.44) returned to Rabarber77
Rabarber77 collected $30.88 from pot
Rabarber77: doesn't show hand
*** SUMMARY ***
Total pot $32.50 | Rake $1.62
Board [4d 2h 7c]
Seat 1: Rabarber77 collected ($30.88)
Seat 2: Nutsfit (button) folded before Flop (didn't bet)
Seat 3: magorko (small blind) folded before Flop
Seat 4: supbigdiaper (big blind) folded on the Flop
Seat 5: Yaaaazz folded before Flop (didn't bet)


PokerStars Hand #222985454970:  Hold'em No Limit ($2.50/$5.00 USD) - 2021/01/23 23:20:36 ET
Table 'Aaltje II' 6-max Seat #3 is the button
Seat 1: Rabarber77 ($1600.78 in chips)
Seat 2: Nutsfit ($602.84 in chips)
Seat 3: magorko ($1069 in chips)
Seat 4: supbigdiaper ($576.05 in chips)
Seat 5: Yaaaazz ($914.38 in chips)
supbigdiaper: posts small blind $2.50
Yaaaazz: posts big blind $5
*** HOLE CARDS ***
Rabarber77: raises $10 to $15
Nutsfit: folds
magorko: folds
supbigdiaper: calls $12.50
Yaaaazz: folds
*** FLOP *** [Js 6c 2d]
supbigdiaper: checks
Rabarber77: bets $16.63
supbigdiaper: calls $16.63
*** TURN *** [Js 6c 2d] [Qs]
supbigdiaper: checks
Rabarber77: bets $32.63
supbigdiaper: folds
Uncalled bet ($32.63) returned to Rabarber77
Rabarber77 collected $65.26 from pot
Rabarber77: doesn't show hand
*** SUMMARY ***
Total pot $68.26 | Rake $3
Board [Js 6c 2d Qs]
Seat 1: Rabarber77 collected ($65.26)
Seat 2: Nutsfit folded before Flop (didn't bet)
Seat 3: magorko (button) folded before Flop (didn't bet)
Seat 4: supbigdiaper (small blind) folded on the Turn
Seat 5: Yaaaazz (big blind) folded before Flop


PokerStars Hand #222985474686:  Hold'em No Limit ($2.50/$5.00 USD) - 2021/01/23 23:21:10 ET
Table 'Aaltje II' 6-max Seat #4 is the button
Seat 1: Rabarber77 ($1634.41 in chips)
Seat 2: Nutsfit ($602.84 in chips)
Seat 3: magorko ($1069 in chips)
Seat 4: supbigdiaper ($544.42 in chips)
Seat 5: Yaaaazz ($909.38 in chips)
Yaaaazz: posts small blind $2.50
Rabarber77: posts big blind $5
*** HOLE CARDS ***
Nutsfit: folds
magorko: folds
supbigdiaper: folds
Yaaaazz has timed out
Yaaaazz: folds
Uncalled bet ($2.50) returned to Rabarber77
Rabarber77 collected $5 from pot
Rabarber77: doesn't show hand
*** SUMMARY ***
Total pot $5 | Rake $0
Seat 1: Rabarber77 (big blind) collected ($5)
Seat 2: Nutsfit folded before Flop (didn't bet)
Seat 3: magorko folded before Flop (didn't bet)
Seat 4: supbigdiaper (button) folded before Flop (didn't bet)
Seat 5: Yaaaazz (small blind) folded before Flop


PokerStars Hand #222985489280:  Hold'em No Limit ($2.50/$5.00 USD) - 2021/01/23 23:21:58 ET
Table 'Aaltje II' 6-max Seat #5 is the button
Seat 1: Rabarber77 ($1636.91 in chips)
Seat 3: magorko ($1069 in chips)
Seat 4: supbigdiaper ($544.42 in chips)
Seat 5: Yaaaazz ($906.88 in chips)
Rabarber77: posts small blind $2.50
Nutsfit: is sitting out
magorko: posts big blind $5
*** HOLE CARDS ***
supbigdiaper: folds
Yaaaazz: folds
Rabarber77: folds
Uncalled bet ($2.50) returned to magorko
magorko collected $5 from pot
magorko: doesn't show hand
*** SUMMARY ***
Total pot $5 | Rake $0
Seat 1: Rabarber77 (small blind) folded before Flop
Seat 3: magorko (big blind) collected ($5)
Seat 4: supbigdiaper folded before Flop (didn't bet)
Seat 5: Yaaaazz (button) folded before Flop (didn't bet)


PokerStars Hand #222985491089:  Hold'em No Limit ($2.50/$5.00 USD) - 2021/01/23 23:22:04 ET
Table 'Aaltje II' 6-max Seat #1 is the button
Seat 1: Rabarber77 ($1634.41 in chips)
Seat 3: magorko ($1071.50 in chips)
Seat 4: supbigdiaper ($544.42 in chips)
Seat 5: Yaaaazz ($906.88 in chips)
magorko: posts small blind $2.50
supbigdiaper: posts big blind $5
*** HOLE CARDS ***
Yaaaazz: folds
Rabarber77: raises $10 to $15
magorko: folds
supbigdiaper: calls $10
*** FLOP *** [3d Kh Ks]
supbigdiaper: checks
Rabarber77: bets $30
supbigdiaper: folds
Uncalled bet ($30) returned to Rabarber77
Rabarber77 collected $31 from pot
Rabarber77: doesn't show hand
*** SUMMARY ***
Total pot $32.50 | Rake $1.50
Board [3d Kh Ks]
Seat 1: Rabarber77 (button) collected ($31)
Seat 3: magorko (small blind) folded before Flop
Seat 4: supbigdiaper (big blind) folded on the Flop
Seat 5: Yaaaazz folded before Flop (didn't bet)


PokerStars Hand #222985504329:  Hold'em No Limit ($2.50/$5.00 USD) - 2021/01/23 23:22:48 ET
Table 'Aaltje II' 6-max Seat #3 is the button
Seat 1: Rabarber77 ($1650.41 in chips)
Seat 3: magorko ($1069 in chips)
Seat 4: supbigdiaper ($529.42 in chips)
Seat 5: Yaaaazz ($906.88 in chips)
supbigdiaper: posts small blind $2.50
Yaaaazz: posts big blind $5
sacachispa19: sits out
*** HOLE CARDS ***
Rabarber77: folds
magorko: raises $7.50 to $12.50
supbigdiaper: folds
Yaaaazz: folds
Uncalled bet ($7.50) returned to magorko
magorko collected $12.50 from pot
magorko: doesn't show hand
*** SUMMARY ***
Total pot $12.50 | Rake $0
Seat 1: Rabarber77 folded before Flop (didn't bet)
Seat 3: magorko (button) collected ($12.50)
Seat 4: supbigdiaper (small blind) folded before Flop
Seat 5: Yaaaazz (big blind) folded before Flop


PokerStars Hand #222985507081:  Hold'em No Limit ($2.50/$5.00 USD) - 2021/01/23 23:22:58 ET
Table 'Aaltje II' 6-max Seat #4 is the button
Seat 1: Rabarber77 ($1650.41 in chips)
Seat 3: magorko ($1076.50 in chips)
Seat 4: supbigdiaper ($526.92 in chips)
Seat 5: Yaaaazz ($901.88 in chips)
Seat 6: sacachispa19 ($547.66 in chips)
Yaaaazz: posts small blind $2.50
sacachispa19: posts big blind $5
*** HOLE CARDS ***
Rabarber77: raises $10 to $15
magorko: folds
supbigdiaper: folds
Yaaaazz: folds
sacachispa19: folds
Uncalled bet ($10) returned to Rabarber77
Rabarber77 collected $12.50 from pot
Rabarber77: doesn't show hand
*** SUMMARY ***
Total pot $12.50 | Rake $0
Seat 1: Rabarber77 collected ($12.50)
Seat 3: magorko folded before Flop (didn't bet)
Seat 4: supbigdiaper (button) folded before Flop (didn't bet)
Seat 5: Yaaaazz (small blind) folded before Flop
Seat 6: sacachispa19 (big blind) folded before Flop


PokerStars Hand #222985510226:  Hold'em No Limit ($2.50/$5.00 USD) - 2021/01/23 23:23:08 ET
Table 'Aaltje II' 6-max Seat #5 is the button
Seat 1: Rabarber77 ($1657.91 in chips)
Seat 3: magorko ($1076.50 in chips)
Seat 4: supbigdiaper ($526.92 in chips)
Seat 5: Yaaaazz ($899.38 in chips)
Seat 6: sacachispa19 ($542.66 in chips)
sacachispa19: posts small blind $2.50
Rabarber77: posts big blind $5
*** HOLE CARDS ***
magorko: folds
supbigdiaper: folds
Yaaaazz: folds
sacachispa19: folds
Uncalled bet ($2.50) returned to Rabarber77
Rabarber77 collected $5 from pot
Rabarber77: doesn't show hand
*** SUMMARY ***
Total pot $5 | Rake $0
Seat 1: Rabarber77 (big blind) collected ($5)
Seat 3: magorko folded before Flop (didn't bet)
Seat 4: supbigdiaper folded before Flop (didn't bet)
Seat 5: Yaaaazz (button) folded before Flop (didn't bet)
Seat 6: sacachispa19 (small blind) folded before Flop


PokerStars Hand #222985512904:  Hold'em No Limit ($2.50/$5.00 USD) - 2021/01/23 23:23:17 ET
Table 'Aaltje II' 6-max Seat #6 is the button
Seat 1: Rabarber77 ($1660.41 in chips)
Seat 3: magorko ($1076.50 in chips)
Seat 4: supbigdiaper ($526.92 in chips)
Seat 5: Yaaaazz ($899.38 in chips)
Seat 6: sacachispa19 ($540.16 in chips)
Rabarber77: posts small blind $2.50
magorko: posts big blind $5
*** HOLE CARDS ***
supbigdiaper: folds
Yaaaazz: folds
sacachispa19: folds
Rabarber77: folds
Uncalled bet ($2.50) returned to magorko
magorko collected $5 from pot
magorko: doesn't show hand
*** SUMMARY ***
Total pot $5 | Rake $0
Seat 1: Rabarber77 (small blind) folded before Flop
Seat 3: magorko (big blind) collected ($5)
Seat 4: supbigdiaper folded before Flop (didn't bet)
Seat 5: Yaaaazz folded before Flop (didn't bet)
Seat 6: sacachispa19 (button) folded before Flop (didn't bet)


PokerStars Hand #222985517405:  Hold'em No Limit ($2.50/$5.00 USD) - 2021/01/23 23:23:32 ET
Table 'Aaltje II' 6-max Seat #1 is the button
Seat 1: Rabarber77 ($1657.91 in chips)
Seat 3: magorko ($1079 in chips)
Seat 4: supbigdiaper ($526.92 in chips)
Seat 5: Yaaaazz ($899.38 in chips)
Seat 6: sacachispa19 ($540.16 in chips)
magorko: posts small blind $2.50
supbigdiaper: posts big blind $5
*** HOLE CARDS ***
Yaaaazz: folds
sacachispa19: folds
Rabarber77: raises $10 to $15
magorko: folds
supbigdiaper: raises $48.75 to $63.75
Rabarber77: calls $48.75
*** FLOP *** [As 3h Ac]
supbigdiaper: checks
Rabarber77: checks
*** TURN *** [As 3h Ac] [Qd]
supbigdiaper: checks
Rabarber77: bets $63.50
supbigdiaper: calls $63.50
*** RIVER *** [As 3h Ac Qd] [Qs]
supbigdiaper: checks
Rabarber77: bets $254
supbigdiaper: raises $145.67 to $399.67 and is all-in
Rabarber77: calls $145.67
*** SHOW DOWN ***
supbigdiaper: shows [Ad Th] (a full house, Aces full of Queens)
Rabarber77: shows [Ah 5h] (a full house, Aces full of Queens)
supbigdiaper collected $526.67 from pot
Rabarber77 collected $526.67 from pot
*** SUMMARY ***
Total pot $1056.34 | Rake $3
Board [As 3h Ac Qd Qs]
Seat 1: Rabarber77 (button) showed [Ah 5h] and won ($526.67) with a full house, Aces full of Queens
Seat 3: magorko (small blind) folded before Flop
Seat 4: supbigdiaper (big blind) showed [Ad Th] and won ($526.67) with a full house, Aces full of Queens
Seat 5: Yaaaazz folded before Flop (didn't bet)
Seat 6: sacachispa19 folded before Flop (didn't bet)


PokerStars Hand #222985534703:  Hold'em No Limit ($2.50/$5.00 USD) - 2021/01/23 23:24:30 ET
Table 'Aaltje II' 6-max Seat #3 is the button
Seat 1: Rabarber77 ($1657.66 in chips)
Seat 3: magorko ($1076.50 in chips)
Seat 4: supbigdiaper ($526.67 in chips)
Seat 5: Yaaaazz ($899.38 in chips)
Seat 6: sacachispa19 ($540.16 in chips)
supbigdiaper: posts small blind $2.50
Yaaaazz: posts big blind $5
*** HOLE CARDS ***
sacachispa19: folds
Rabarber77: raises $10 to $15
magorko: folds
supbigdiaper: calls $12.50
Yaaaazz: folds
*** FLOP *** [6d 7d 3c]
supbigdiaper: checks
Rabarber77: bets $16.63
supbigdiaper: folds
Uncalled bet ($16.63) returned to Rabarber77
Rabarber77 collected $33.25 from pot
Rabarber77: doesn't show hand
*** SUMMARY ***
Total pot $35 | Rake $1.75
Board [6d 7d 3c]
Seat 1: Rabarber77 collected ($33.25)
Seat 3: magorko (button) folded before Flop (didn't bet)
Seat 4: supbigdiaper (small blind) folded on the Flop
Seat 5: Yaaaazz (big blind) folded before Flop
Seat 6: sacachispa19 folded before Flop (didn't bet)


PokerStars Hand #222985545687:  Hold'em No Limit ($2.50/$5.00 USD) - 2021/01/23 23:25:07 ET
Table 'Aaltje II' 6-max Seat #4 is the button
Seat 1: Rabarber77 ($1675.91 in chips)
Seat 3: magorko ($1076.50 in chips)
Seat 4: supbigdiaper ($511.67 in chips)
Seat 5: Yaaaazz ($894.38 in chips)
Seat 6: sacachispa19 ($540.16 in chips)
Yaaaazz: posts small blind $2.50
sacachispa19: posts big blind $5
*** HOLE CARDS ***
Rabarber77: folds
magorko: folds
supbigdiaper: raises $7.50 to $12.50
Yaaaazz: folds
sacachispa19: folds
Uncalled bet ($7.50) returned to supbigdiaper
supbigdiaper collected $12.50 from pot
supbigdiaper: doesn't show hand
*** SUMMARY ***
Total pot $12.50 | Rake $0
Seat 1: Rabarber77 folded before Flop (didn't bet)
Seat 3: magorko folded before Flop (didn't bet)
Seat 4: supbigdiaper (button) collected ($12.50)
Seat 5: Yaaaazz (small blind) folded before Flop
Seat 6: sacachispa19 (big blind) folded before Flop


PokerStars Hand #222985551910:  Hold'em No Limit ($2.50/$5.00 USD) - 2021/01/23 23:25:28 ET
Table 'Aaltje II' 6-max Seat #5 is the button
Seat 1: Rabarber77 ($1675.91 in chips)
Seat 3: magorko ($1076.50 in chips)
Seat 4: supbigdiaper ($519.17 in chips)
Seat 5: Yaaaazz ($891.88 in chips)
Seat 6: sacachispa19 ($535.16 in chips)
sacachispa19: posts small blind $2.50
Rabarber77: posts big blind $5
*** HOLE CARDS ***
magorko: folds
supbigdiaper: raises $7.50 to $12.50
Yaaaazz: calls $12.50
sacachispa19: folds
Rabarber77: raises $52.50 to $65
supbigdiaper: calls $52.50
Yaaaazz: calls $52.50
*** FLOP *** [Kc 5d Jd]
Rabarber77: bets $115
supbigdiaper: folds
Yaaaazz: folds
Uncalled bet ($115) returned to Rabarber77
Rabarber77 collected $194.50 from pot
Rabarber77: doesn't show hand
*** SUMMARY ***
Total pot $197.50 | Rake $3
Board [Kc 5d Jd]
Seat 1: Rabarber77 (big blind) collected ($194.50)
Seat 3: magorko folded before Flop (didn't bet)
Seat 4: supbigdiaper folded on the Flop
Seat 5: Yaaaazz (button) folded on the Flop
Seat 6: sacachispa19 (small blind) folded before Flop


PokerStars Hand #222985567921:  Hold'em No Limit ($2.50/$5.00 USD) - 2021/01/23 23:26:23 ET
Table 'Aaltje II' 6-max Seat #6 is the button
Seat 1: Rabarber77 ($1805.41 in chips)
Seat 3: magorko ($1076.50 in chips)
Seat 4: supbigdiaper ($500 in chips)
Seat 5: Yaaaazz ($826.88 in chips)
Seat 6: sacachispa19 ($532.66 in chips)
Rabarber77: posts small blind $2.50
magorko: posts big blind $5
*** HOLE CARDS ***
supbigdiaper: folds
Yaaaazz: raises $6.25 to $11.25
sacachispa19: folds
Rabarber77: calls $8.75
magorko: calls $6.25
*** FLOP *** [2d 5c 4d]
Rabarber77: checks
magorko: checks
Yaaaazz: bets $25.65
Rabarber77: calls $25.65
magorko: folds
*** TURN *** [2d 5c 4d] [Kd]
Rabarber77: checks
Yaaaazz: bets $27.08
Rabarber77: calls $27.08
*** RIVER *** [2d 5c 4d Kd] [Jh]
Rabarber77: checks
Yaaaazz: checks
*** SHOW DOWN ***
Rabarber77: shows [6s 4s] (a pair of Fours)
Yaaaazz: shows [Qs Qd] (a pair of Queens)
Yaaaazz collected $136.21 from pot
*** SUMMARY ***
Total pot $139.21 | Rake $3
Board [2d 5c 4d Kd Jh]
Seat 1: Rabarber77 (small blind) showed [6s 4s] and lost with a pair of Fours
Seat 3: magorko (big blind) folded on the Flop
Seat 4: supbigdiaper folded before Flop (didn't bet)
Seat 5: Yaaaazz showed [Qs Qd] and won ($136.21) with a pair of Queens
Seat 6: sacachispa19 (button) folded before Flop (didn't bet)


PokerStars Hand #222985579176:  Hold'em No Limit ($2.50/$5.00 USD) - 2021/01/23 23:27:01 ET
Table 'Aaltje II' 6-max Seat #1 is the button
Seat 1: Rabarber77 ($1741.43 in chips)
Seat 3: magorko ($1065.25 in chips)
Seat 4: supbigdiaper ($500 in chips)
Seat 5: Yaaaazz ($899.11 in chips)
Seat 6: sacachispa19 ($532.66 in chips)
magorko: posts small blind $2.50
supbigdiaper: posts big blind $5
*** HOLE CARDS ***
Yaaaazz: folds
sacachispa19: raises $7.50 to $12.50
Rabarber77: folds
magorko: folds
supbigdiaper: calls $7.50
*** FLOP *** [8c Th 9s]
supbigdiaper: checks
sacachispa19: checks
*** TURN *** [8c Th 9s] [Ts]
supbigdiaper: checks
sacachispa19: bets $12.50
supbigdiaper: folds
Uncalled bet ($12.50) returned to sacachispa19
sacachispa19 collected $26.12 from pot
sacachispa19: doesn't show hand
*** SUMMARY ***
Total pot $27.50 | Rake $1.38
Board [8c Th 9s Ts]
Seat 1: Rabarber77 (button) folded before Flop (didn't bet)
Seat 3: magorko (small blind) folded before Flop
Seat 4: supbigdiaper (big blind) folded on the Turn
Seat 5: Yaaaazz folded before Flop (didn't bet)
Seat 6: sacachispa19 collected ($26.12)


PokerStars Hand #222985590710:  Hold'em No Limit ($2.50/$5.00 USD) - 2021/01/23 23:27:41 ET
Table 'Aaltje II' 6-max Seat #3 is the button
Seat 1: Rabarber77 ($1741.43 in chips)
Seat 3: magorko ($1062.75 in chips)
Seat 4: supbigdiaper ($500 in chips)
Seat 5: Yaaaazz ($899.11 in chips)
Seat 6: sacachispa19 ($546.28 in chips)
supbigdiaper: posts small blind $2.50
Yaaaazz: posts big blind $5
*** HOLE CARDS ***
sacachispa19 has timed out
sacachispa19: folds
Rabarber77: folds
magorko: raises $7.50 to $12.50
supbigdiaper: folds
Yaaaazz: folds
Uncalled bet ($7.50) returned to magorko
magorko collected $12.50 from pot
magorko: doesn't show hand
*** SUMMARY ***
Total pot $12.50 | Rake $0
Seat 1: Rabarber77 folded before Flop (didn't bet)
Seat 3: magorko (button) collected ($12.50)
Seat 4: supbigdiaper (small blind) folded before Flop
Seat 5: Yaaaazz (big blind) folded before Flop
Seat 6: sacachispa19 folded before Flop (didn't bet)


PokerStars Hand #222985599460:  Hold'em No Limit ($2.50/$5.00 USD) - 2021/01/23 23:28:11 ET
Table 'Aaltje II' 6-max Seat #4 is the button
Seat 1: Rabarber77 ($1741.43 in chips)
Seat 3: magorko ($1070.25 in chips)
Seat 4: supbigdiaper ($500 in chips)
Seat 5: Yaaaazz ($894.11 in chips)
Seat 6: sacachispa19 ($546.28 in chips)
Yaaaazz: posts small blind $2.50
sacachispa19: posts big blind $5
*** HOLE CARDS ***
Rabarber77: raises $10 to $15
magorko: folds
supbigdiaper: folds
Yaaaazz: folds
sacachispa19: folds
Uncalled bet ($10) returned to Rabarber77
Rabarber77 collected $12.50 from pot
Rabarber77: doesn't show hand
*** SUMMARY ***
Total pot $12.50 | Rake $0
Seat 1: Rabarber77 collected ($12.50)
Seat 3: magorko folded before Flop (didn't bet)
Seat 4: supbigdiaper (button) folded before Flop (didn't bet)
Seat 5: Yaaaazz (small blind) folded before Flop
Seat 6: sacachispa19 (big blind) folded before Flop


PokerStars Hand #222985611723:  Hold'em No Limit ($2.50/$5.00 USD) - 2021/01/23 23:28:54 ET
Table 'Aaltje II' 6-max Seat #6 is the button
Seat 1: Rabarber77 ($1762.55 in chips)
Seat 3: magorko ($1070.25 in chips)
Seat 4: supbigdiaper ($500 in chips)
Seat 5: Yaaaazz ($891.61 in chips)
Seat 6: sacachispa19 ($538.78 in chips)
Rabarber77: posts small blind $2.50
magorko: posts big blind $5
*** HOLE CARDS ***
supbigdiaper: folds
Yaaaazz: folds
sacachispa19: folds
Rabarber77: folds
Uncalled bet ($2.50) returned to magorko
magorko collected $5 from pot
Nutsfit was removed from the table for failing to post
Nutsfit leaves the table
magorko: doesn't show hand
*** SUMMARY ***
Total pot $5 | Rake $0
Seat 1: Rabarber77 (small blind) folded before Flop
Seat 3: magorko (big blind) collected ($5)
Seat 4: supbigdiaper folded before Flop (didn't bet)
Seat 5: Yaaaazz folded before Flop (didn't bet)
Seat 6: sacachispa19 (button) folded before Flop (didn't bet)


PokerStars Hand #222985603025:  Hold'em No Limit ($2.50/$5.00 USD) - 2021/01/23 23:28:24 ET
Table 'Aaltje II' 6-max Seat #5 is the button
Seat 1: Rabarber77 ($1748.93 in chips)
Seat 3: magorko ($1070.25 in chips)
Seat 4: supbigdiaper ($500 in chips)
Seat 5: Yaaaazz ($891.61 in chips)
Seat 6: sacachispa19 ($541.28 in chips)
sacachispa19: posts small blind $2.50
Rabarber77: posts big blind $5
*** HOLE CARDS ***
magorko: folds
supbigdiaper: raises $7.50 to $12.50
Yaaaazz: folds
sacachispa19: folds
Rabarber77: calls $7.50
*** FLOP *** [8d 4c 9h]
Rabarber77: checks
supbigdiaper: checks
*** TURN *** [8d 4c 9h] [5s]
Rabarber77: bets $13.06
supbigdiaper: folds
Uncalled bet ($13.06) returned to Rabarber77
Rabarber77 collected $26.12 from pot
Rabarber77: doesn't show hand
*** SUMMARY ***
Total pot $27.50 | Rake $1.38
Board [8d 4c 9h 5s]
Seat 1: Rabarber77 (big blind) collected ($26.12)
Seat 3: magorko folded before Flop (didn't bet)
Seat 4: supbigdiaper folded on the Turn
Seat 5: Yaaaazz (button) folded before Flop (didn't bet)
Seat 6: sacachispa19 (small blind) folded before Flop


PokerStars Hand #222985613598:  Hold'em No Limit ($2.50/$5.00 USD) - 2021/01/23 23:29:00 ET
Table 'Aaltje II' 6-max Seat #1 is the button
Seat 1: Rabarber77 ($1760.05 in chips)
Seat 3: magorko ($1072.75 in chips)
Seat 4: supbigdiaper ($500 in chips)
Seat 5: Yaaaazz ($891.61 in chips)
Seat 6: sacachispa19 ($538.78 in chips)
magorko: posts small blind $2.50
supbigdiaper: posts big blind $5
*** HOLE CARDS ***
Yaaaazz: folds
sacachispa19: raises $7.50 to $12.50
Rabarber77: raises $22.50 to $35
magorko: folds
supbigdiaper: folds
sacachispa19: calls $22.50
*** FLOP *** [Ks Ts 2h]
RAidakCo joins the table at seat #2
sacachispa19: checks
Rabarber77: bets $45
sacachispa19: folds
Uncalled bet ($45) returned to Rabarber77
Rabarber77 collected $74.50 from pot
Rabarber77: doesn't show hand
*** SUMMARY ***
Total pot $77.50 | Rake $3
Board [Ks Ts 2h]
Seat 1: Rabarber77 (button) collected ($74.50)
Seat 3: magorko (small blind) folded before Flop
Seat 4: supbigdiaper (big blind) folded before Flop
Seat 5: Yaaaazz folded before Flop (didn't bet)
Seat 6: sacachispa19 folded on the Flop


PokerStars Hand #222985620343:  Hold'em No Limit ($2.50/$5.00 USD) - 2021/01/23 23:29:23 ET
Table 'Aaltje II' 6-max Seat #3 is the button
Seat 1: Rabarber77 ($1799.55 in chips)
Seat 3: magorko ($1070.25 in chips)
Seat 4: supbigdiaper ($500 in chips)
Seat 5: Yaaaazz ($891.61 in chips)
Seat 6: sacachispa19 ($503.78 in chips)
supbigdiaper: posts small blind $2.50
Yaaaazz: posts big blind $5
RAidakCo: sits out
*** HOLE CARDS ***
sacachispa19: raises $7.50 to $12.50
Rabarber77: folds
magorko: folds
supbigdiaper: folds
Yaaaazz: folds
Uncalled bet ($7.50) returned to sacachispa19
sacachispa19 collected $12.50 from pot
sacachispa19: doesn't show hand
*** SUMMARY ***
Total pot $12.50 | Rake $0
Seat 1: Rabarber77 folded before Flop (didn't bet)
Seat 3: magorko (button) folded before Flop (didn't bet)
Seat 4: supbigdiaper (small blind) folded before Flop
Seat 5: Yaaaazz (big blind) folded before Flop
Seat 6: sacachispa19 collected ($12.50)


PokerStars Hand #222985625051:  Hold'em No Limit ($2.50/$5.00 USD) - 2021/01/23 23:29:40 ET
Table 'Aaltje II' 6-max Seat #4 is the button
Seat 1: Rabarber77 ($1799.55 in chips)
Seat 3: magorko ($1070.25 in chips)
Seat 4: supbigdiaper ($500 in chips)
Seat 5: Yaaaazz ($886.61 in chips)
Yaaaazz: posts small blind $2.50
sacachispa19: is sitting out
Rabarber77: posts big blind $5
sacachispa19 leaves the table
RAidakCo: sits out
*** HOLE CARDS ***
magorko: folds
supbigdiaper: raises $7.50 to $12.50
Yaaaazz: folds
Rabarber77: folds
Uncalled bet ($7.50) returned to supbigdiaper
supbigdiaper collected $12.50 from pot
supbigdiaper: doesn't show hand
*** SUMMARY ***
Total pot $12.50 | Rake $0
Seat 1: Rabarber77 (big blind) folded before Flop
Seat 3: magorko folded before Flop (didn't bet)
Seat 4: supbigdiaper (button) collected ($12.50)
Seat 5: Yaaaazz (small blind) folded before Flop


PokerStars Hand #222985627624:  Hold'em No Limit ($2.50/$5.00 USD) - 2021/01/23 23:29:49 ET
Table 'Aaltje II' 6-max Seat #5 is the button
Seat 1: Rabarber77 ($1794.55 in chips)
Seat 2: RAidakCo ($500 in chips)
Seat 3: magorko ($1070.25 in chips)
Seat 4: supbigdiaper ($507.50 in chips)
Seat 5: Yaaaazz ($884.11 in chips)
Rabarber77: posts small blind $2.50
RAidakCo: posts big blind $5
*** HOLE CARDS ***
Nutsfit joins the table at seat #6
magorko: folds
supbigdiaper: folds
Yaaaazz: folds
Rabarber77: folds
Uncalled bet ($2.50) returned to RAidakCo
RAidakCo collected $5 from pot
RAidakCo: doesn't show hand
*** SUMMARY ***
Total pot $5 | Rake $0
Seat 1: Rabarber77 (small blind) folded before Flop
Seat 2: RAidakCo (big blind) collected ($5)
Seat 3: magorko folded before Flop (didn't bet)
Seat 4: supbigdiaper folded before Flop (didn't bet)
Seat 5: Yaaaazz (button) folded before Flop (didn't bet)


PokerStars Hand #222985629363:  Hold'em No Limit ($2.50/$5.00 USD) - 2021/01/23 23:29:55 ET
Table 'Aaltje II' 6-max Seat #1 is the button
Seat 1: Rabarber77 ($1792.05 in chips)
Seat 2: RAidakCo ($502.50 in chips)
Seat 3: magorko ($1070.25 in chips)
Seat 4: supbigdiaper ($507.50 in chips)
Seat 5: Yaaaazz ($884.11 in chips)
RAidakCo: posts small blind $2.50
magorko: posts big blind $5
Nutsfit: sits out
*** HOLE CARDS ***
supbigdiaper: folds
Yaaaazz: folds
Rabarber77: raises $10 to $15
RAidakCo: raises $45 to $60
magorko: folds
Rabarber77: calls $45
*** FLOP *** [7h Qh 6h]
RAidakCo: checks
Rabarber77: checks
*** TURN *** [7h Qh 6h] [Jh]
RAidakCo: checks
Rabarber77: bets $61
RAidakCo: calls $61
*** RIVER *** [7h Qh 6h Jh] [Qc]
RAidakCo: checks
Rabarber77: checks
*** SHOW DOWN ***
RAidakCo: shows [As Qs] (three of a kind, Queens)
Rabarber77: shows [Th Ks] (a flush, Queen high)
Rabarber77 collected $244 from pot
*** SUMMARY ***
Total pot $247 | Rake $3
Board [7h Qh 6h Jh Qc]
Seat 1: Rabarber77 (button) showed [Th Ks] and won ($244) with a flush, Queen high
Seat 2: RAidakCo (small blind) showed [As Qs] and lost with three of a kind, Queens
Seat 3: magorko (big blind) folded before Flop
Seat 4: supbigdiaper folded before Flop (didn't bet)
Seat 5: Yaaaazz folded before Flop (didn't bet)


PokerStars Hand #222985641814:  Hold'em No Limit ($2.50/$5.00 USD) - 2021/01/23 23:30:38 ET
Table 'Aaltje II' 6-max Seat #2 is the button
Seat 1: Rabarber77 ($1915.05 in chips)
Seat 2: RAidakCo ($500 in chips)
Seat 3: magorko ($1065.25 in chips)
Seat 4: supbigdiaper ($507.50 in chips)
Seat 5: Yaaaazz ($884.11 in chips)
magorko: posts small blind $2.50
supbigdiaper: posts big blind $5
Nutsfit: sits out
*** HOLE CARDS ***
Yaaaazz: folds
Rabarber77: raises $10 to $15
RAidakCo: folds
magorko: folds
supbigdiaper: calls $10
*** FLOP *** [Kh Kd 9s]
supbigdiaper: checks
Rabarber77: bets $15.44
supbigdiaper: folds
Uncalled bet ($15.44) returned to Rabarber77
Rabarber77 collected $30.88 from pot
Rabarber77: doesn't show hand
*** SUMMARY ***
Total pot $32.50 | Rake $1.62
Board [Kh Kd 9s]
Seat 1: Rabarber77 collected ($30.88)
Seat 2: RAidakCo (button) folded before Flop (didn't bet)
Seat 3: magorko (small blind) folded before Flop
Seat 4: supbigdiaper (big blind) folded on the Flop
Seat 5: Yaaaazz folded before Flop (didn't bet)


PokerStars Hand #222985646984:  Hold'em No Limit ($2.50/$5.00 USD) - 2021/01/23 23:30:55 ET
Table 'Aaltje II' 6-max Seat #3 is the button
Seat 1: Rabarber77 ($1930.93 in chips)
Seat 2: RAidakCo ($500 in chips)
Seat 3: magorko ($1062.75 in chips)
Seat 4: supbigdiaper ($500 in chips)
Seat 5: Yaaaazz ($884.11 in chips)
supbigdiaper: posts small blind $2.50
Yaaaazz: posts big blind $5
Nutsfit: sits out
*** HOLE CARDS ***
Rabarber77: raises $10 to $15
RAidakCo: folds
magorko: folds
supbigdiaper: folds
Yaaaazz: folds
Uncalled bet ($10) returned to Rabarber77
Rabarber77 collected $12.50 from pot
Rabarber77: doesn't show hand
*** SUMMARY ***
Total pot $12.50 | Rake $0
Seat 1: Rabarber77 collected ($12.50)
Seat 2: RAidakCo folded before Flop (didn't bet)
Seat 3: magorko (button) folded before Flop (didn't bet)
Seat 4: supbigdiaper (small blind) folded before Flop
Seat 5: Yaaaazz (big blind) folded before Flop


PokerStars Hand #222985651305:  Hold'em No Limit ($2.50/$5.00 USD) - 2021/01/23 23:31:11 ET
Table 'Aaltje II' 6-max Seat #4 is the button
Seat 1: Rabarber77 ($1938.43 in chips)
Seat 2: RAidakCo ($500 in chips)
Seat 3: magorko ($1062.75 in chips)
Seat 4: supbigdiaper ($500 in chips)
Seat 5: Yaaaazz ($879.11 in chips)
Seat 6: Nutsfit ($602.84 in chips)
Yaaaazz: posts small blind $2.50
Nutsfit: posts big blind $5
*** HOLE CARDS ***
Rabarber77: raises $10 to $15
RAidakCo: raises $30 to $45
magorko: folds
supbigdiaper: folds
Yaaaazz: folds
Nutsfit: folds
Rabarber77: calls $30
*** FLOP *** [2s 5s 3s]
Rabarber77: checks
RAidakCo: bets $28.35
Rabarber77: calls $28.35
*** TURN *** [2s 5s 3s] [6d]
Rabarber77: checks
RAidakCo: bets $113.40
Rabarber77: calls $113.40
*** RIVER *** [2s 5s 3s 6d] [Kh]
Rabarber77: checks
RAidakCo: checks
*** SHOW DOWN ***
Rabarber77: shows [Ah 6h] (a pair of Sixes)
RAidakCo: mucks hand
Rabarber77 collected $378 from pot
*** SUMMARY ***
Total pot $381 | Rake $3
Board [2s 5s 3s 6d Kh]
Seat 1: Rabarber77 showed [Ah 6h] and won ($378) with a pair of Sixes
Seat 2: RAidakCo mucked
Seat 3: magorko folded before Flop (didn't bet)
Seat 4: supbigdiaper (button) folded before Flop (didn't bet)
Seat 5: Yaaaazz (small blind) folded before Flop
Seat 6: Nutsfit (big blind) folded before Flop


PokerStars Hand #222985670560:  Hold'em No Limit ($2.50/$5.00 USD) - 2021/01/23 23:32:18 ET
Table 'Aaltje II' 6-max Seat #5 is the button
Seat 1: Rabarber77 ($2129.68 in chips)
Seat 2: RAidakCo ($500 in chips)
Seat 3: magorko ($1062.75 in chips)
Seat 4: supbigdiaper ($500 in chips)
Seat 5: Yaaaazz ($876.61 in chips)
Seat 6: Nutsfit ($597.84 in chips)
Nutsfit: posts small blind $2.50
Rabarber77: posts big blind $5
*** HOLE CARDS ***
RAidakCo: folds
magorko: raises $7.50 to $12.50
supbigdiaper: folds
Yaaaazz: raises $25 to $37.50
Nutsfit: folds
Rabarber77: folds
magorko: folds
Uncalled bet ($25) returned to Yaaaazz
Yaaaazz collected $32.50 from pot
Yaaaazz: doesn't show hand
*** SUMMARY ***
Total pot $32.50 | Rake $0
Seat 1: Rabarber77 (big blind) folded before Flop
Seat 2: RAidakCo folded before Flop (didn't bet)
Seat 3: magorko folded before Flop
Seat 4: supbigdiaper folded before Flop (didn't bet)
Seat 5: Yaaaazz (button) collected ($32.50)
Seat 6: Nutsfit (small blind) folded before Flop


PokerStars Hand #222985676689:  Hold'em No Limit ($2.50/$5.00 USD) - 2021/01/23 23:32:39 ET
Table 'Aaltje II' 6-max Seat #6 is the button
Seat 1: Rabarber77 ($2124.68 in chips)
Seat 2: RAidakCo ($500 in chips)
Seat 3: magorko ($1050.25 in chips)
Seat 4: supbigdiaper ($500 in chips)
Seat 5: Yaaaazz ($896.61 in chips)
Seat 6: Nutsfit ($595.34 in chips)
Rabarber77: posts small blind $2.50
RAidakCo: posts big blind $5
*** HOLE CARDS ***
magorko: folds
supbigdiaper: folds
Yaaaazz: folds
Nutsfit: raises $7.50 to $12.50
Rabarber77: calls $10
RAidakCo: folds
*** FLOP *** [8d Ts Ah]
Rabarber77: checks
Nutsfit: bets $8.83
Rabarber77: folds
Uncalled bet ($8.83) returned to Nutsfit
Nutsfit collected $28.50 from pot
Nutsfit: doesn't show hand
*** SUMMARY ***
Total pot $30 | Rake $1.50
Board [8d Ts Ah]
Seat 1: Rabarber77 (small blind) folded on the Flop
Seat 2: RAidakCo (big blind) folded before Flop
Seat 3: magorko folded before Flop (didn't bet)
Seat 4: supbigdiaper folded before Flop (didn't bet)
Seat 5: Yaaaazz folded before Flop (didn't bet)
Seat 6: Nutsfit (button) collected ($28.50)


PokerStars Hand #222985689686:  Hold'em No Limit ($2.50/$5.00 USD) - 2021/01/23 23:33:24 ET
Table 'Aaltje II' 6-max Seat #1 is the button
Seat 1: Rabarber77 ($2112.18 in chips)
Seat 2: RAidakCo ($500 in chips)
Seat 4: supbigdiaper ($500 in chips)
Seat 5: Yaaaazz ($896.61 in chips)
Seat 6: Nutsfit ($611.34 in chips)
RAidakCo: posts small blind $2.50
magorko: is sitting out
supbigdiaper: posts big blind $5
*** HOLE CARDS ***
magorko leaves the table
Yaaaazz: folds
Nutsfit: raises $7.50 to $12.50
Rabarber77: calls $12.50
RAidakCo: folds
supbigdiaper: folds
*** FLOP *** [4s Jd 3h]
IdrinkBEERI joins the table at seat #3
Nutsfit: checks
Rabarber77: bets $15.44
Nutsfit: folds
Uncalled bet ($15.44) returned to Rabarber77
Rabarber77 collected $30.88 from pot
Rabarber77: doesn't show hand
*** SUMMARY ***
Total pot $32.50 | Rake $1.62
Board [4s Jd 3h]
Seat 1: Rabarber77 (button) collected ($30.88)
Seat 2: RAidakCo (small blind) folded before Flop
Seat 4: supbigdiaper (big blind) folded before Flop
Seat 5: Yaaaazz folded before Flop (didn't bet)
Seat 6: Nutsfit folded on the Flop


PokerStars Hand #222985700254:  Hold'em No Limit ($2.50/$5.00 USD) - 2021/01/23 23:34:01 ET
Table 'Aaltje II' 6-max Seat #2 is the button
Seat 1: Rabarber77 ($2130.56 in chips)
Seat 2: RAidakCo ($500 in chips)
Seat 4: supbigdiaper ($500 in chips)
Seat 5: Yaaaazz ($896.61 in chips)
Seat 6: Nutsfit ($598.84 in chips)
supbigdiaper: posts small blind $2.50
Yaaaazz: posts big blind $5
*** HOLE CARDS ***
Nutsfit: folds
Rabarber77: folds
RAidakCo: folds
supbigdiaper: raises $7.50 to $12.50
Yaaaazz: folds
Uncalled bet ($7.50) returned to supbigdiaper
supbigdiaper collected $10 from pot
supbigdiaper: doesn't show hand
*** SUMMARY ***
Total pot $10 | Rake $0
Seat 1: Rabarber77 folded before Flop (didn't bet)
Seat 2: RAidakCo (button) folded before Flop (didn't bet)
Seat 4: supbigdiaper (small blind) collected ($10)
Seat 5: Yaaaazz (big blind) folded before Flop
Seat 6: Nutsfit folded before Flop (didn't bet)


PokerStars Hand #222985706836:  Hold'em No Limit ($2.50/$5.00 USD) - 2021/01/23 23:34:24 ET
Table 'Aaltje II' 6-max Seat #4 is the button
Seat 1: Rabarber77 ($2130.56 in chips)
Seat 2: RAidakCo ($500 in chips)
Seat 4: supbigdiaper ($505 in chips)
Seat 5: Yaaaazz ($891.61 in chips)
Seat 6: Nutsfit ($598.84 in chips)
Yaaaazz: posts small blind $2.50
Nutsfit: posts big blind $5
IdrinkBEERI: sits out
*** HOLE CARDS ***
Rabarber77: folds
RAidakCo: folds
supbigdiaper: folds
Yaaaazz: raises $10 to $15
Nutsfit: raises $30 to $45
Yaaaazz: folds
Uncalled bet ($30) returned to Nutsfit
Nutsfit collected $30 from pot
Nutsfit: doesn't show hand
*** SUMMARY ***
Total pot $30 | Rake $0
Seat 1: Rabarber77 folded before Flop (didn't bet)
Seat 2: RAidakCo folded before Flop (didn't bet)
Seat 4: supbigdiaper (button) folded before Flop (didn't bet)
Seat 5: Yaaaazz (small blind) folded before Flop
Seat 6: Nutsfit (big blind) collected ($30)


PokerStars Hand #222985715769:  Hold'em No Limit ($2.50/$5.00 USD) - 2021/01/23 23:34:55 ET
Table 'Aaltje II' 6-max Seat #5 is the button
Seat 1: Rabarber77 ($2130.56 in chips)
Seat 2: RAidakCo ($500 in chips)
Seat 4: supbigdiaper ($505 in chips)
Seat 5: Yaaaazz ($876.61 in chips)
Seat 6: Nutsfit ($613.84 in chips)
Nutsfit: posts small blind $2.50
Rabarber77: posts big blind $5
IdrinkBEERI: sits out
*** HOLE CARDS ***
RAidakCo: folds
supbigdiaper: raises $7.50 to $12.50
Yaaaazz: folds
Nutsfit: folds
Rabarber77: folds
Uncalled bet ($7.50) returned to supbigdiaper
supbigdiaper collected $12.50 from pot
supbigdiaper: doesn't show hand
*** SUMMARY ***
Total pot $12.50 | Rake $0
Seat 1: Rabarber77 (big blind) folded before Flop
Seat 2: RAidakCo folded before Flop (didn't bet)
Seat 4: supbigdiaper collected ($12.50)
Seat 5: Yaaaazz (button) folded before Flop (didn't bet)
Seat 6: Nutsfit (small blind) folded before Flop


PokerStars Hand #222985722258:  Hold'em No Limit ($2.50/$5.00 USD) - 2021/01/23 23:35:17 ET
Table 'Aaltje II' 6-max Seat #6 is the button
Seat 1: Rabarber77 ($2125.56 in chips)
Seat 2: RAidakCo ($500 in chips)
Seat 4: supbigdiaper ($512.50 in chips)
Seat 5: Yaaaazz ($876.61 in chips)
Seat 6: Nutsfit ($611.34 in chips)
Rabarber77: posts small blind $2.50
RAidakCo: posts big blind $5
IdrinkBEERI: sits out
*** HOLE CARDS ***
supbigdiaper: folds
Yaaaazz: folds
Nutsfit: folds
Rabarber77: folds
Uncalled bet ($2.50) returned to RAidakCo
RAidakCo collected $5 from pot
RAidakCo: doesn't show hand
*** SUMMARY ***
Total pot $5 | Rake $0
Seat 1: Rabarber77 (small blind) folded before Flop
Seat 2: RAidakCo (big blind) collected ($5)
Seat 4: supbigdiaper folded before Flop (didn't bet)
Seat 5: Yaaaazz folded before Flop (didn't bet)
Seat 6: Nutsfit (button) folded before Flop (didn't bet)


PokerStars Hand #222985724733:  Hold'em No Limit ($2.50/$5.00 USD) - 2021/01/23 23:35:26 ET
Table 'Aaltje II' 6-max Seat #1 is the button
Seat 1: Rabarber77 ($2123.06 in chips)
Seat 2: RAidakCo ($502.50 in chips)
Seat 3: IdrinkBEERI ($500 in chips)
Seat 4: supbigdiaper ($512.50 in chips)
Seat 5: Yaaaazz ($876.61 in chips)
Seat 6: Nutsfit ($611.34 in chips)
RAidakCo: posts small blind $2.50
IdrinkBEERI: posts big blind $5
*** HOLE CARDS ***
supbigdiaper: folds
Yaaaazz: folds
Nutsfit: folds
Rabarber77: raises $10 to $15
RAidakCo: raises $45 to $60
IdrinkBEERI: folds
Rabarber77: calls $45
*** FLOP *** [Ah 5c 2c]
RAidakCo: bets $36.60
Rabarber77: calls $36.60
*** TURN *** [Ah 5c 2c] [9d]
RAidakCo: checks
Rabarber77: bets $97.60
RAidakCo: folds
Uncalled bet ($97.60) returned to Rabarber77
Rabarber77 collected $195.20 from pot
Rabarber77: doesn't show hand
*** SUMMARY ***
Total pot $198.20 | Rake $3
Board [Ah 5c 2c 9d]
Seat 1: Rabarber77 (button) collected ($195.20)
Seat 2: RAidakCo (small blind) folded on the Turn
Seat 3: IdrinkBEERI (big blind) folded before Flop
Seat 4: supbigdiaper folded before Flop (didn't bet)
Seat 5: Yaaaazz folded before Flop (didn't bet)
Seat 6: Nutsfit folded before Flop (didn't bet)


PokerStars Hand #222985739762:  Hold'em No Limit ($2.50/$5.00 USD) - 2021/01/23 23:36:18 ET
Table 'Aaltje II' 6-max Seat #2 is the button
Seat 1: Rabarber77 ($2221.66 in chips)
Seat 2: RAidakCo ($500 in chips)
Seat 3: IdrinkBEERI ($500 in chips)
Seat 4: supbigdiaper ($512.50 in chips)
Seat 5: Yaaaazz ($876.61 in chips)
Seat 6: Nutsfit ($611.34 in chips)
IdrinkBEERI: posts small blind $2.50
supbigdiaper: posts big blind $5
*** HOLE CARDS ***
Yaaaazz: folds
Nutsfit: folds
Rabarber77: folds
RAidakCo: raises $7.50 to $12.50
IdrinkBEERI: folds
supbigdiaper: raises $41.25 to $53.75
RAidakCo: calls $41.25
*** FLOP *** [Qd 3s 7h]
supbigdiaper: bets $35.31
RAidakCo: calls $35.31
*** TURN *** [Qd 3s 7h] [Qs]
supbigdiaper: checks
RAidakCo: bets $88.81
supbigdiaper: calls $88.81
*** RIVER *** [Qd 3s 7h Qs] [2h]
supbigdiaper: checks
RAidakCo: checks
*** SHOW DOWN ***
supbigdiaper: shows [Ad Qh] (three of a kind, Queens)
RAidakCo: mucks hand
supbigdiaper collected $355.24 from pot
*** SUMMARY ***
Total pot $358.24 | Rake $3
Board [Qd 3s 7h Qs 2h]
Seat 1: Rabarber77 folded before Flop (didn't bet)
Seat 2: RAidakCo (button) mucked
Seat 3: IdrinkBEERI (small blind) folded before Flop
Seat 4: supbigdiaper (big blind) showed [Ad Qh] and won ($355.24) with three of a kind, Queens
Seat 5: Yaaaazz folded before Flop (didn't bet)
Seat 6: Nutsfit folded before Flop (didn't bet)


PokerStars Hand #222985765416:  Hold'em No Limit ($2.50/$5.00 USD) - 2021/01/23 23:37:47 ET
Table 'Aaltje II' 6-max Seat #3 is the button
Seat 1: Rabarber77 ($2221.66 in chips)
Seat 2: RAidakCo ($500 in chips)
Seat 3: IdrinkBEERI ($500 in chips)
Seat 4: supbigdiaper ($689.87 in chips)
Seat 5: Yaaaazz ($876.61 in chips)
Seat 6: Nutsfit ($611.34 in chips)
supbigdiaper: posts small blind $2.50
Yaaaazz: posts big blind $5
*** HOLE CARDS ***
Nutsfit: folds
Rabarber77: folds
RAidakCo: folds
IdrinkBEERI: folds
supbigdiaper: raises $7.50 to $12.50
Yaaaazz: folds
Uncalled bet ($7.50) returned to supbigdiaper
supbigdiaper collected $10 from pot
supbigdiaper: doesn't show hand
*** SUMMARY ***
Total pot $10 | Rake $0
Seat 1: Rabarber77 folded before Flop (didn't bet)
Seat 2: RAidakCo folded before Flop (didn't bet)
Seat 3: IdrinkBEERI (button) folded before Flop (didn't bet)
Seat 4: supbigdiaper (small blind) collected ($10)
Seat 5: Yaaaazz (big blind) folded before Flop
Seat 6: Nutsfit folded before Flop (didn't bet)


PokerStars Hand #222985774398:  Hold'em No Limit ($2.50/$5.00 USD) - 2021/01/23 23:38:07 ET
Table 'Aaltje II' 6-max Seat #4 is the button
Seat 1: Rabarber77 ($2221.66 in chips)
Seat 2: RAidakCo ($500 in chips)
Seat 3: IdrinkBEERI ($500 in chips)
Seat 4: supbigdiaper ($694.87 in chips)
Seat 5: Yaaaazz ($871.61 in chips)
Seat 6: Nutsfit ($611.34 in chips)
Yaaaazz: posts small blind $2.50
Nutsfit: posts big blind $5
*** HOLE CARDS ***
Rabarber77: raises $10 to $15
RAidakCo: raises $35 to $50
IdrinkBEERI: folds
supbigdiaper: folds
Yaaaazz: folds
Nutsfit: folds
Rabarber77: calls $35
*** FLOP *** [4c 4s 6c]
Rabarber77: checks
RAidakCo: bets $31.35
Rabarber77: calls $31.35
*** TURN *** [4c 4s 6c] [Js]
Rabarber77: checks
RAidakCo: bets $83.60
Rabarber77: calls $83.60
*** RIVER *** [4c 4s 6c Js] [6d]
Rabarber77: bets $2056.71 and is all-in
RAidakCo: calls $335.05 and is all-in
Uncalled bet ($1721.66) returned to Rabarber77
*** SHOW DOWN ***
Rabarber77: shows [6h 7h] (a full house, Sixes full of Fours)
RAidakCo: shows [Qc As] (two pair, Sixes and Fours)
Rabarber77 collected $1004.50 from pot
*** SUMMARY ***
Total pot $1007.50 | Rake $3
Board [4c 4s 6c Js 6d]
Seat 1: Rabarber77 showed [6h 7h] and won ($1004.50) with a full house, Sixes full of Fours
Seat 2: RAidakCo showed [Qc As] and lost with two pair, Sixes and Fours
Seat 3: IdrinkBEERI folded before Flop (didn't bet)
Seat 4: supbigdiaper (button) folded before Flop (didn't bet)
Seat 5: Yaaaazz (small blind) folded before Flop
Seat 6: Nutsfit (big blind) folded before Flop


PokerStars Hand #222985793996:  Hold'em No Limit ($2.50/$5.00 USD) - 2021/01/23 23:39:10 ET
Table 'Aaltje II' 6-max Seat #5 is the button
Seat 1: Rabarber77 ($2726.16 in chips)
Seat 2: RAidakCo ($500 in chips)
Seat 3: IdrinkBEERI ($500 in chips)
Seat 4: supbigdiaper ($694.87 in chips)
Seat 5: Yaaaazz ($869.11 in chips)
Seat 6: Nutsfit ($606.34 in chips)
Nutsfit: posts small blind $2.50
Rabarber77: posts big blind $5
*** HOLE CARDS ***
RAidakCo: folds
IdrinkBEERI: folds
supbigdiaper: raises $7.50 to $12.50
Yaaaazz: folds
Nutsfit: folds
Rabarber77: calls $7.50
*** FLOP *** [Qh 3h Td]
Rabarber77: checks
supbigdiaper: bets $8.62
Rabarber77: calls $8.62
*** TURN *** [Qh 3h Td] [9d]
Rabarber77: checks
supbigdiaper: checks
*** RIVER *** [Qh 3h Td 9d] [Jc]
Rabarber77: checks
supbigdiaper: bets $31.88
Rabarber77: folds
Uncalled bet ($31.88) returned to supbigdiaper
supbigdiaper collected $42.50 from pot
supbigdiaper: doesn't show hand
*** SUMMARY ***
Total pot $44.74 | Rake $2.24
Board [Qh 3h Td 9d Jc]
Seat 1: Rabarber77 (big blind) folded on the River
Seat 2: RAidakCo folded before Flop (didn't bet)
Seat 3: IdrinkBEERI folded before Flop (didn't bet)
Seat 4: supbigdiaper collected ($42.50)
Seat 5: Yaaaazz (button) folded before Flop (didn't bet)
Seat 6: Nutsfit (small blind) folded before Flop


PokerStars Hand #222985809324:  Hold'em No Limit ($2.50/$5.00 USD) - 2021/01/23 23:40:04 ET
Table 'Aaltje II' 6-max Seat #6 is the button
Seat 1: Rabarber77 ($2705.04 in chips)
Seat 2: RAidakCo ($500 in chips)
Seat 3: IdrinkBEERI ($500 in chips)
Seat 4: supbigdiaper ($716.25 in chips)
Seat 5: Yaaaazz ($869.11 in chips)
Seat 6: Nutsfit ($603.84 in chips)
Rabarber77: posts small blind $2.50
RAidakCo: posts big blind $5
*** HOLE CARDS ***
IdrinkBEERI: raises $11.20 to $16.20
supbigdiaper: folds
Yaaaazz: folds
Nutsfit: folds
Rabarber77: folds
RAidakCo: folds
Uncalled bet ($11.20) returned to IdrinkBEERI
IdrinkBEERI collected $12.50 from pot
IdrinkBEERI: doesn't show hand
*** SUMMARY ***
Total pot $12.50 | Rake $0
Seat 1: Rabarber77 (small blind) folded before Flop
Seat 2: RAidakCo (big blind) folded before Flop
Seat 3: IdrinkBEERI collected ($12.50)
Seat 4: supbigdiaper folded before Flop (didn't bet)
Seat 5: Yaaaazz folded before Flop (didn't bet)
Seat 6: Nutsfit (button) folded before Flop (didn't bet)


PokerStars Hand #222985812177:  Hold'em No Limit ($2.50/$5.00 USD) - 2021/01/23 23:40:14 ET
Table 'Aaltje II' 6-max Seat #1 is the button
Seat 1: Rabarber77 ($2702.54 in chips)
Seat 2: RAidakCo ($500 in chips)
Seat 3: IdrinkBEERI ($507.50 in chips)
Seat 4: supbigdiaper ($716.25 in chips)
Seat 5: Yaaaazz ($869.11 in chips)
Seat 6: Nutsfit ($603.84 in chips)
RAidakCo: posts small blind $2.50
IdrinkBEERI: posts big blind $5
*** HOLE CARDS ***
supbigdiaper: folds
Yaaaazz: folds
Nutsfit: folds
Rabarber77: folds
RAidakCo: folds
Uncalled bet ($2.50) returned to IdrinkBEERI
IdrinkBEERI collected $5 from pot
IdrinkBEERI: doesn't show hand
*** SUMMARY ***
Total pot $5 | Rake $0
Seat 1: Rabarber77 (button) folded before Flop (didn't bet)
Seat 2: RAidakCo (small blind) folded before Flop
Seat 3: IdrinkBEERI (big blind) collected ($5)
Seat 4: supbigdiaper folded before Flop (didn't bet)
Seat 5: Yaaaazz folded before Flop (didn't bet)
Seat 6: Nutsfit folded before Flop (didn't bet)


PokerStars Hand #222985816572:  Hold'em No Limit ($2.50/$5.00 USD) - 2021/01/23 23:40:30 ET
Table 'Aaltje II' 6-max Seat #2 is the button
Seat 1: Rabarber77 ($2702.54 in chips)
Seat 2: RAidakCo ($500 in chips)
Seat 3: IdrinkBEERI ($510 in chips)
Seat 4: supbigdiaper ($716.25 in chips)
Seat 5: Yaaaazz ($869.11 in chips)
Seat 6: Nutsfit ($603.84 in chips)
IdrinkBEERI: posts small blind $2.50
supbigdiaper: posts big blind $5
*** HOLE CARDS ***
Yaaaazz: folds
Nutsfit: folds
Rabarber77: raises $10 to $15
RAidakCo: folds
IdrinkBEERI: folds
supbigdiaper: calls $10
*** FLOP *** [2d 9s 3s]
supbigdiaper: checks
Rabarber77: bets $20
supbigdiaper: folds
Uncalled bet ($20) returned to Rabarber77
Rabarber77 collected $30.88 from pot
Rabarber77: doesn't show hand
*** SUMMARY ***
Total pot $32.50 | Rake $1.62
Board [2d 9s 3s]
Seat 1: Rabarber77 collected ($30.88)
Seat 2: RAidakCo (button) folded before Flop (didn't bet)
Seat 3: IdrinkBEERI (small blind) folded before Flop
Seat 4: supbigdiaper (big blind) folded on the Flop
Seat 5: Yaaaazz folded before Flop (didn't bet)
Seat 6: Nutsfit folded before Flop (didn't bet)


PokerStars Hand #222985824134:  Hold'em No Limit ($2.50/$5.00 USD) - 2021/01/23 23:40:57 ET
Table 'Aaltje II' 6-max Seat #3 is the button
Seat 1: Rabarber77 ($2718.42 in chips)
Seat 2: RAidakCo ($500 in chips)
Seat 3: IdrinkBEERI ($507.50 in chips)
Seat 4: supbigdiaper ($701.25 in chips)
Seat 5: Yaaaazz ($869.11 in chips)
Seat 6: Nutsfit ($603.84 in chips)
supbigdiaper: posts small blind $2.50
Yaaaazz: posts big blind $5
*** HOLE CARDS ***
Nutsfit: folds
Rabarber77: folds
RAidakCo: folds
IdrinkBEERI: raises $9.65 to $14.65
supbigdiaper: folds
Yaaaazz: folds
Uncalled bet ($9.65) returned to IdrinkBEERI
IdrinkBEERI collected $12.50 from pot
IdrinkBEERI: doesn't show hand
*** SUMMARY ***
Total pot $12.50 | Rake $0
Seat 1: Rabarber77 folded before Flop (didn't bet)
Seat 2: RAidakCo folded before Flop (didn't bet)
Seat 3: IdrinkBEERI (button) collected ($12.50)
Seat 4: supbigdiaper (small blind) folded before Flop
Seat 5: Yaaaazz (big blind) folded before Flop
Seat 6: Nutsfit folded before Flop (didn't bet)


PokerStars Hand #222985829113:  Hold'em No Limit ($2.50/$5.00 USD) - 2021/01/23 23:41:15 ET
Table 'Aaltje II' 6-max Seat #4 is the button
Seat 1: Rabarber77 ($2718.42 in chips)
Seat 2: RAidakCo ($500 in chips)
Seat 3: IdrinkBEERI ($515 in chips)
Seat 4: supbigdiaper ($698.75 in chips)
Seat 5: Yaaaazz ($864.11 in chips)
Seat 6: Nutsfit ($603.84 in chips)
Yaaaazz: posts small blind $2.50
Nutsfit: posts big blind $5
*** HOLE CARDS ***
Rabarber77: raises $10 to $15
RAidakCo: folds
IdrinkBEERI: folds
supbigdiaper: calls $15
Yaaaazz: folds
Nutsfit: folds
*** FLOP *** [2s 6h 4h]
Rabarber77: bets $17.81
supbigdiaper: raises $47.02 to $64.83
Rabarber77: calls $47.02
*** TURN *** [2s 6h 4h] [Jd]
Rabarber77: checks
supbigdiaper: checks
*** RIVER *** [2s 6h 4h Jd] [4s]
Rabarber77: checks
supbigdiaper: checks
*** SHOW DOWN ***
Rabarber77: shows [6d 5d] (two pair, Sixes and Fours)
supbigdiaper: mucks hand
Rabarber77 collected $164.16 from pot
*** SUMMARY ***
Total pot $167.16 | Rake $3
Board [2s 6h 4h Jd 4s]
Seat 1: Rabarber77 showed [6d 5d] and won ($164.16) with two pair, Sixes and Fours
Seat 2: RAidakCo folded before Flop (didn't bet)
Seat 3: IdrinkBEERI folded before Flop (didn't bet)
Seat 4: supbigdiaper (button) mucked
Seat 5: Yaaaazz (small blind) folded before Flop
Seat 6: Nutsfit (big blind) folded before Flop


PokerStars Hand #222985846211:  Hold'em No Limit ($2.50/$5.00 USD) - 2021/01/23 23:42:01 ET
Table 'Aaltje II' 6-max Seat #5 is the button
Seat 1: Rabarber77 ($2802.75 in chips)
Seat 2: RAidakCo ($500 in chips)
Seat 3: IdrinkBEERI ($515 in chips)
Seat 4: supbigdiaper ($618.92 in chips)
Seat 5: Yaaaazz ($861.61 in chips)
Seat 6: Nutsfit ($598.84 in chips)
Nutsfit: posts small blind $2.50
Rabarber77: posts big blind $5
*** HOLE CARDS ***
RAidakCo: folds
IdrinkBEERI: folds
supbigdiaper: folds
Yaaaazz: raises $7.50 to $12.50
Nutsfit: calls $10
Rabarber77: calls $7.50
*** FLOP *** [8c 3h Qc]
Nutsfit: checks
Rabarber77: bets $17.81
Yaaaazz: calls $17.81
Nutsfit: raises $42.19 to $60
Rabarber77: calls $42.19
Yaaaazz: folds
*** TURN *** [8c 3h Qc] [9s]
Nutsfit: checks
Rabarber77: checks
*** RIVER *** [8c 3h Qc 9s] [Th]
Nutsfit: bets $87.88
Rabarber77: folds
Uncalled bet ($87.88) returned to Nutsfit
Nutsfit collected $172.31 from pot
Nutsfit: doesn't show hand
*** SUMMARY ***
Total pot $175.31 | Rake $3
Board [8c 3h Qc 9s Th]
Seat 1: Rabarber77 (big blind) folded on the River
Seat 2: RAidakCo folded before Flop (didn't bet)
Seat 3: IdrinkBEERI folded before Flop (didn't bet)
Seat 4: supbigdiaper folded before Flop (didn't bet)
Seat 5: Yaaaazz (button) folded on the Flop
Seat 6: Nutsfit (small blind) collected ($172.31)


PokerStars Hand #222985875748:  Hold'em No Limit ($2.50/$5.00 USD) - 2021/01/23 23:43:45 ET
Table 'Aaltje II' 6-max Seat #6 is the button
Seat 1: Rabarber77 ($2730.25 in chips)
Seat 2: RAidakCo ($500 in chips)
Seat 3: IdrinkBEERI ($515 in chips)
Seat 4: supbigdiaper ($618.92 in chips)
Seat 5: Yaaaazz ($831.30 in chips)
Seat 6: Nutsfit ($698.65 in chips)
Rabarber77: posts small blind $2.50
RAidakCo: posts big blind $5
*** HOLE CARDS ***
IdrinkBEERI: folds
supbigdiaper: folds
Yaaaazz: folds
Nutsfit: folds
Rabarber77: raises $10 to $15
RAidakCo: raises $30 to $45
Rabarber77: calls $30
*** FLOP *** [Qh 6c Ad]
Rabarber77: checks
RAidakCo: bets $26.10
Rabarber77: folds
Uncalled bet ($26.10) returned to RAidakCo
RAidakCo collected $87 from pot
RAidakCo: doesn't show hand
*** SUMMARY ***
Total pot $90 | Rake $3
Board [Qh 6c Ad]
Seat 1: Rabarber77 (small blind) folded on the Flop
Seat 2: RAidakCo (big blind) collected ($87)
Seat 3: IdrinkBEERI folded before Flop (didn't bet)
Seat 4: supbigdiaper folded before Flop (didn't bet)
Seat 5: Yaaaazz folded before Flop (didn't bet)
Seat 6: Nutsfit (button) folded before Flop (didn't bet)


PokerStars Hand #222985884230:  Hold'em No Limit ($2.50/$5.00 USD) - 2021/01/23 23:44:16 ET
Table 'Aaltje II' 6-max Seat #1 is the button
Seat 1: Rabarber77 ($2685.25 in chips)
Seat 2: RAidakCo ($542 in chips)
Seat 3: IdrinkBEERI ($515 in chips)
Seat 4: supbigdiaper ($618.92 in chips)
Seat 5: Yaaaazz ($831.30 in chips)
Seat 6: Nutsfit ($698.65 in chips)
RAidakCo: posts small blind $2.50
IdrinkBEERI: posts big blind $5
*** HOLE CARDS ***
supbigdiaper: raises $7.50 to $12.50
Yaaaazz: raises $25 to $37.50
Nutsfit: folds
Rabarber77: calls $37.50
RAidakCo: folds
IdrinkBEERI: folds
supbigdiaper: calls $25
*** FLOP *** [Kd Ac 4s]
supbigdiaper: checks
Yaaaazz: checks
Rabarber77: bets $85
supbigdiaper: folds
Yaaaazz: folds
Uncalled bet ($85) returned to Rabarber77
Rabarber77 collected $117 from pot
Rabarber77: doesn't show hand
*** SUMMARY ***
Total pot $120 | Rake $3
Board [Kd Ac 4s]
Seat 1: Rabarber77 (button) collected ($117)
Seat 2: RAidakCo (small blind) folded before Flop
Seat 3: IdrinkBEERI (big blind) folded before Flop
Seat 4: supbigdiaper folded on the Flop
Seat 5: Yaaaazz folded on the Flop
Seat 6: Nutsfit folded before Flop (didn't bet)


PokerStars Hand #222985894835:  Hold'em No Limit ($2.50/$5.00 USD) - 2021/01/23 23:44:53 ET
Table 'Aaltje II' 6-max Seat #2 is the button
Seat 1: Rabarber77 ($2764.75 in chips)
Seat 2: RAidakCo ($539.50 in chips)
Seat 3: IdrinkBEERI ($510 in chips)
Seat 4: supbigdiaper ($581.42 in chips)
Seat 5: Yaaaazz ($793.80 in chips)
Seat 6: Nutsfit ($698.65 in chips)
IdrinkBEERI: posts small blind $2.50
supbigdiaper: posts big blind $5
*** HOLE CARDS ***
Yaaaazz: folds
Nutsfit: folds
Rabarber77: folds
RAidakCo: folds
IdrinkBEERI: raises $9.85 to $14.85
supbigdiaper: raises $30 to $44.85
IdrinkBEERI: raises $67.28 to $112.13
supbigdiaper: calls $67.28
*** FLOP *** [3c 2h Ts]
IdrinkBEERI: checks
supbigdiaper: bets $55.32
IdrinkBEERI: folds
Uncalled bet ($55.32) returned to supbigdiaper
supbigdiaper collected $221.26 from pot
supbigdiaper: doesn't show hand
*** SUMMARY ***
Total pot $224.26 | Rake $3
Board [3c 2h Ts]
Seat 1: Rabarber77 folded before Flop (didn't bet)
Seat 2: RAidakCo (button) folded before Flop (didn't bet)
Seat 3: IdrinkBEERI (small blind) folded on the Flop
Seat 4: supbigdiaper (big blind) collected ($221.26)
Seat 5: Yaaaazz folded before Flop (didn't bet)
Seat 6: Nutsfit folded before Flop (didn't bet)


PokerStars Hand #222985919575:  Hold'em No Limit ($2.50/$5.00 USD) - 2021/01/23 23:46:23 ET
Table 'Aaltje II' 6-max Seat #3 is the button
Seat 1: Rabarber77 ($2764.75 in chips)
Seat 2: RAidakCo ($539.50 in chips)
Seat 3: IdrinkBEERI ($500 in chips)
Seat 4: supbigdiaper ($690.55 in chips)
Seat 5: Yaaaazz ($793.80 in chips)
Seat 6: Nutsfit ($698.65 in chips)
supbigdiaper: posts small blind $2.50
Yaaaazz: posts big blind $5
*** HOLE CARDS ***
Nutsfit: raises $5.90 to $10.90
Rabarber77: calls $10.90
RAidakCo: folds
IdrinkBEERI: folds
supbigdiaper: folds
Yaaaazz: folds
*** FLOP *** [Ah 8h 6h]
Nutsfit: checks
Rabarber77: bets $13.92
Nutsfit: folds
Uncalled bet ($13.92) returned to Rabarber77
Rabarber77 collected $27.84 from pot
Rabarber77: doesn't show hand
*** SUMMARY ***
Total pot $29.30 | Rake $1.46
Board [Ah 8h 6h]
Seat 1: Rabarber77 collected ($27.84)
Seat 2: RAidakCo folded before Flop (didn't bet)
Seat 3: IdrinkBEERI (button) folded before Flop (didn't bet)
Seat 4: supbigdiaper (small blind) folded before Flop
Seat 5: Yaaaazz (big blind) folded before Flop
Seat 6: Nutsfit folded on the Flop


PokerStars Hand #222985928622:  Hold'em No Limit ($2.50/$5.00 USD) - 2021/01/23 23:46:56 ET
Table 'Aaltje II' 6-max Seat #4 is the button
Seat 1: Rabarber77 ($2781.69 in chips)
Seat 2: RAidakCo ($539.50 in chips)
Seat 3: IdrinkBEERI ($500 in chips)
Seat 4: supbigdiaper ($688.05 in chips)
Seat 5: Yaaaazz ($788.80 in chips)
Seat 6: Nutsfit ($687.75 in chips)
Yaaaazz: posts small blind $2.50
Nutsfit: posts big blind $5
*** HOLE CARDS ***
Rabarber77: folds
RAidakCo: folds
IdrinkBEERI: folds
supbigdiaper: folds
Yaaaazz: folds
Uncalled bet ($2.50) returned to Nutsfit
Nutsfit collected $5 from pot
Nutsfit: doesn't show hand
*** SUMMARY ***
Total pot $5 | Rake $0
Seat 1: Rabarber77 folded before Flop (didn't bet)
Seat 2: RAidakCo folded before Flop (didn't bet)
Seat 3: IdrinkBEERI folded before Flop (didn't bet)
Seat 4: supbigdiaper (button) folded before Flop (didn't bet)
Seat 5: Yaaaazz (small blind) folded before Flop
Seat 6: Nutsfit (big blind) collected ($5)


PokerStars Hand #222985933679:  Hold'em No Limit ($2.50/$5.00 USD) - 2021/01/23 23:47:14 ET
Table 'Aaltje II' 6-max Seat #5 is the button
Seat 1: Rabarber77 ($2781.69 in chips)
Seat 2: RAidakCo ($539.50 in chips)
Seat 3: IdrinkBEERI ($500 in chips)
Seat 4: supbigdiaper ($688.05 in chips)
Seat 5: Yaaaazz ($786.30 in chips)
Seat 6: Nutsfit ($690.25 in chips)
Nutsfit: posts small blind $2.50
Rabarber77: posts big blind $5
*** HOLE CARDS ***
RAidakCo: folds
IdrinkBEERI: folds
supbigdiaper: raises $7.50 to $12.50
Yaaaazz: folds
Nutsfit: folds
Rabarber77: calls $7.50
*** FLOP *** [Td 6h 5h]
Rabarber77: checks
supbigdiaper: checks
*** TURN *** [Td 6h 5h] [2h]
Rabarber77: bets $13.06
supbigdiaper: calls $13.06
*** RIVER *** [Td 6h 5h 2h] [9h]
Rabarber77: checks
supbigdiaper: checks
*** SHOW DOWN ***
Rabarber77: shows [6s 7d] (a pair of Sixes)
supbigdiaper: shows [3h 3c] (a flush, Nine high)
supbigdiaper collected $50.94 from pot
*** SUMMARY ***
Total pot $53.62 | Rake $2.68
Board [Td 6h 5h 2h 9h]
Seat 1: Rabarber77 (big blind) showed [6s 7d] and lost with a pair of Sixes
Seat 2: RAidakCo folded before Flop (didn't bet)
Seat 3: IdrinkBEERI folded before Flop (didn't bet)
Seat 4: supbigdiaper showed [3h 3c] and won ($50.94) with a flush, Nine high
Seat 5: Yaaaazz (button) folded before Flop (didn't bet)
Seat 6: Nutsfit (small blind) folded before Flop


PokerStars Hand #222985945807:  Hold'em No Limit ($2.50/$5.00 USD) - 2021/01/23 23:47:58 ET
Table 'Aaltje II' 6-max Seat #6 is the button
Seat 1: Rabarber77 ($2756.13 in chips)
Seat 2: RAidakCo ($539.50 in chips)
Seat 3: IdrinkBEERI ($500 in chips)
Seat 4: supbigdiaper ($713.43 in chips)
Seat 5: Yaaaazz ($786.30 in chips)
Seat 6: Nutsfit ($687.75 in chips)
Rabarber77: posts small blind $2.50
RAidakCo: posts big blind $5
*** HOLE CARDS ***
IdrinkBEERI: raises $11.20 to $16.20
supbigdiaper: folds
Yaaaazz: folds
Nutsfit: folds
Rabarber77: raises $23.80 to $40
RAidakCo: folds
IdrinkBEERI: folds
Uncalled bet ($23.80) returned to Rabarber77
Rabarber77 collected $37.40 from pot
Rabarber77: doesn't show hand
*** SUMMARY ***
Total pot $37.40 | Rake $0
Seat 1: Rabarber77 (small blind) collected ($37.40)
Seat 2: RAidakCo (big blind) folded before Flop
Seat 3: IdrinkBEERI folded before Flop
Seat 4: supbigdiaper folded before Flop (didn't bet)
Seat 5: Yaaaazz folded before Flop (didn't bet)
Seat 6: Nutsfit (button) folded before Flop (didn't bet)


PokerStars Hand #222985956563:  Hold'em No Limit ($2.50/$5.00 USD) - 2021/01/23 23:48:37 ET
Table 'Aaltje II' 6-max Seat #1 is the button
Seat 1: Rabarber77 ($2777.33 in chips)
Seat 2: RAidakCo ($534.50 in chips)
Seat 3: IdrinkBEERI ($500 in chips)
Seat 4: supbigdiaper ($713.43 in chips)
Seat 5: Yaaaazz ($786.30 in chips)
Seat 6: Nutsfit ($687.75 in chips)
RAidakCo: posts small blind $2.50
IdrinkBEERI: posts big blind $5
*** HOLE CARDS ***
supbigdiaper: folds
Yaaaazz: folds
Nutsfit: raises $7.50 to $12.50
Rabarber77: folds
RAidakCo: folds
IdrinkBEERI: folds
Uncalled bet ($7.50) returned to Nutsfit
Nutsfit collected $12.50 from pot
Nutsfit: doesn't show hand
*** SUMMARY ***
Total pot $12.50 | Rake $0
Seat 1: Rabarber77 (button) folded before Flop (didn't bet)
Seat 2: RAidakCo (small blind) folded before Flop
Seat 3: IdrinkBEERI (big blind) folded before Flop
Seat 4: supbigdiaper folded before Flop (didn't bet)
Seat 5: Yaaaazz folded before Flop (didn't bet)
Seat 6: Nutsfit collected ($12.50)


PokerStars Hand #222985962749:  Hold'em No Limit ($2.50/$5.00 USD) - 2021/01/23 23:49:00 ET
Table 'Aaltje II' 6-max Seat #2 is the button
Seat 1: Rabarber77 ($2777.33 in chips)
Seat 2: RAidakCo ($532 in chips)
Seat 3: IdrinkBEERI ($500 in chips)
Seat 4: supbigdiaper ($713.43 in chips)
Seat 5: Yaaaazz ($786.30 in chips)
Seat 6: Nutsfit ($695.25 in chips)
IdrinkBEERI: posts small blind $2.50
supbigdiaper: posts big blind $5
*** HOLE CARDS ***
Yaaaazz: folds
Nutsfit: folds
Rabarber77: folds
RAidakCo: raises $7.50 to $12.50
IdrinkBEERI: folds
supbigdiaper: calls $7.50
*** FLOP *** [3c 7c 9s]
supbigdiaper: checks
RAidakCo: bets $19.59
supbigdiaper: calls $19.59
*** TURN *** [3c 7c 9s] [Jh]
supbigdiaper: checks
RAidakCo: bets $100
supbigdiaper: folds
Uncalled bet ($100) returned to RAidakCo
RAidakCo collected $63.68 from pot
RAidakCo: doesn't show hand
*** SUMMARY ***
Total pot $66.68 | Rake $3
Board [3c 7c 9s Jh]
Seat 1: Rabarber77 folded before Flop (didn't bet)
Seat 2: RAidakCo (button) collected ($63.68)
Seat 3: IdrinkBEERI (small blind) folded before Flop
Seat 4: supbigdiaper (big blind) folded on the Turn
Seat 5: Yaaaazz folded before Flop (didn't bet)
Seat 6: Nutsfit folded before Flop (didn't bet)


PokerStars Hand #222985984387:  Hold'em No Limit ($2.50/$5.00 USD) - 2021/01/23 23:50:17 ET
Table 'Aaltje II' 6-max Seat #3 is the button
Seat 1: Rabarber77 ($2777.33 in chips)
Seat 2: RAidakCo ($563.59 in chips)
Seat 3: IdrinkBEERI ($500 in chips)
Seat 4: supbigdiaper ($681.34 in chips)
Seat 5: Yaaaazz ($786.30 in chips)
Seat 6: Nutsfit ($695.25 in chips)
supbigdiaper: posts small blind $2.50
Yaaaazz: posts big blind $5
*** HOLE CARDS ***
Nutsfit: folds
Rabarber77: folds
RAidakCo: raises $6 to $11
IdrinkBEERI: folds
supbigdiaper: folds
Yaaaazz: folds
Uncalled bet ($6) returned to RAidakCo
RAidakCo collected $12.50 from pot
RAidakCo: doesn't show hand
*** SUMMARY ***
Total pot $12.50 | Rake $0
Seat 1: Rabarber77 folded before Flop (didn't bet)
Seat 2: RAidakCo collected ($12.50)
Seat 3: IdrinkBEERI (button) folded before Flop (didn't bet)
Seat 4: supbigdiaper (small blind) folded before Flop
Seat 5: Yaaaazz (big blind) folded before Flop
Seat 6: Nutsfit folded before Flop (didn't bet)


PokerStars Hand #222985989187:  Hold'em No Limit ($2.50/$5.00 USD) - 2021/01/23 23:50:35 ET
Table 'Aaltje II' 6-max Seat #4 is the button
Seat 1: Rabarber77 ($2777.33 in chips)
Seat 2: RAidakCo ($571.09 in chips)
Seat 3: IdrinkBEERI ($500 in chips)
Seat 4: supbigdiaper ($678.84 in chips)
Seat 5: Yaaaazz ($781.30 in chips)
Yaaaazz: posts small blind $2.50
Nutsfit: is sitting out
Rabarber77: posts big blind $5
*** HOLE CARDS ***
RAidakCo: folds
IdrinkBEERI: folds
supbigdiaper: folds
Yaaaazz: folds
Uncalled bet ($2.50) returned to Rabarber77
Rabarber77 collected $5 from pot
Rabarber77: doesn't show hand
*** SUMMARY ***
Total pot $5 | Rake $0
Seat 1: Rabarber77 (big blind) collected ($5)
Seat 2: RAidakCo folded before Flop (didn't bet)
Seat 3: IdrinkBEERI folded before Flop (didn't bet)
Seat 4: supbigdiaper (button) folded before Flop (didn't bet)
Seat 5: Yaaaazz (small blind) folded before Flop


PokerStars Hand #222986001222:  Hold'em No Limit ($2.50/$5.00 USD) - 2021/01/23 23:50:45 ET
Table 'Aaltje II' 6-max Seat #5 is the button
Seat 1: Rabarber77 ($2779.83 in chips)
Seat 2: RAidakCo ($571.09 in chips)
Seat 3: IdrinkBEERI ($500 in chips)
Seat 4: supbigdiaper ($678.84 in chips)
Seat 5: Yaaaazz ($778.80 in chips)
Rabarber77: posts small blind $2.50
RAidakCo: posts big blind $5
*** HOLE CARDS ***
Nutsfit leaves the table
IdrinkBEERI has timed out
IdrinkBEERI: folds
supbigdiaper: raises $7.50 to $12.50
Yaaaazz: calls $12.50
Rabarber77: folds
RAidakCo: folds
*** FLOP *** [Ks 7d 2c]
supbigdiaper: bets $10.19
Yaaaazz: folds
Uncalled bet ($10.19) returned to supbigdiaper
supbigdiaper collected $30.88 from pot
supbigdiaper: doesn't show hand
*** SUMMARY ***
Total pot $32.50 | Rake $1.62
Board [Ks 7d 2c]
Seat 1: Rabarber77 (small blind) folded before Flop
Seat 2: RAidakCo (big blind) folded before Flop
Seat 3: IdrinkBEERI folded before Flop (didn't bet)
Seat 4: supbigdiaper collected ($30.88)
Seat 5: Yaaaazz (button) folded on the Flop


PokerStars Hand #222986008534:  Hold'em No Limit ($2.50/$5.00 USD) - 2021/01/23 23:51:12 ET
Table 'Aaltje II' 6-max Seat #1 is the button
Seat 1: Rabarber77 ($2777.33 in chips)
Seat 2: RAidakCo ($566.09 in chips)
Seat 3: IdrinkBEERI ($500 in chips)
Seat 4: supbigdiaper ($697.22 in chips)
Seat 5: Yaaaazz ($766.30 in chips)
RAidakCo: posts small blind $2.50
IdrinkBEERI: posts big blind $5
*** HOLE CARDS ***
supbigdiaper: folds
Yaaaazz: folds
Rabarber77: raises $10 to $15
RAidakCo: folds
IdrinkBEERI: folds
Uncalled bet ($10) returned to Rabarber77
Rabarber77 collected $12.50 from pot
Rabarber77: doesn't show hand
*** SUMMARY ***
Total pot $12.50 | Rake $0
Seat 1: Rabarber77 (button) collected ($12.50)
Seat 2: RAidakCo (small blind) folded before Flop
Seat 3: IdrinkBEERI (big blind) folded before Flop
Seat 4: supbigdiaper folded before Flop (didn't bet)
Seat 5: Yaaaazz folded before Flop (didn't bet)


PokerStars Hand #222986014740:  Hold'em No Limit ($2.50/$5.00 USD) - 2021/01/23 23:51:35 ET
Table 'Aaltje II' 6-max Seat #2 is the button
Seat 1: Rabarber77 ($2784.83 in chips)
Seat 2: RAidakCo ($563.59 in chips)
Seat 3: IdrinkBEERI ($500 in chips)
Seat 4: supbigdiaper ($697.22 in chips)
Seat 5: Yaaaazz ($766.30 in chips)
IdrinkBEERI: posts small blind $2.50
Labuns joins the table at seat #6
supbigdiaper: posts big blind $5
*** HOLE CARDS ***
Yaaaazz: folds
Rabarber77: raises $10 to $15
RAidakCo: folds
IdrinkBEERI: folds
supbigdiaper: calls $10
*** FLOP *** [As 6c Ts]
supbigdiaper: checks
Rabarber77: bets $15.44
supbigdiaper: calls $15.44
*** TURN *** [As 6c Ts] [7c]
supbigdiaper: checks
Rabarber77: checks
*** RIVER *** [As 6c Ts 7c] [9c]
supbigdiaper: bets $45.29
Rabarber77: folds
Uncalled bet ($45.29) returned to supbigdiaper
supbigdiaper collected $60.38 from pot
supbigdiaper: doesn't show hand
*** SUMMARY ***
Total pot $63.38 | Rake $3
Board [As 6c Ts 7c 9c]
Seat 1: Rabarber77 folded on the River
Seat 2: RAidakCo (button) folded before Flop (didn't bet)
Seat 3: IdrinkBEERI (small blind) folded before Flop
Seat 4: supbigdiaper (big blind) collected ($60.38)
Seat 5: Yaaaazz folded before Flop (didn't bet)


PokerStars Hand #222986030508:  Hold'em No Limit ($2.50/$5.00 USD) - 2021/01/23 23:52:32 ET
Table 'Aaltje II' 6-max Seat #3 is the button
Seat 1: Rabarber77 ($2754.39 in chips)
Seat 2: RAidakCo ($563.59 in chips)
Seat 3: IdrinkBEERI ($500 in chips)
Seat 4: supbigdiaper ($727.16 in chips)
Seat 5: Yaaaazz ($766.30 in chips)
supbigdiaper: posts small blind $2.50
Yaaaazz: posts big blind $5
Labuns: sits out
*** HOLE CARDS ***
Rabarber77: folds
RAidakCo: raises $6 to $11
IdrinkBEERI: folds
supbigdiaper: folds
Yaaaazz: folds
Uncalled bet ($6) returned to RAidakCo
RAidakCo collected $12.50 from pot
RAidakCo: doesn't show hand
*** SUMMARY ***
Total pot $12.50 | Rake $0
Seat 1: Rabarber77 folded before Flop (didn't bet)
Seat 2: RAidakCo collected ($12.50)
Seat 3: IdrinkBEERI (button) folded before Flop (didn't bet)
Seat 4: supbigdiaper (small blind) folded before Flop
Seat 5: Yaaaazz (big blind) folded before Flop


PokerStars Hand #222986034300:  Hold'em No Limit ($2.50/$5.00 USD) - 2021/01/23 23:52:46 ET
Table 'Aaltje II' 6-max Seat #4 is the button
Seat 1: Rabarber77 ($2754.39 in chips)
Seat 2: RAidakCo ($571.09 in chips)
Seat 3: IdrinkBEERI ($500 in chips)
Seat 4: supbigdiaper ($724.66 in chips)
Seat 5: Yaaaazz ($761.30 in chips)
Seat 6: Labuns ($500 in chips)
Yaaaazz: posts small blind $2.50
Labuns: posts big blind $5
*** HOLE CARDS ***
Rabarber77: raises $10 to $15
RAidakCo: raises $35 to $50
IdrinkBEERI: folds
supbigdiaper: calls $50
Yaaaazz: folds
Labuns: raises $450 to $500 and is all-in
Rabarber77: folds
RAidakCo: folds
supbigdiaper: folds
Uncalled bet ($450) returned to Labuns
Labuns collected $167.50 from pot
Labuns: doesn't show hand
*** SUMMARY ***
Total pot $167.50 | Rake $0
Seat 1: Rabarber77 folded before Flop
Seat 2: RAidakCo folded before Flop
Seat 3: IdrinkBEERI folded before Flop (didn't bet)
Seat 4: supbigdiaper (button) folded before Flop
Seat 5: Yaaaazz (small blind) folded before Flop
Seat 6: Labuns (big blind) collected ($167.50)


PokerStars Hand #222986046564:  Hold'em No Limit ($2.50/$5.00 USD) - 2021/01/23 23:53:31 ET
Table 'Aaltje II' 6-max Seat #5 is the button
Seat 1: Rabarber77 ($2739.39 in chips)
Seat 2: RAidakCo ($521.09 in chips)
Seat 3: IdrinkBEERI ($500 in chips)
Seat 4: supbigdiaper ($674.66 in chips)
Seat 5: Yaaaazz ($758.80 in chips)
Seat 6: Labuns ($617.50 in chips)
Labuns: posts small blind $2.50
Rabarber77: posts big blind $5
*** HOLE CARDS ***
RAidakCo: folds
IdrinkBEERI: folds
supbigdiaper: raises $7.50 to $12.50
Yaaaazz: folds
Labuns: folds
Rabarber77: calls $7.50
*** FLOP *** [8c 8h 9d]
Rabarber77: checks
supbigdiaper: bets $8.62
Rabarber77: folds
Uncalled bet ($8.62) returned to supbigdiaper
supbigdiaper collected $26.12 from pot
supbigdiaper: doesn't show hand
*** SUMMARY ***
Total pot $27.50 | Rake $1.38
Board [8c 8h 9d]
Seat 1: Rabarber77 (big blind) folded on the Flop
Seat 2: RAidakCo folded before Flop (didn't bet)
Seat 3: IdrinkBEERI folded before Flop (didn't bet)
Seat 4: supbigdiaper collected ($26.12)
Seat 5: Yaaaazz (button) folded before Flop (didn't bet)
Seat 6: Labuns (small blind) folded before Flop


PokerStars Hand #222986052619:  Hold'em No Limit ($2.50/$5.00 USD) - 2021/01/23 23:53:53 ET
Table 'Aaltje II' 6-max Seat #6 is the button
Seat 1: Rabarber77 ($2726.89 in chips)
Seat 2: RAidakCo ($521.09 in chips)
Seat 3: IdrinkBEERI ($500 in chips)
Seat 4: supbigdiaper ($688.28 in chips)
Seat 5: Yaaaazz ($758.80 in chips)
Seat 6: Labuns ($615 in chips)
Rabarber77: posts small blind $2.50
RAidakCo: posts big blind $5
*** HOLE CARDS ***
IdrinkBEERI: folds
supbigdiaper: raises $7.50 to $12.50
Yaaaazz: folds
Labuns: folds
Rabarber77: raises $7.50 to $20
RAidakCo: calls $15
supbigdiaper: raises $60.60 to $80.60
Rabarber77: calls $60.60
RAidakCo: folds
*** FLOP *** [Th 6h Kh]
Rabarber77: checks
supbigdiaper: bets $58.81
Rabarber77: calls $58.81
*** TURN *** [Th 6h Kh] [5d]
Rabarber77: checks
supbigdiaper: bets $105
Rabarber77: folds
Uncalled bet ($105) returned to supbigdiaper
supbigdiaper collected $295.82 from pot
supbigdiaper: doesn't show hand
*** SUMMARY ***
Total pot $298.82 | Rake $3
Board [Th 6h Kh 5d]
Seat 1: Rabarber77 (small blind) folded on the Turn
Seat 2: RAidakCo (big blind) folded before Flop
Seat 3: IdrinkBEERI folded before Flop (didn't bet)
Seat 4: supbigdiaper collected ($295.82)
Seat 5: Yaaaazz folded before Flop (didn't bet)
Seat 6: Labuns (button) folded before Flop (didn't bet)


PokerStars Hand #222986073104:  Hold'em No Limit ($2.50/$5.00 USD) - 2021/01/23 23:55:09 ET
Table 'Aaltje II' 6-max Seat #1 is the button
Seat 1: Rabarber77 ($2587.48 in chips)
Seat 2: RAidakCo ($501.09 in chips)
Seat 3: IdrinkBEERI ($500 in chips)
Seat 4: supbigdiaper ($844.69 in chips)
Seat 5: Yaaaazz ($758.80 in chips)
Seat 6: Labuns ($615 in chips)
RAidakCo: posts small blind $2.50
IdrinkBEERI: posts big blind $5
*** HOLE CARDS ***
supbigdiaper: folds
Yaaaazz: folds
Labuns: folds
Rabarber77: raises $10 to $15
RAidakCo: folds
IdrinkBEERI: raises $60 to $75
Rabarber77: folds
Uncalled bet ($60) returned to IdrinkBEERI
IdrinkBEERI collected $32.50 from pot
IdrinkBEERI: doesn't show hand
*** SUMMARY ***
Total pot $32.50 | Rake $0
Seat 1: Rabarber77 (button) folded before Flop
Seat 2: RAidakCo (small blind) folded before Flop
Seat 3: IdrinkBEERI (big blind) collected ($32.50)
Seat 4: supbigdiaper folded before Flop (didn't bet)
Seat 5: Yaaaazz folded before Flop (didn't bet)
Seat 6: Labuns folded before Flop (didn't bet)


PokerStars Hand #222986079903:  Hold'em No Limit ($2.50/$5.00 USD) - 2021/01/23 23:55:42 ET
Table 'Aaltje II' 6-max Seat #2 is the button
Seat 1: Rabarber77 ($2572.48 in chips)
Seat 2: RAidakCo ($500 in chips)
Seat 3: IdrinkBEERI ($517.50 in chips)
Seat 4: supbigdiaper ($844.69 in chips)
Seat 5: Yaaaazz ($758.80 in chips)
Seat 6: Labuns ($615 in chips)
IdrinkBEERI: posts small blind $2.50
supbigdiaper: posts big blind $5
*** HOLE CARDS ***
Yaaaazz: folds
Labuns: folds
Rabarber77: folds
RAidakCo: raises $7.50 to $12.50
IdrinkBEERI: folds
supbigdiaper: folds
Uncalled bet ($7.50) returned to RAidakCo
RAidakCo collected $12.50 from pot
RAidakCo: doesn't show hand
*** SUMMARY ***
Total pot $12.50 | Rake $0
Seat 1: Rabarber77 folded before Flop (didn't bet)
Seat 2: RAidakCo (button) collected ($12.50)
Seat 3: IdrinkBEERI (small blind) folded before Flop
Seat 4: supbigdiaper (big blind) folded before Flop
Seat 5: Yaaaazz folded before Flop (didn't bet)
Seat 6: Labuns folded before Flop (didn't bet)


PokerStars Hand #222986084120:  Hold'em No Limit ($2.50/$5.00 USD) - 2021/01/23 23:56:03 ET
Table 'Aaltje II' 6-max Seat #3 is the button
Seat 1: Rabarber77 ($2572.48 in chips)
Seat 2: RAidakCo ($507.50 in chips)
Seat 3: IdrinkBEERI ($515 in chips)
Seat 4: supbigdiaper ($839.69 in chips)
Seat 5: Yaaaazz ($758.80 in chips)
Seat 6: Labuns ($615 in chips)
supbigdiaper: posts small blind $2.50
Yaaaazz: posts big blind $5
*** HOLE CARDS ***
Labuns: folds
Rabarber77: raises $10 to $15
RAidakCo: folds
IdrinkBEERI: folds
supbigdiaper: folds
Yaaaazz: raises $55 to $70
Rabarber77: calls $55
*** FLOP *** [Qs Kc 3s]
Yaaaazz: bets $111.60
Rabarber77: calls $111.60
*** TURN *** [Qs Kc 3s] [8h]
Yaaaazz: checks
Rabarber77: bets $2390.88 and is all-in
Yaaaazz: calls $577.20 and is all-in
Uncalled bet ($1813.68) returned to Rabarber77
*** RIVER *** [Qs Kc 3s 8h] [9s]
*** SHOW DOWN ***
Yaaaazz: shows [Kh As] (a pair of Kings)
Rabarber77: shows [Qc 8c] (two pair, Queens and Eights)
Rabarber77 collected $1517.10 from pot
*** SUMMARY ***
Total pot $1520.10 | Rake $3
Board [Qs Kc 3s 8h 9s]
Seat 1: Rabarber77 showed [Qc 8c] and won ($1517.10) with two pair, Queens and Eights
Seat 2: RAidakCo folded before Flop (didn't bet)
Seat 3: IdrinkBEERI (button) folded before Flop (didn't bet)
Seat 4: supbigdiaper (small blind) folded before Flop
Seat 5: Yaaaazz (big blind) showed [Kh As] and lost with a pair of Kings
Seat 6: Labuns folded before Flop (didn't bet)


PokerStars Hand #222986093432:  Hold'em No Limit ($2.50/$5.00 USD) - 2021/01/23 23:56:49 ET
Table 'Aaltje II' 6-max Seat #4 is the button
Seat 1: Rabarber77 ($3330.78 in chips)
Seat 2: RAidakCo ($507.50 in chips)
Seat 3: IdrinkBEERI ($515 in chips)
Seat 4: supbigdiaper ($837.19 in chips)
Seat 5: Yaaaazz ($500 in chips)
Seat 6: Labuns ($615 in chips)
Yaaaazz: posts small blind $2.50
Labuns: posts big blind $5
*** HOLE CARDS ***
Rabarber77: raises $10 to $15
RAidakCo: folds
IdrinkBEERI: folds
supbigdiaper: folds
Yaaaazz: folds
Labuns: calls $10
*** FLOP *** [Tc 9c 4d]
Labuns: checks
Rabarber77: bets $15.44
Labuns: folds
Uncalled bet ($15.44) returned to Rabarber77
Rabarber77 collected $30.88 from pot
Rabarber77: doesn't show hand
*** SUMMARY ***
Total pot $32.50 | Rake $1.62
Board [Tc 9c 4d]
Seat 1: Rabarber77 collected ($30.88)
Seat 2: RAidakCo folded before Flop (didn't bet)
Seat 3: IdrinkBEERI folded before Flop (didn't bet)
Seat 4: supbigdiaper (button) folded before Flop (didn't bet)
Seat 5: Yaaaazz (small blind) folded before Flop
Seat 6: Labuns (big blind) folded on the Flop


PokerStars Hand #222986108014:  Hold'em No Limit ($2.50/$5.00 USD) - 2021/01/23 23:58:00 ET
Table 'Aaltje II' 6-max Seat #6 is the button
Seat 1: Rabarber77 ($3390.16 in chips)
Seat 2: RAidakCo ($507.50 in chips)
Seat 3: IdrinkBEERI ($515 in chips)
Seat 4: supbigdiaper ($805.69 in chips)
Seat 5: Yaaaazz ($500 in chips)
Seat 6: Labuns ($597.50 in chips)
Rabarber77: posts small blind $2.50
RAidakCo: posts big blind $5
*** HOLE CARDS ***
IdrinkBEERI: raises $11.20 to $16.20
supbigdiaper: folds
Yaaaazz: folds
Labuns: folds
Rabarber77: folds
RAidakCo: folds
Uncalled bet ($11.20) returned to IdrinkBEERI
IdrinkBEERI collected $12.50 from pot
IdrinkBEERI: doesn't show hand
*** SUMMARY ***
Total pot $12.50 | Rake $0
Seat 1: Rabarber77 (small blind) folded before Flop
Seat 2: RAidakCo (big blind) folded before Flop
Seat 3: IdrinkBEERI collected ($12.50)
Seat 4: supbigdiaper folded before Flop (didn't bet)
Seat 5: Yaaaazz folded before Flop (didn't bet)
Seat 6: Labuns (button) folded before Flop (didn't bet)


PokerStars Hand #222986098732:  Hold'em No Limit ($2.50/$5.00 USD) - 2021/01/23 23:57:14 ET
Table 'Aaltje II' 6-max Seat #5 is the button
Seat 1: Rabarber77 ($3346.66 in chips)
Seat 2: RAidakCo ($507.50 in chips)
Seat 3: IdrinkBEERI ($515 in chips)
Seat 4: supbigdiaper ($837.19 in chips)
Seat 5: Yaaaazz ($500 in chips)
Seat 6: Labuns ($600 in chips)
Labuns: posts small blind $2.50
Rabarber77: posts big blind $5
*** HOLE CARDS ***
RAidakCo: folds
IdrinkBEERI: folds
supbigdiaper: raises $7.50 to $12.50
Yaaaazz: calls $12.50
Labuns: folds
Rabarber77: calls $7.50
*** FLOP *** [5d 6c 4c]
Rabarber77: checks
supbigdiaper: checks
Yaaaazz: checks
*** TURN *** [5d 6c 4c] [Kc]
Rabarber77: bets $19
supbigdiaper: calls $19
Yaaaazz: folds
*** RIVER *** [5d 6c 4c Kc] [4d]
Rabarber77: bets $75
supbigdiaper: folds
Uncalled bet ($75) returned to Rabarber77
Rabarber77 collected $75 from pot
Rabarber77: doesn't show hand
*** SUMMARY ***
Total pot $78 | Rake $3
Board [5d 6c 4c Kc 4d]
Seat 1: Rabarber77 (big blind) collected ($75)
Seat 2: RAidakCo folded before Flop (didn't bet)
Seat 3: IdrinkBEERI folded before Flop (didn't bet)
Seat 4: supbigdiaper folded on the River
Seat 5: Yaaaazz (button) folded on the Turn
Seat 6: Labuns (small blind) folded before Flop


PokerStars Hand #222986109915:  Hold'em No Limit ($2.50/$5.00 USD) - 2021/01/23 23:58:09 ET
Table 'Aaltje II' 6-max Seat #1 is the button
Seat 1: Rabarber77 ($3387.66 in chips)
Seat 2: RAidakCo ($502.50 in chips)
Seat 3: IdrinkBEERI ($522.50 in chips)
Seat 4: supbigdiaper ($805.69 in chips)
Seat 5: Yaaaazz ($500 in chips)
Seat 6: Labuns ($597.50 in chips)
RAidakCo: posts small blind $2.50
IdrinkBEERI: posts big blind $5
*** HOLE CARDS ***
supbigdiaper: folds
Yaaaazz: folds
Labuns: folds
Rabarber77: raises $10 to $15
RAidakCo: folds
IdrinkBEERI: folds
Uncalled bet ($10) returned to Rabarber77
Rabarber77 collected $12.50 from pot
Rabarber77: doesn't show hand
*** SUMMARY ***
Total pot $12.50 | Rake $0
Seat 1: Rabarber77 (button) collected ($12.50)
Seat 2: RAidakCo (small blind) folded before Flop
Seat 3: IdrinkBEERI (big blind) folded before Flop
Seat 4: supbigdiaper folded before Flop (didn't bet)
Seat 5: Yaaaazz folded before Flop (didn't bet)
Seat 6: Labuns folded before Flop (didn't bet)


PokerStars Hand #222986113030:  Hold'em No Limit ($2.50/$5.00 USD) - 2021/01/23 23:58:24 ET
Table 'Aaltje II' 6-max Seat #2 is the button
Seat 1: Rabarber77 ($3395.16 in chips)
Seat 2: RAidakCo ($500 in chips)
Seat 3: IdrinkBEERI ($517.50 in chips)
Seat 4: supbigdiaper ($805.69 in chips)
Seat 5: Yaaaazz ($500 in chips)
Seat 6: Labuns ($597.50 in chips)
IdrinkBEERI: posts small blind $2.50
supbigdiaper: posts big blind $5
*** HOLE CARDS ***
Yaaaazz: folds
Labuns: folds
Rabarber77: folds
RAidakCo: folds
IdrinkBEERI: folds
Uncalled bet ($2.50) returned to supbigdiaper
supbigdiaper collected $5 from pot
supbigdiaper: doesn't show hand
*** SUMMARY ***
Total pot $5 | Rake $0
Seat 1: Rabarber77 folded before Flop (didn't bet)
Seat 2: RAidakCo (button) folded before Flop (didn't bet)
Seat 3: IdrinkBEERI (small blind) folded before Flop
Seat 4: supbigdiaper (big blind) collected ($5)
Seat 5: Yaaaazz folded before Flop (didn't bet)
Seat 6: Labuns folded before Flop (didn't bet)


PokerStars Hand #222986115070:  Hold'em No Limit ($2.50/$5.00 USD) - 2021/01/23 23:58:34 ET
Table 'Aaltje II' 6-max Seat #3 is the button
Seat 1: Rabarber77 ($3395.16 in chips)
Seat 2: RAidakCo ($500 in chips)
Seat 3: IdrinkBEERI ($515 in chips)
Seat 4: supbigdiaper ($808.19 in chips)
Seat 5: Yaaaazz ($500 in chips)
Seat 6: Labuns ($597.50 in chips)
supbigdiaper: posts small blind $2.50
Yaaaazz: posts big blind $5
*** HOLE CARDS ***
Labuns: folds
Rabarber77: raises $10 to $15
RAidakCo: folds
IdrinkBEERI: raises $45 to $60
supbigdiaper: folds
Yaaaazz: folds
Rabarber77: calls $45
*** FLOP *** [6c 7s 3c]
Rabarber77: checks
IdrinkBEERI: checks
*** TURN *** [6c 7s 3c] [7c]
Rabarber77: bets $40
IdrinkBEERI: calls $40
*** RIVER *** [6c 7s 3c 7c] [2c]
Rabarber77: bets $100
IdrinkBEERI: folds
Uncalled bet ($100) returned to Rabarber77
Rabarber77 collected $204.50 from pot
Rabarber77: doesn't show hand
*** SUMMARY ***
Total pot $207.50 | Rake $3
Board [6c 7s 3c 7c 2c]
Seat 1: Rabarber77 collected ($204.50)
Seat 2: RAidakCo folded before Flop (didn't bet)
Seat 3: IdrinkBEERI (button) folded on the River
Seat 4: supbigdiaper (small blind) folded before Flop
Seat 5: Yaaaazz (big blind) folded before Flop
Seat 6: Labuns folded before Flop (didn't bet)


PokerStars Hand #222986141884:  Hold'em No Limit ($2.50/$5.00 USD) - 2021/01/24 0:00:01 ET
Table 'Aaltje II' 6-max Seat #4 is the button
Seat 1: Rabarber77 ($3499.66 in chips)
Seat 2: RAidakCo ($500 in chips)
Seat 3: IdrinkBEERI ($500 in chips)
Seat 4: supbigdiaper ($805.69 in chips)
Seat 5: Yaaaazz ($500 in chips)
Seat 6: Labuns ($597.50 in chips)
Yaaaazz: posts small blind $2.50
Labuns: posts big blind $5
*** HOLE CARDS ***
Rabarber77: folds
RAidakCo: raises $6 to $11
IdrinkBEERI: folds
supbigdiaper: folds
Yaaaazz: folds
Labuns: folds
Uncalled bet ($6) returned to RAidakCo
RAidakCo collected $12.50 from pot
RAidakCo: doesn't show hand
*** SUMMARY ***
Total pot $12.50 | Rake $0
Seat 1: Rabarber77 folded before Flop (didn't bet)
Seat 2: RAidakCo collected ($12.50)
Seat 3: IdrinkBEERI folded before Flop (didn't bet)
Seat 4: supbigdiaper (button) folded before Flop (didn't bet)
Seat 5: Yaaaazz (small blind) folded before Flop
Seat 6: Labuns (big blind) folded before Flop


PokerStars Hand #222986148009:  Hold'em No Limit ($2.50/$5.00 USD) - 2021/01/24 0:00:27 ET
Table 'Aaltje II' 6-max Seat #5 is the button
Seat 1: Rabarber77 ($3499.66 in chips)
Seat 2: RAidakCo ($507.50 in chips)
Seat 3: IdrinkBEERI ($500 in chips)
Seat 4: supbigdiaper ($805.69 in chips)
Seat 5: Yaaaazz ($500 in chips)
Seat 6: Labuns ($592.50 in chips)
Labuns: posts small blind $2.50
Rabarber77: posts big blind $5
*** HOLE CARDS ***
RAidakCo: folds
IdrinkBEERI: folds
supbigdiaper: raises $7.50 to $12.50
Yaaaazz: raises $25 to $37.50
Labuns: folds
Rabarber77: folds
supbigdiaper: folds
Uncalled bet ($25) returned to Yaaaazz
Yaaaazz collected $32.50 from pot
Yaaaazz: doesn't show hand
*** SUMMARY ***
Total pot $32.50 | Rake $0
Seat 1: Rabarber77 (big blind) folded before Flop
Seat 2: RAidakCo folded before Flop (didn't bet)
Seat 3: IdrinkBEERI folded before Flop (didn't bet)
Seat 4: supbigdiaper folded before Flop
Seat 5: Yaaaazz (button) collected ($32.50)
Seat 6: Labuns (small blind) folded before Flop


PokerStars Hand #222986150349:  Hold'em No Limit ($2.50/$5.00 USD) - 2021/01/24 0:00:36 ET
Table 'Aaltje II' 6-max Seat #6 is the button
Seat 1: Rabarber77 ($3494.66 in chips)
Seat 2: RAidakCo ($507.50 in chips)
Seat 3: IdrinkBEERI ($500 in chips)
Seat 4: supbigdiaper ($793.19 in chips)
Seat 5: Yaaaazz ($520 in chips)
Seat 6: Labuns ($590 in chips)
Rabarber77: posts small blind $2.50
RAidakCo: posts big blind $5
*** HOLE CARDS ***
IdrinkBEERI: folds
supbigdiaper: folds
Yaaaazz: folds
Labuns: raises $7.25 to $12.25
Rabarber77: calls $9.75
RAidakCo: calls $7.25
*** FLOP *** [5c Js 3s]
Rabarber77: checks
RAidakCo: checks
Labuns: bets $10.47
Rabarber77: calls $10.47
RAidakCo: folds
*** TURN *** [5c Js 3s] [2d]
Rabarber77: checks
Labuns: checks
*** RIVER *** [5c Js 3s 2d] [4s]
Rabarber77: bets $27.41
Labuns: folds
Uncalled bet ($27.41) returned to Rabarber77
Rabarber77 collected $54.81 from pot
Rabarber77: doesn't show hand
*** SUMMARY ***
Total pot $57.69 | Rake $2.88
Board [5c Js 3s 2d 4s]
Seat 1: Rabarber77 (small blind) collected ($54.81)
Seat 2: RAidakCo (big blind) folded on the Flop
Seat 3: IdrinkBEERI folded before Flop (didn't bet)
Seat 4: supbigdiaper folded before Flop (didn't bet)
Seat 5: Yaaaazz folded before Flop (didn't bet)
Seat 6: Labuns (button) folded on the River


PokerStars Hand #222986164372:  Hold'em No Limit ($2.50/$5.00 USD) - 2021/01/24 0:01:31 ET
Table 'Aaltje II' 6-max Seat #1 is the button
Seat 1: Rabarber77 ($3526.75 in chips)
Seat 2: RAidakCo ($500 in chips)
Seat 3: IdrinkBEERI ($500 in chips)
Seat 4: supbigdiaper ($793.19 in chips)
Seat 5: Yaaaazz ($520 in chips)
Seat 6: Labuns ($567.28 in chips)
RAidakCo: posts small blind $2.50
IdrinkBEERI: posts big blind $5
*** HOLE CARDS ***
supbigdiaper: folds
Yaaaazz: folds
Labuns: folds
Rabarber77: folds
RAidakCo: folds
Uncalled bet ($2.50) returned to IdrinkBEERI
IdrinkBEERI collected $5 from pot
IdrinkBEERI: doesn't show hand
*** SUMMARY ***
Total pot $5 | Rake $0
Seat 1: Rabarber77 (button) folded before Flop (didn't bet)
Seat 2: RAidakCo (small blind) folded before Flop
Seat 3: IdrinkBEERI (big blind) collected ($5)
Seat 4: supbigdiaper folded before Flop (didn't bet)
Seat 5: Yaaaazz folded before Flop (didn't bet)
Seat 6: Labuns folded before Flop (didn't bet)


PokerStars Hand #222986167058:  Hold'em No Limit ($2.50/$5.00 USD) - 2021/01/24 0:01:41 ET
Table 'Aaltje II' 6-max Seat #2 is the button
Seat 1: Rabarber77 ($3526.75 in chips)
Seat 2: RAidakCo ($500 in chips)
Seat 3: IdrinkBEERI ($502.50 in chips)
Seat 4: supbigdiaper ($793.19 in chips)
Seat 5: Yaaaazz ($520 in chips)
Seat 6: Labuns ($567.28 in chips)
IdrinkBEERI: posts small blind $2.50
supbigdiaper: posts big blind $5
*** HOLE CARDS ***
Yaaaazz: folds
Labuns: raises $5.50 to $10.50
Rabarber77: folds
RAidakCo: folds
IdrinkBEERI: folds
supbigdiaper: calls $5.50
*** FLOP *** [Qs Qc 3h]
supbigdiaper: checks
Labuns: bets $6.70
supbigdiaper: folds
Uncalled bet ($6.70) returned to Labuns
Labuns collected $22.32 from pot
Labuns: doesn't show hand
*** SUMMARY ***
Total pot $23.50 | Rake $1.18
Board [Qs Qc 3h]
Seat 1: Rabarber77 folded before Flop (didn't bet)
Seat 2: RAidakCo (button) folded before Flop (didn't bet)
Seat 3: IdrinkBEERI (small blind) folded before Flop
Seat 4: supbigdiaper (big blind) folded on the Flop
Seat 5: Yaaaazz folded before Flop (didn't bet)
Seat 6: Labuns collected ($22.32)


PokerStars Hand #222986176538:  Hold'em No Limit ($2.50/$5.00 USD) - 2021/01/24 0:02:18 ET
Table 'Aaltje II' 6-max Seat #3 is the button
Seat 1: Rabarber77 ($3526.75 in chips)
Seat 2: RAidakCo ($500 in chips)
Seat 3: IdrinkBEERI ($500 in chips)
Seat 4: supbigdiaper ($782.69 in chips)
Seat 5: Yaaaazz ($520 in chips)
Seat 6: Labuns ($579.10 in chips)
supbigdiaper: posts small blind $2.50
Yaaaazz: posts big blind $5
*** HOLE CARDS ***
Labuns: raises $5.50 to $10.50
Rabarber77: folds
RAidakCo: folds
IdrinkBEERI: folds
supbigdiaper: folds
Yaaaazz: calls $5.50
*** FLOP *** [Kd Jd 2d]
Yaaaazz: checks
Labuns: checks
*** TURN *** [Kd Jd 2d] [3d]
Yaaaazz: checks
Labuns: checks
*** RIVER *** [Kd Jd 2d 3d] [9s]
Yaaaazz: bets $17.86
Labuns: calls $17.86
*** SHOW DOWN ***
Yaaaazz: shows [Ts 7s] (high card King)
Labuns: shows [7h 7d] (a flush, King high)
Labuns collected $56.26 from pot
*** SUMMARY ***
Total pot $59.22 | Rake $2.96
Board [Kd Jd 2d 3d 9s]
Seat 1: Rabarber77 folded before Flop (didn't bet)
Seat 2: RAidakCo folded before Flop (didn't bet)
Seat 3: IdrinkBEERI (button) folded before Flop (didn't bet)
Seat 4: supbigdiaper (small blind) folded before Flop
Seat 5: Yaaaazz (big blind) showed [Ts 7s] and lost with high card King
Seat 6: Labuns showed [7h 7d] and won ($56.26) with a flush, King high


PokerStars Hand #222986192219:  Hold'em No Limit ($2.50/$5.00 USD) - 2021/01/24 0:03:18 ET
Table 'Aaltje II' 6-max Seat #4 is the button
Seat 1: Rabarber77 ($3526.75 in chips)
Seat 2: RAidakCo ($500 in chips)
Seat 3: IdrinkBEERI ($500 in chips)
Seat 4: supbigdiaper ($780.19 in chips)
Seat 5: Yaaaazz ($500 in chips)
Seat 6: Labuns ($607 in chips)
Yaaaazz: posts small blind $2.50
Labuns: posts big blind $5
*** HOLE CARDS ***
Rabarber77: folds
RAidakCo: folds
IdrinkBEERI: raises $11.25 to $16.25
supbigdiaper: folds
Yaaaazz: folds
Labuns: raises $43.75 to $60
IdrinkBEERI: calls $43.75
*** FLOP *** [7d 7s 5d]
Labuns: bets $69.31
IdrinkBEERI: calls $69.31
*** TURN *** [7d 7s 5d] [8s]
Labuns: bets $477.69 and is all-in
IdrinkBEERI: calls $370.69 and is all-in
Uncalled bet ($107) returned to Labuns
*** FIRST RIVER *** [7d 7s 5d 8s] [9h]
*** SECOND RIVER *** [7d 7s 5d 8s] [3s]
*** FIRST SHOW DOWN ***
Labuns: shows [Tc Jc] (a straight, Seven to Jack)
IdrinkBEERI: shows [6c 6s] (a straight, Five to Nine)
Labuns collected $499.75 from pot
*** SECOND SHOW DOWN ***
Labuns: shows [Tc Jc] (a pair of Sevens)
IdrinkBEERI: shows [6c 6s] (two pair, Sevens and Sixes)
IdrinkBEERI collected $499.75 from pot
*** SUMMARY ***
Total pot $1002.50 | Rake $3
Hand was run twice
FIRST Board [7d 7s 5d 8s 9h]
SECOND Board [7d 7s 5d 8s 3s]
Seat 1: Rabarber77 folded before Flop (didn't bet)
Seat 2: RAidakCo folded before Flop (didn't bet)
Seat 3: IdrinkBEERI showed [6c 6s] and lost with a straight, Five to Nine, and won ($499.75) with two pair, Sevens and Sixes
Seat 4: supbigdiaper (button) folded before Flop (didn't bet)
Seat 5: Yaaaazz (small blind) folded before Flop
Seat 6: Labuns (big blind) showed [Tc Jc] and won ($499.75) with a straight, Seven to Jack, and lost with a pair of Sevens


PokerStars Hand #222986216451:  Hold'em No Limit ($2.50/$5.00 USD) - 2021/01/24 0:04:51 ET
Table 'Aaltje II' 6-max Seat #5 is the button
Seat 1: Rabarber77 ($3526.75 in chips)
Seat 2: RAidakCo ($500 in chips)
Seat 3: IdrinkBEERI ($500 in chips)
Seat 4: supbigdiaper ($780.19 in chips)
Seat 5: Yaaaazz ($500 in chips)
Seat 6: Labuns ($606.75 in chips)
Labuns: posts small blind $2.50
Rabarber77: posts big blind $5
*** HOLE CARDS ***
RAidakCo: raises $6 to $11
IdrinkBEERI has timed out
IdrinkBEERI: folds
supbigdiaper: calls $11
Yaaaazz: folds
Labuns: folds
Rabarber77: calls $6
*** FLOP *** [6c 2d Qh]
Rabarber77: checks
RAidakCo: bets $10.12
supbigdiaper: folds
Rabarber77: folds
Uncalled bet ($10.12) returned to RAidakCo
RAidakCo collected $33.72 from pot
RAidakCo: doesn't show hand
*** SUMMARY ***
Total pot $35.50 | Rake $1.78
Board [6c 2d Qh]
Seat 1: Rabarber77 (big blind) folded on the Flop
Seat 2: RAidakCo collected ($33.72)
Seat 3: IdrinkBEERI folded before Flop (didn't bet)
Seat 4: supbigdiaper folded on the Flop
Seat 5: Yaaaazz (button) folded before Flop (didn't bet)
Seat 6: Labuns (small blind) folded before Flop


PokerStars Hand #222986226490:  Hold'em No Limit ($2.50/$5.00 USD) - 2021/01/24 0:05:29 ET
Table 'Aaltje II' 6-max Seat #6 is the button
Seat 1: Rabarber77 ($3515.75 in chips)
Seat 2: RAidakCo ($522.72 in chips)
Seat 3: IdrinkBEERI ($500 in chips)
Seat 4: supbigdiaper ($769.19 in chips)
Seat 5: Yaaaazz ($500 in chips)
Seat 6: Labuns ($604.25 in chips)
Rabarber77: posts small blind $2.50
RAidakCo: posts big blind $5
*** HOLE CARDS ***
IdrinkBEERI: raises $11.20 to $16.20
supbigdiaper: folds
Yaaaazz: folds
Labuns: raises $29.93 to $46.13
Rabarber77: folds
RAidakCo: folds
IdrinkBEERI: calls $29.93
*** FLOP *** [Qc Qh 7s]
IdrinkBEERI: checks
Labuns: bets $29.03
IdrinkBEERI: raises $78.96 to $107.99
Labuns: calls $78.96
*** TURN *** [Qc Qh 7s] [5c]
IdrinkBEERI: bets $345.88 and is all-in
Labuns: folds
Uncalled bet ($345.88) returned to IdrinkBEERI
IdrinkBEERI collected $312.74 from pot
IdrinkBEERI: doesn't show hand
*** SUMMARY ***
Total pot $315.74 | Rake $3
Board [Qc Qh 7s 5c]
Seat 1: Rabarber77 (small blind) folded before Flop
Seat 2: RAidakCo (big blind) folded before Flop
Seat 3: IdrinkBEERI collected ($312.74)
Seat 4: supbigdiaper folded before Flop (didn't bet)
Seat 5: Yaaaazz folded before Flop (didn't bet)
Seat 6: Labuns (button) folded on the Turn


PokerStars Hand #222986245819:  Hold'em No Limit ($2.50/$5.00 USD) - 2021/01/24 0:06:44 ET
Table 'Aaltje II' 6-max Seat #1 is the button
Seat 1: Rabarber77 ($3513.25 in chips)
Seat 2: RAidakCo ($517.72 in chips)
Seat 3: IdrinkBEERI ($658.62 in chips)
Seat 4: supbigdiaper ($769.19 in chips)
Seat 5: Yaaaazz ($500 in chips)
Seat 6: Labuns ($500 in chips)
RAidakCo: posts small blind $2.50
IdrinkBEERI: posts big blind $5
*** HOLE CARDS ***
supbigdiaper: folds
Yaaaazz: folds
Labuns: folds
Rabarber77: raises $10 to $15
RAidakCo: raises $45 to $60
IdrinkBEERI: folds
Rabarber77: calls $45
*** FLOP *** [2h Tc 6s]
RAidakCo: bets $36.60
Rabarber77: raises $66.60 to $103.20
RAidakCo: calls $66.60
*** TURN *** [2h Tc 6s] [5c]
RAidakCo: checks
Rabarber77: checks
*** RIVER *** [2h Tc 6s 5c] [Td]
RAidakCo: checks
Rabarber77: checks
*** SHOW DOWN ***
RAidakCo: shows [Ac Jd] (a pair of Tens)
Rabarber77: mucks hand
RAidakCo collected $328.40 from pot
*** SUMMARY ***
Total pot $331.40 | Rake $3
Board [2h Tc 6s 5c Td]
Seat 1: Rabarber77 (button) mucked
Seat 2: RAidakCo (small blind) showed [Ac Jd] and won ($328.40) with a pair of Tens
Seat 3: IdrinkBEERI (big blind) folded before Flop
Seat 4: supbigdiaper folded before Flop (didn't bet)
Seat 5: Yaaaazz folded before Flop (didn't bet)
Seat 6: Labuns folded before Flop (didn't bet)


PokerStars Hand #222986263166:  Hold'em No Limit ($2.50/$5.00 USD) - 2021/01/24 0:07:52 ET
Table 'Aaltje II' 6-max Seat #2 is the button
Seat 1: Rabarber77 ($3350.05 in chips)
Seat 2: RAidakCo ($682.92 in chips)
Seat 3: IdrinkBEERI ($653.62 in chips)
Seat 4: supbigdiaper ($769.19 in chips)
Seat 5: Yaaaazz ($500 in chips)
Seat 6: Labuns ($500 in chips)
IdrinkBEERI: posts small blind $2.50
supbigdiaper: posts big blind $5
*** HOLE CARDS ***
Yaaaazz: folds
Labuns: folds
Rabarber77: folds
RAidakCo: folds
IdrinkBEERI: folds
Uncalled bet ($2.50) returned to supbigdiaper
supbigdiaper collected $5 from pot
supbigdiaper: doesn't show hand
*** SUMMARY ***
Total pot $5 | Rake $0
Seat 1: Rabarber77 folded before Flop (didn't bet)
Seat 2: RAidakCo (button) folded before Flop (didn't bet)
Seat 3: IdrinkBEERI (small blind) folded before Flop
Seat 4: supbigdiaper (big blind) collected ($5)
Seat 5: Yaaaazz folded before Flop (didn't bet)
Seat 6: Labuns folded before Flop (didn't bet)


PokerStars Hand #222986267328:  Hold'em No Limit ($2.50/$5.00 USD) - 2021/01/24 0:08:08 ET
Table 'Aaltje II' 6-max Seat #3 is the button
Seat 1: Rabarber77 ($3350.05 in chips)
Seat 2: RAidakCo ($682.92 in chips)
Seat 3: IdrinkBEERI ($651.12 in chips)
Seat 4: supbigdiaper ($771.69 in chips)
Seat 5: Yaaaazz ($500 in chips)
Seat 6: Labuns ($500 in chips)
supbigdiaper: posts small blind $2.50
Yaaaazz: posts big blind $5
*** HOLE CARDS ***
Labuns: folds
Rabarber77: folds
RAidakCo: folds
IdrinkBEERI: raises $9.65 to $14.65
supbigdiaper: folds
Yaaaazz: folds
Uncalled bet ($9.65) returned to IdrinkBEERI
IdrinkBEERI collected $12.50 from pot
IdrinkBEERI: doesn't show hand
*** SUMMARY ***
Total pot $12.50 | Rake $0
Seat 1: Rabarber77 folded before Flop (didn't bet)
Seat 2: RAidakCo folded before Flop (didn't bet)
Seat 3: IdrinkBEERI (button) collected ($12.50)
Seat 4: supbigdiaper (small blind) folded before Flop
Seat 5: Yaaaazz (big blind) folded before Flop
Seat 6: Labuns folded before Flop (didn't bet)


PokerStars Hand #222986272328:  Hold'em No Limit ($2.50/$5.00 USD) - 2021/01/24 0:08:28 ET
Table 'Aaltje II' 6-max Seat #4 is the button
Seat 1: Rabarber77 ($3350.05 in chips)
Seat 2: RAidakCo ($682.92 in chips)
Seat 3: IdrinkBEERI ($658.62 in chips)
Seat 4: supbigdiaper ($769.19 in chips)
Seat 5: Yaaaazz ($500 in chips)
Seat 6: Labuns ($500 in chips)
Yaaaazz: posts small blind $2.50
Labuns: posts big blind $5
*** HOLE CARDS ***
Rabarber77: folds
RAidakCo: folds
IdrinkBEERI: folds
supbigdiaper: raises $7.50 to $12.50
Yaaaazz: raises $42.50 to $55
Labuns: folds
supbigdiaper: raises $72.50 to $127.50
Yaaaazz: folds
Uncalled bet ($72.50) returned to supbigdiaper
supbigdiaper collected $115 from pot
supbigdiaper: doesn't show hand
*** SUMMARY ***
Total pot $115 | Rake $0
Seat 1: Rabarber77 folded before Flop (didn't bet)
Seat 2: RAidakCo folded before Flop (didn't bet)
Seat 3: IdrinkBEERI folded before Flop (didn't bet)
Seat 4: supbigdiaper (button) collected ($115)
Seat 5: Yaaaazz (small blind) folded before Flop
Seat 6: Labuns (big blind) folded before Flop


PokerStars Hand #222986280523:  Hold'em No Limit ($2.50/$5.00 USD) - 2021/01/24 0:09:00 ET
Table 'Aaltje II' 6-max Seat #5 is the button
Seat 1: Rabarber77 ($3350.05 in chips)
Seat 2: RAidakCo ($682.92 in chips)
Seat 3: IdrinkBEERI ($658.62 in chips)
Seat 4: supbigdiaper ($829.19 in chips)
Seat 5: Yaaaazz ($500 in chips)
Seat 6: Labuns ($500 in chips)
Labuns: posts small blind $2.50
Rabarber77: posts big blind $5
*** HOLE CARDS ***
RAidakCo: folds
IdrinkBEERI: folds
supbigdiaper: folds
Yaaaazz: raises $7.50 to $12.50
Labuns: folds
Rabarber77: calls $7.50
*** FLOP *** [2d 4s 2h]
Rabarber77: checks
Yaaaazz: checks
*** TURN *** [2d 4s 2h] [5d]
Rabarber77: bets $26.12
Yaaaazz: folds
Uncalled bet ($26.12) returned to Rabarber77
Rabarber77 collected $26.12 from pot
Rabarber77: doesn't show hand
*** SUMMARY ***
Total pot $27.50 | Rake $1.38
Board [2d 4s 2h 5d]
Seat 1: Rabarber77 (big blind) collected ($26.12)
Seat 2: RAidakCo folded before Flop (didn't bet)
Seat 3: IdrinkBEERI folded before Flop (didn't bet)
Seat 4: supbigdiaper folded before Flop (didn't bet)
Seat 5: Yaaaazz (button) folded on the Turn
Seat 6: Labuns (small blind) folded before Flop


PokerStars Hand #222986293543:  Hold'em No Limit ($2.50/$5.00 USD) - 2021/01/24 0:09:51 ET
Table 'Aaltje II' 6-max Seat #6 is the button
Seat 1: Rabarber77 ($3363.67 in chips)
Seat 2: RAidakCo ($682.92 in chips)
Seat 3: IdrinkBEERI ($658.62 in chips)
Seat 4: supbigdiaper ($829.19 in chips)
Seat 5: Yaaaazz ($500 in chips)
Seat 6: Labuns ($500 in chips)
Rabarber77: posts small blind $2.50
RAidakCo: posts big blind $5
*** HOLE CARDS ***
IdrinkBEERI: folds
supbigdiaper: folds
Yaaaazz: folds
Labuns: folds
Rabarber77: raises $10 to $15
RAidakCo: calls $10
*** FLOP *** [Th Js 7s]
Rabarber77: bets $28.50
RAidakCo: calls $28.50
*** TURN *** [Th Js 7s] [Qd]
Rabarber77: bets $84
RAidakCo: folds
Uncalled bet ($84) returned to Rabarber77
Rabarber77 collected $84 from pot
Rabarber77: doesn't show hand
*** SUMMARY ***
Total pot $87 | Rake $3
Board [Th Js 7s Qd]
Seat 1: Rabarber77 (small blind) collected ($84)
Seat 2: RAidakCo (big blind) folded on the Turn
Seat 3: IdrinkBEERI folded before Flop (didn't bet)
Seat 4: supbigdiaper folded before Flop (didn't bet)
Seat 5: Yaaaazz folded before Flop (didn't bet)
Seat 6: Labuns (button) folded before Flop (didn't bet)


PokerStars Hand #222986301732:  Hold'em No Limit ($2.50/$5.00 USD) - 2021/01/24 0:10:23 ET
Table 'Aaltje II' 6-max Seat #1 is the button
Seat 1: Rabarber77 ($3404.17 in chips)
Seat 2: RAidakCo ($639.42 in chips)
Seat 3: IdrinkBEERI ($658.62 in chips)
Seat 4: supbigdiaper ($829.19 in chips)
Seat 5: Yaaaazz ($500 in chips)
Seat 6: Labuns ($500 in chips)
RAidakCo: posts small blind $2.50
IdrinkBEERI: posts big blind $5
*** HOLE CARDS ***
supbigdiaper: folds
Yaaaazz: folds
Labuns: raises $7.25 to $12.25
Rabarber77: folds
RAidakCo: folds
IdrinkBEERI: raises $57.75 to $70
Labuns: folds
Uncalled bet ($57.75) returned to IdrinkBEERI
IdrinkBEERI collected $27 from pot
IdrinkBEERI: doesn't show hand
*** SUMMARY ***
Total pot $27 | Rake $0
Seat 1: Rabarber77 (button) folded before Flop (didn't bet)
Seat 2: RAidakCo (small blind) folded before Flop
Seat 3: IdrinkBEERI (big blind) collected ($27)
Seat 4: supbigdiaper folded before Flop (didn't bet)
Seat 5: Yaaaazz folded before Flop (didn't bet)
Seat 6: Labuns folded before Flop


PokerStars Hand #222986308825:  Hold'em No Limit ($2.50/$5.00 USD) - 2021/01/24 0:10:51 ET
Table 'Aaltje II' 6-max Seat #2 is the button
Seat 1: Rabarber77 ($3404.17 in chips)
Seat 2: RAidakCo ($636.92 in chips)
Seat 3: IdrinkBEERI ($673.37 in chips)
Seat 4: supbigdiaper ($829.19 in chips)
Seat 5: Yaaaazz ($500 in chips)
Seat 6: Labuns ($500 in chips)
IdrinkBEERI: posts small blind $2.50
supbigdiaper: posts big blind $5
*** HOLE CARDS ***
Yaaaazz: folds
Labuns: raises $5.50 to $10.50
Rabarber77: folds
RAidakCo: folds
IdrinkBEERI: folds
supbigdiaper: folds
Uncalled bet ($5.50) returned to Labuns
Labuns collected $12.50 from pot
Labuns: doesn't show hand
*** SUMMARY ***
Total pot $12.50 | Rake $0
Seat 1: Rabarber77 folded before Flop (didn't bet)
Seat 2: RAidakCo (button) folded before Flop (didn't bet)
Seat 3: IdrinkBEERI (small blind) folded before Flop
Seat 4: supbigdiaper (big blind) folded before Flop
Seat 5: Yaaaazz folded before Flop (didn't bet)
Seat 6: Labuns collected ($12.50)


PokerStars Hand #222986311726:  Hold'em No Limit ($2.50/$5.00 USD) - 2021/01/24 0:11:03 ET
Table 'Aaltje II' 6-max Seat #3 is the button
Seat 1: Rabarber77 ($3404.17 in chips)
Seat 2: RAidakCo ($636.92 in chips)
Seat 3: IdrinkBEERI ($670.87 in chips)
Seat 4: supbigdiaper ($824.19 in chips)
Seat 5: Yaaaazz ($500 in chips)
Seat 6: Labuns ($507.50 in chips)
supbigdiaper: posts small blind $2.50
Yaaaazz: posts big blind $5
*** HOLE CARDS ***
Labuns: folds
Rabarber77: folds
RAidakCo: folds
IdrinkBEERI: folds
supbigdiaper: folds
Uncalled bet ($2.50) returned to Yaaaazz
Yaaaazz collected $5 from pot
Yaaaazz: doesn't show hand
*** SUMMARY ***
Total pot $5 | Rake $0
Seat 1: Rabarber77 folded before Flop (didn't bet)
Seat 2: RAidakCo folded before Flop (didn't bet)
Seat 3: IdrinkBEERI (button) folded before Flop (didn't bet)
Seat 4: supbigdiaper (small blind) folded before Flop
Seat 5: Yaaaazz (big blind) collected ($5)
Seat 6: Labuns folded before Flop (didn't bet)


PokerStars Hand #222986315882:  Hold'em No Limit ($2.50/$5.00 USD) - 2021/01/24 0:11:19 ET
Table 'Aaltje II' 6-max Seat #4 is the button
Seat 1: Rabarber77 ($3404.17 in chips)
Seat 2: RAidakCo ($636.92 in chips)
Seat 3: IdrinkBEERI ($670.87 in chips)
Seat 4: supbigdiaper ($821.69 in chips)
Seat 5: Yaaaazz ($502.50 in chips)
Seat 6: Labuns ($507.50 in chips)
Yaaaazz: posts small blind $2.50
Labuns: posts big blind $5
*** HOLE CARDS ***
Rabarber77: folds
RAidakCo: folds
IdrinkBEERI: folds
supbigdiaper: raises $7.50 to $12.50
Yaaaazz: folds
Labuns: calls $7.50
*** FLOP *** [Qh 2h 4d]
Labuns: checks
supbigdiaper: bets $8.62
Labuns: calls $8.62
*** TURN *** [Qh 2h 4d] [5c]
Labuns: checks
supbigdiaper: bets $31.88
Labuns: folds
Uncalled bet ($31.88) returned to supbigdiaper
supbigdiaper collected $42.50 from pot
supbigdiaper: doesn't show hand
*** SUMMARY ***
Total pot $44.74 | Rake $2.24
Board [Qh 2h 4d 5c]
Seat 1: Rabarber77 folded before Flop (didn't bet)
Seat 2: RAidakCo folded before Flop (didn't bet)
Seat 3: IdrinkBEERI folded before Flop (didn't bet)
Seat 4: supbigdiaper (button) collected ($42.50)
Seat 5: Yaaaazz (small blind) folded before Flop
Seat 6: Labuns (big blind) folded on the Turn


PokerStars Hand #222986327956:  Hold'em No Limit ($2.50/$5.00 USD) - 2021/01/24 0:12:07 ET
Table 'Aaltje II' 6-max Seat #5 is the button
Seat 1: Rabarber77 ($3404.17 in chips)
Seat 2: RAidakCo ($636.92 in chips)
Seat 3: IdrinkBEERI ($670.87 in chips)
Seat 4: supbigdiaper ($843.07 in chips)
Seat 5: Yaaaazz ($500 in chips)
Seat 6: Labuns ($500 in chips)
Labuns: posts small blind $2.50
Rabarber77: posts big blind $5
*** HOLE CARDS ***
RAidakCo: folds
IdrinkBEERI: raises $11.20 to $16.20
supbigdiaper: folds
Yaaaazz: raises $32.40 to $48.60
Labuns: folds
Rabarber77: folds
IdrinkBEERI: folds
Uncalled bet ($32.40) returned to Yaaaazz
Yaaaazz collected $39.90 from pot
Yaaaazz: doesn't show hand
*** SUMMARY ***
Total pot $39.90 | Rake $0
Seat 1: Rabarber77 (big blind) folded before Flop
Seat 2: RAidakCo folded before Flop (didn't bet)
Seat 3: IdrinkBEERI folded before Flop
Seat 4: supbigdiaper folded before Flop (didn't bet)
Seat 5: Yaaaazz (button) collected ($39.90)
Seat 6: Labuns (small blind) folded before Flop


PokerStars Hand #222986332181:  Hold'em No Limit ($2.50/$5.00 USD) - 2021/01/24 0:12:23 ET
Table 'Aaltje II' 6-max Seat #6 is the button
Seat 1: Rabarber77 ($3399.17 in chips)
Seat 2: RAidakCo ($636.92 in chips)
Seat 3: IdrinkBEERI ($654.67 in chips)
Seat 4: supbigdiaper ($843.07 in chips)
Seat 5: Yaaaazz ($523.70 in chips)
Seat 6: Labuns ($500 in chips)
Rabarber77: posts small blind $2.50
RAidakCo: posts big blind $5
*** HOLE CARDS ***
IdrinkBEERI: folds
supbigdiaper: folds
Yaaaazz: raises $6.25 to $11.25
Labuns: folds
Rabarber77: folds
RAidakCo: calls $6.25
*** FLOP *** [8s 5h Ah]
RAidakCo: checks
Yaaaazz: checks
*** TURN *** [8s 5h Ah] [Qh]
RAidakCo: bets $7.13
Yaaaazz: folds
Uncalled bet ($7.13) returned to RAidakCo
RAidakCo collected $23.75 from pot
RAidakCo: doesn't show hand
*** SUMMARY ***
Total pot $25 | Rake $1.25
Board [8s 5h Ah Qh]
Seat 1: Rabarber77 (small blind) folded before Flop
Seat 2: RAidakCo (big blind) collected ($23.75)
Seat 3: IdrinkBEERI folded before Flop (didn't bet)
Seat 4: supbigdiaper folded before Flop (didn't bet)
Seat 5: Yaaaazz folded on the Turn
Seat 6: Labuns (button) folded before Flop (didn't bet)


PokerStars Hand #222986344530:  Hold'em No Limit ($2.50/$5.00 USD) - 2021/01/24 0:12:58 ET
Table 'Aaltje II' 6-max Seat #1 is the button
Seat 1: Rabarber77 ($3396.67 in chips)
Seat 2: RAidakCo ($649.42 in chips)
Seat 3: IdrinkBEERI ($654.67 in chips)
Seat 4: supbigdiaper ($843.07 in chips)
Seat 5: Yaaaazz ($512.45 in chips)
Seat 6: Labuns ($500 in chips)
RAidakCo: posts small blind $2.50
IdrinkBEERI: posts big blind $5
*** HOLE CARDS ***
supbigdiaper: folds
Yaaaazz: raises $6.25 to $11.25
Labuns: folds
Rabarber77: folds
RAidakCo: folds
IdrinkBEERI: folds
Uncalled bet ($6.25) returned to Yaaaazz
Yaaaazz collected $12.50 from pot
Yaaaazz: doesn't show hand
*** SUMMARY ***
Total pot $12.50 | Rake $0
Seat 1: Rabarber77 (button) folded before Flop (didn't bet)
Seat 2: RAidakCo (small blind) folded before Flop
Seat 3: IdrinkBEERI (big blind) folded before Flop
Seat 4: supbigdiaper folded before Flop (didn't bet)
Seat 5: Yaaaazz collected ($12.50)
Seat 6: Labuns folded before Flop (didn't bet)


PokerStars Hand #222986347834:  Hold'em No Limit ($2.50/$5.00 USD) - 2021/01/24 0:13:11 ET
Table 'Aaltje II' 6-max Seat #2 is the button
Seat 1: Rabarber77 ($3396.67 in chips)
Seat 2: RAidakCo ($646.92 in chips)
Seat 3: IdrinkBEERI ($649.67 in chips)
Seat 4: supbigdiaper ($843.07 in chips)
Seat 5: Yaaaazz ($519.95 in chips)
Seat 6: Labuns ($500 in chips)
IdrinkBEERI: posts small blind $2.50
supbigdiaper: posts big blind $5
*** HOLE CARDS ***
Yaaaazz: folds
Labuns: folds
Rabarber77: raises $10 to $15
RAidakCo: calls $15
IdrinkBEERI: folds
supbigdiaper: calls $10
*** FLOP *** [Qs Ac Ah]
supbigdiaper: checks
Rabarber77: bets $22.56
RAidakCo: folds
supbigdiaper: folds
Uncalled bet ($22.56) returned to Rabarber77
Rabarber77 collected $45.12 from pot
Rabarber77: doesn't show hand
*** SUMMARY ***
Total pot $47.50 | Rake $2.38
Board [Qs Ac Ah]
Seat 1: Rabarber77 collected ($45.12)
Seat 2: RAidakCo (button) folded on the Flop
Seat 3: IdrinkBEERI (small blind) folded before Flop
Seat 4: supbigdiaper (big blind) folded on the Flop
Seat 5: Yaaaazz folded before Flop (didn't bet)
Seat 6: Labuns folded before Flop (didn't bet)


PokerStars Hand #222986353612:  Hold'em No Limit ($2.50/$5.00 USD) - 2021/01/24 0:13:34 ET
Table 'Aaltje II' 6-max Seat #3 is the button
Seat 1: Rabarber77 ($3426.79 in chips)
Seat 2: RAidakCo ($631.92 in chips)
Seat 3: IdrinkBEERI ($647.17 in chips)
Seat 4: supbigdiaper ($828.07 in chips)
Seat 5: Yaaaazz ($519.95 in chips)
Seat 6: Labuns ($500 in chips)
supbigdiaper: posts small blind $2.50
Yaaaazz: posts big blind $5
*** HOLE CARDS ***
Labuns: folds
Rabarber77: folds
RAidakCo: folds
IdrinkBEERI: folds
supbigdiaper: folds
Uncalled bet ($2.50) returned to Yaaaazz
Yaaaazz collected $5 from pot
Yaaaazz: doesn't show hand
*** SUMMARY ***
Total pot $5 | Rake $0
Seat 1: Rabarber77 folded before Flop (didn't bet)
Seat 2: RAidakCo folded before Flop (didn't bet)
Seat 3: IdrinkBEERI (button) folded before Flop (didn't bet)
Seat 4: supbigdiaper (small blind) folded before Flop
Seat 5: Yaaaazz (big blind) collected ($5)
Seat 6: Labuns folded before Flop (didn't bet)


PokerStars Hand #222986357948:  Hold'em No Limit ($2.50/$5.00 USD) - 2021/01/24 0:13:51 ET
Table 'Aaltje II' 6-max Seat #4 is the button
Seat 1: Rabarber77 ($3426.79 in chips)
Seat 2: RAidakCo ($631.92 in chips)
Seat 3: IdrinkBEERI ($647.17 in chips)
Seat 4: supbigdiaper ($825.57 in chips)
Seat 5: Yaaaazz ($522.45 in chips)
Seat 6: Labuns ($500 in chips)
Yaaaazz: posts small blind $2.50
Labuns: posts big blind $5
*** HOLE CARDS ***
Rabarber77: folds
RAidakCo: folds
IdrinkBEERI: folds
supbigdiaper: folds
Yaaaazz: folds
Uncalled bet ($2.50) returned to Labuns
Labuns collected $5 from pot
Labuns: doesn't show hand
*** SUMMARY ***
Total pot $5 | Rake $0
Seat 1: Rabarber77 folded before Flop (didn't bet)
Seat 2: RAidakCo folded before Flop (didn't bet)
Seat 3: IdrinkBEERI folded before Flop (didn't bet)
Seat 4: supbigdiaper (button) folded before Flop (didn't bet)
Seat 5: Yaaaazz (small blind) folded before Flop
Seat 6: Labuns (big blind) collected ($5)


PokerStars Hand #222986361669:  Hold'em No Limit ($2.50/$5.00 USD) - 2021/01/24 0:14:06 ET
Table 'Aaltje II' 6-max Seat #5 is the button
Seat 1: Rabarber77 ($3426.79 in chips)
Seat 2: RAidakCo ($631.92 in chips)
Seat 3: IdrinkBEERI ($647.17 in chips)
Seat 4: supbigdiaper ($825.57 in chips)
Seat 5: Yaaaazz ($519.95 in chips)
Seat 6: Labuns ($502.50 in chips)
Labuns: posts small blind $2.50
Rabarber77: posts big blind $5
*** HOLE CARDS ***
RAidakCo: folds
IdrinkBEERI: folds
supbigdiaper: folds
Yaaaazz: raises $7.50 to $12.50
Labuns: folds
Rabarber77: calls $7.50
*** FLOP *** [8s 2s 6d]
Rabarber77: checks
Yaaaazz: checks
*** TURN *** [8s 2s 6d] [3c]
Rabarber77: bets $26.12
Yaaaazz: folds
Uncalled bet ($26.12) returned to Rabarber77
Rabarber77 collected $26.12 from pot
Rabarber77: doesn't show hand
*** SUMMARY ***
Total pot $27.50 | Rake $1.38
Board [8s 2s 6d 3c]
Seat 1: Rabarber77 (big blind) collected ($26.12)
Seat 2: RAidakCo folded before Flop (didn't bet)
Seat 3: IdrinkBEERI folded before Flop (didn't bet)
Seat 4: supbigdiaper folded before Flop (didn't bet)
Seat 5: Yaaaazz (button) folded on the Turn
Seat 6: Labuns (small blind) folded before Flop


PokerStars Hand #222986373795:  Hold'em No Limit ($2.50/$5.00 USD) - 2021/01/24 0:14:55 ET
Table 'Aaltje II' 6-max Seat #6 is the button
Seat 1: Rabarber77 ($3440.41 in chips)
Seat 2: RAidakCo ($631.92 in chips)
Seat 3: IdrinkBEERI ($647.17 in chips)
Seat 4: supbigdiaper ($825.57 in chips)
Seat 5: Yaaaazz ($507.45 in chips)
Seat 6: Labuns ($500 in chips)
Rabarber77: posts small blind $2.50
RAidakCo: posts big blind $5
*** HOLE CARDS ***
IdrinkBEERI: folds
supbigdiaper: folds
Yaaaazz: folds
Labuns: folds
Rabarber77: folds
Uncalled bet ($2.50) returned to RAidakCo
RAidakCo collected $5 from pot
RAidakCo: doesn't show hand
*** SUMMARY ***
Total pot $5 | Rake $0
Seat 1: Rabarber77 (small blind) folded before Flop
Seat 2: RAidakCo (big blind) collected ($5)
Seat 3: IdrinkBEERI folded before Flop (didn't bet)
Seat 4: supbigdiaper folded before Flop (didn't bet)
Seat 5: Yaaaazz folded before Flop (didn't bet)
Seat 6: Labuns (button) folded before Flop (didn't bet)


PokerStars Hand #222986378408:  Hold'em No Limit ($2.50/$5.00 USD) - 2021/01/24 0:15:13 ET
Table 'Aaltje II' 6-max Seat #1 is the button
Seat 1: Rabarber77 ($3437.91 in chips)
Seat 2: RAidakCo ($634.42 in chips)
Seat 3: IdrinkBEERI ($647.17 in chips)
Seat 4: supbigdiaper ($825.57 in chips)
Seat 5: Yaaaazz ($507.45 in chips)
Seat 6: Labuns ($500 in chips)
RAidakCo: posts small blind $2.50
IdrinkBEERI: posts big blind $5
*** HOLE CARDS ***
supbigdiaper: raises $7.50 to $12.50
Yaaaazz: folds
Labuns: folds
Rabarber77: folds
RAidakCo: folds
IdrinkBEERI: folds
Uncalled bet ($7.50) returned to supbigdiaper
supbigdiaper collected $12.50 from pot
supbigdiaper: doesn't show hand
*** SUMMARY ***
Total pot $12.50 | Rake $0
Seat 1: Rabarber77 (button) folded before Flop (didn't bet)
Seat 2: RAidakCo (small blind) folded before Flop
Seat 3: IdrinkBEERI (big blind) folded before Flop
Seat 4: supbigdiaper collected ($12.50)
Seat 5: Yaaaazz folded before Flop (didn't bet)
Seat 6: Labuns folded before Flop (didn't bet)


PokerStars Hand #222986381986:  Hold'em No Limit ($2.50/$5.00 USD) - 2021/01/24 0:15:27 ET
Table 'Aaltje II' 6-max Seat #2 is the button
Seat 1: Rabarber77 ($3437.91 in chips)
Seat 2: RAidakCo ($631.92 in chips)
Seat 3: IdrinkBEERI ($642.17 in chips)
Seat 4: supbigdiaper ($833.07 in chips)
Seat 5: Yaaaazz ($507.45 in chips)
Seat 6: Labuns ($500 in chips)
IdrinkBEERI: posts small blind $2.50
supbigdiaper: posts big blind $5
*** HOLE CARDS ***
Yaaaazz: folds
Labuns: folds
Rabarber77: folds
RAidakCo: folds
IdrinkBEERI: folds
Uncalled bet ($2.50) returned to supbigdiaper
supbigdiaper collected $5 from pot
supbigdiaper: doesn't show hand
*** SUMMARY ***
Total pot $5 | Rake $0
Seat 1: Rabarber77 folded before Flop (didn't bet)
Seat 2: RAidakCo (button) folded before Flop (didn't bet)
Seat 3: IdrinkBEERI (small blind) folded before Flop
Seat 4: supbigdiaper (big blind) collected ($5)
Seat 5: Yaaaazz folded before Flop (didn't bet)
Seat 6: Labuns folded before Flop (didn't bet)


PokerStars Hand #222986386048:  Hold'em No Limit ($2.50/$5.00 USD) - 2021/01/24 0:15:43 ET
Table 'Aaltje II' 6-max Seat #3 is the button
Seat 1: Rabarber77 ($3437.91 in chips)
Seat 2: RAidakCo ($631.92 in chips)
Seat 3: IdrinkBEERI ($639.67 in chips)
Seat 4: supbigdiaper ($835.57 in chips)
Seat 5: Yaaaazz ($507.45 in chips)
Seat 6: Labuns ($500 in chips)
supbigdiaper: posts small blind $2.50
Yaaaazz: posts big blind $5
*** HOLE CARDS ***
Labuns: folds
Rabarber77: folds
RAidakCo: raises $6 to $11
IdrinkBEERI: folds
supbigdiaper: folds
Yaaaazz: calls $6
*** FLOP *** [Ts 5s 2c]
Yaaaazz: checks
RAidakCo: bets $6.98
Yaaaazz: folds
Uncalled bet ($6.98) returned to RAidakCo
RAidakCo collected $23.28 from pot
RAidakCo: doesn't show hand
*** SUMMARY ***
Total pot $24.50 | Rake $1.22
Board [Ts 5s 2c]
Seat 1: Rabarber77 folded before Flop (didn't bet)
Seat 2: RAidakCo collected ($23.28)
Seat 3: IdrinkBEERI (button) folded before Flop (didn't bet)
Seat 4: supbigdiaper (small blind) folded before Flop
Seat 5: Yaaaazz (big blind) folded on the Flop
Seat 6: Labuns folded before Flop (didn't bet)


PokerStars Hand #222986394827:  Hold'em No Limit ($2.50/$5.00 USD) - 2021/01/24 0:16:19 ET
Table 'Aaltje II' 6-max Seat #4 is the button
Seat 1: Rabarber77 ($3437.91 in chips)
Seat 2: RAidakCo ($644.20 in chips)
Seat 3: IdrinkBEERI ($639.67 in chips)
Seat 4: supbigdiaper ($833.07 in chips)
Seat 5: Yaaaazz ($500 in chips)
Seat 6: Labuns ($500 in chips)
Yaaaazz: posts small blind $2.50
Labuns: posts big blind $5
*** HOLE CARDS ***
Rabarber77: folds
RAidakCo: folds
IdrinkBEERI: raises $11.25 to $16.25
supbigdiaper: folds
Yaaaazz: folds
Labuns: folds
Uncalled bet ($11.25) returned to IdrinkBEERI
IdrinkBEERI collected $12.50 from pot
IdrinkBEERI: doesn't show hand
*** SUMMARY ***
Total pot $12.50 | Rake $0
Seat 1: Rabarber77 folded before Flop (didn't bet)
Seat 2: RAidakCo folded before Flop (didn't bet)
Seat 3: IdrinkBEERI collected ($12.50)
Seat 4: supbigdiaper (button) folded before Flop (didn't bet)
Seat 5: Yaaaazz (small blind) folded before Flop
Seat 6: Labuns (big blind) folded before Flop


PokerStars Hand #222986399750:  Hold'em No Limit ($2.50/$5.00 USD) - 2021/01/24 0:16:38 ET
Table 'Aaltje II' 6-max Seat #5 is the button
Seat 1: Rabarber77 ($3437.91 in chips)
Seat 2: RAidakCo ($644.20 in chips)
Seat 3: IdrinkBEERI ($647.17 in chips)
Seat 4: supbigdiaper ($833.07 in chips)
Seat 5: Yaaaazz ($500 in chips)
Seat 6: Labuns ($500 in chips)
Labuns: posts small blind $2.50
Rabarber77: posts big blind $5
*** HOLE CARDS ***
RAidakCo: folds
IdrinkBEERI: folds
supbigdiaper: folds
Yaaaazz: raises $7.50 to $12.50
Labuns: folds
Rabarber77: calls $7.50
*** FLOP *** [2d 6c Th]
Rabarber77: checks
Yaaaazz: checks
*** TURN *** [2d 6c Th] [7c]
Rabarber77: bets $13.06
Yaaaazz: calls $13.06
*** RIVER *** [2d 6c Th 7c] [9c]
Rabarber77: bets $50.94
Yaaaazz: folds
Uncalled bet ($50.94) returned to Rabarber77
Rabarber77 collected $50.94 from pot
Rabarber77: doesn't show hand
*** SUMMARY ***
Total pot $53.62 | Rake $2.68
Board [2d 6c Th 7c 9c]
Seat 1: Rabarber77 (big blind) collected ($50.94)
Seat 2: RAidakCo folded before Flop (didn't bet)
Seat 3: IdrinkBEERI folded before Flop (didn't bet)
Seat 4: supbigdiaper folded before Flop (didn't bet)
Seat 5: Yaaaazz (button) folded on the River
Seat 6: Labuns (small blind) folded before Flop


PokerStars Hand #222986410229:  Hold'em No Limit ($2.50/$5.00 USD) - 2021/01/24 0:17:20 ET
Table 'Aaltje II' 6-max Seat #6 is the button
Seat 1: Rabarber77 ($3463.29 in chips)
Seat 2: RAidakCo ($644.20 in chips)
Seat 3: IdrinkBEERI ($647.17 in chips)
Seat 4: supbigdiaper ($833.07 in chips)
Seat 5: Yaaaazz ($500 in chips)
Seat 6: Labuns ($500 in chips)
Rabarber77: posts small blind $2.50
RAidakCo: posts big blind $5
*** HOLE CARDS ***
IdrinkBEERI: raises $11.20 to $16.20
supbigdiaper: folds
Yaaaazz: folds
Labuns: folds
Rabarber77: calls $13.70
RAidakCo: folds
*** FLOP *** [6c 6s 7h]
Rabarber77: checks
IdrinkBEERI: checks
*** TURN *** [6c 6s 7h] [Ks]
Rabarber77: checks
IdrinkBEERI: checks
*** RIVER *** [6c 6s 7h Ks] [2c]
Rabarber77: checks
IdrinkBEERI: bets $23.81
Rabarber77: folds
Uncalled bet ($23.81) returned to IdrinkBEERI
IdrinkBEERI collected $35.53 from pot
IdrinkBEERI: doesn't show hand
*** SUMMARY ***
Total pot $37.40 | Rake $1.87
Board [6c 6s 7h Ks 2c]
Seat 1: Rabarber77 (small blind) folded on the River
Seat 2: RAidakCo (big blind) folded before Flop
Seat 3: IdrinkBEERI collected ($35.53)
Seat 4: supbigdiaper folded before Flop (didn't bet)
Seat 5: Yaaaazz folded before Flop (didn't bet)
Seat 6: Labuns (button) folded before Flop (didn't bet)


PokerStars Hand #222986428989:  Hold'em No Limit ($2.50/$5.00 USD) - 2021/01/24 0:18:35 ET
Table 'Aaltje II' 6-max Seat #1 is the button
Seat 1: Rabarber77 ($3447.09 in chips)
Seat 2: RAidakCo ($639.20 in chips)
Seat 3: IdrinkBEERI ($666.50 in chips)
Seat 4: supbigdiaper ($833.07 in chips)
Seat 5: Yaaaazz ($500 in chips)
Seat 6: Labuns ($500 in chips)
RAidakCo: posts small blind $2.50
IdrinkBEERI: posts big blind $5
*** HOLE CARDS ***
supbigdiaper: raises $7.50 to $12.50
Yaaaazz: folds
Labuns: raises $24.38 to $36.88
Rabarber77: folds
RAidakCo: folds
IdrinkBEERI: folds
supbigdiaper: folds
Uncalled bet ($24.38) returned to Labuns
Labuns collected $32.50 from pot
Labuns: doesn't show hand
*** SUMMARY ***
Total pot $32.50 | Rake $0
Seat 1: Rabarber77 (button) folded before Flop (didn't bet)
Seat 2: RAidakCo (small blind) folded before Flop
Seat 3: IdrinkBEERI (big blind) folded before Flop
Seat 4: supbigdiaper folded before Flop
Seat 5: Yaaaazz folded before Flop (didn't bet)
Seat 6: Labuns collected ($32.50)


PokerStars Hand #222986434706:  Hold'em No Limit ($2.50/$5.00 USD) - 2021/01/24 0:18:58 ET
Table 'Aaltje II' 6-max Seat #2 is the button
Seat 1: Rabarber77 ($3447.09 in chips)
Seat 2: RAidakCo ($636.70 in chips)
Seat 3: IdrinkBEERI ($661.50 in chips)
Seat 4: supbigdiaper ($820.57 in chips)
Seat 5: Yaaaazz ($500 in chips)
Seat 6: Labuns ($520 in chips)
IdrinkBEERI: posts small blind $2.50
supbigdiaper: posts big blind $5
*** HOLE CARDS ***
Yaaaazz: folds
Labuns: folds
Rabarber77: raises $10 to $15
RAidakCo: calls $15
IdrinkBEERI: folds
supbigdiaper: folds
*** FLOP *** [Qh 7c 8d]
Rabarber77: bets $17.81
RAidakCo: calls $17.81
*** TURN *** [Qh 7c 8d] [9d]
Rabarber77: bets $35.06
RAidakCo: raises $70.12 to $105.18
Rabarber77: calls $70.12
*** RIVER *** [Qh 7c 8d 9d] [Qs]
Rabarber77: checks
RAidakCo: checks
*** SHOW DOWN ***
Rabarber77: shows [Jh Jc] (two pair, Queens and Jacks)
RAidakCo: mucks hand
Rabarber77 collected $280.48 from pot
*** SUMMARY ***
Total pot $283.48 | Rake $3
Board [Qh 7c 8d 9d Qs]
Seat 1: Rabarber77 showed [Jh Jc] and won ($280.48) with two pair, Queens and Jacks
Seat 2: RAidakCo (button) mucked
Seat 3: IdrinkBEERI (small blind) folded before Flop
Seat 4: supbigdiaper (big blind) folded before Flop
Seat 5: Yaaaazz folded before Flop (didn't bet)
Seat 6: Labuns folded before Flop (didn't bet)


PokerStars Hand #222986447111:  Hold'em No Limit ($2.50/$5.00 USD) - 2021/01/24 0:19:47 ET
Table 'Aaltje II' 6-max Seat #3 is the button
Seat 1: Rabarber77 ($3589.58 in chips)
Seat 2: RAidakCo ($500 in chips)
Seat 3: IdrinkBEERI ($659 in chips)
Seat 4: supbigdiaper ($815.57 in chips)
Seat 5: Yaaaazz ($500 in chips)
Seat 6: Labuns ($520 in chips)
supbigdiaper: posts small blind $2.50
Yaaaazz: posts big blind $5
*** HOLE CARDS ***
Labuns: folds
Rabarber77: folds
RAidakCo: raises $6 to $11
IdrinkBEERI: calls $11
supbigdiaper: folds
Yaaaazz: calls $6
*** FLOP *** [3s 5c 3d]
Yaaaazz: checks
RAidakCo: bets $10.12
IdrinkBEERI: folds
Yaaaazz: folds
Uncalled bet ($10.12) returned to RAidakCo
RAidakCo collected $33.72 from pot
RAidakCo: doesn't show hand
*** SUMMARY ***
Total pot $35.50 | Rake $1.78
Board [3s 5c 3d]
Seat 1: Rabarber77 folded before Flop (didn't bet)
Seat 2: RAidakCo collected ($33.72)
Seat 3: IdrinkBEERI (button) folded on the Flop
Seat 4: supbigdiaper (small blind) folded before Flop
Seat 5: Yaaaazz (big blind) folded on the Flop
Seat 6: Labuns folded before Flop (didn't bet)


PokerStars Hand #222986459223:  Hold'em No Limit ($2.50/$5.00 USD) - 2021/01/24 0:20:36 ET
Table 'Aaltje II' 6-max Seat #4 is the button
Seat 1: Rabarber77 ($3589.58 in chips)
Seat 2: RAidakCo ($522.72 in chips)
Seat 3: IdrinkBEERI ($648 in chips)
Seat 4: supbigdiaper ($813.07 in chips)
Seat 5: Yaaaazz ($500 in chips)
Seat 6: Labuns ($520 in chips)
Yaaaazz: posts small blind $2.50
Labuns: posts big blind $5
*** HOLE CARDS ***
Rabarber77: folds
RAidakCo: folds
IdrinkBEERI: raises $11.25 to $16.25
supbigdiaper: folds
Yaaaazz: folds
Labuns: folds
Uncalled bet ($11.25) returned to IdrinkBEERI
IdrinkBEERI collected $12.50 from pot
IdrinkBEERI: doesn't show hand
*** SUMMARY ***
Total pot $12.50 | Rake $0
Seat 1: Rabarber77 folded before Flop (didn't bet)
Seat 2: RAidakCo folded before Flop (didn't bet)
Seat 3: IdrinkBEERI collected ($12.50)
Seat 4: supbigdiaper (button) folded before Flop (didn't bet)
Seat 5: Yaaaazz (small blind) folded before Flop
Seat 6: Labuns (big blind) folded before Flop


PokerStars Hand #222986462285:  Hold'em No Limit ($2.50/$5.00 USD) - 2021/01/24 0:20:48 ET
Table 'Aaltje II' 6-max Seat #5 is the button
Seat 1: Rabarber77 ($3589.58 in chips)
Seat 2: RAidakCo ($522.72 in chips)
Seat 3: IdrinkBEERI ($655.50 in chips)
Seat 4: supbigdiaper ($813.07 in chips)
Seat 5: Yaaaazz ($500 in chips)
Seat 6: Labuns ($515 in chips)
Labuns: posts small blind $2.50
Rabarber77: posts big blind $5
*** HOLE CARDS ***
RAidakCo: raises $6 to $11
IdrinkBEERI: folds
supbigdiaper: folds
Yaaaazz: folds
Labuns: folds
Rabarber77: folds
Uncalled bet ($6) returned to RAidakCo
RAidakCo collected $12.50 from pot
RAidakCo: doesn't show hand
*** SUMMARY ***
Total pot $12.50 | Rake $0
Seat 1: Rabarber77 (big blind) folded before Flop
Seat 2: RAidakCo collected ($12.50)
Seat 3: IdrinkBEERI folded before Flop (didn't bet)
Seat 4: supbigdiaper folded before Flop (didn't bet)
Seat 5: Yaaaazz (button) folded before Flop (didn't bet)
Seat 6: Labuns (small blind) folded before Flop


PokerStars Hand #222986474431:  Hold'em No Limit ($2.50/$5.00 USD) - 2021/01/24 0:21:10 ET
Table 'Aaltje II' 6-max Seat #6 is the button
Seat 1: Rabarber77 ($3584.58 in chips)
Seat 2: RAidakCo ($530.22 in chips)
Seat 3: IdrinkBEERI ($655.50 in chips)
Seat 4: supbigdiaper ($813.07 in chips)
Seat 5: Yaaaazz ($500 in chips)
Seat 6: Labuns ($512.50 in chips)
Rabarber77: posts small blind $2.50
RAidakCo: posts big blind $5
*** HOLE CARDS ***
IdrinkBEERI: folds
supbigdiaper: folds
Yaaaazz: folds
Labuns: folds
Rabarber77: raises $10 to $15
RAidakCo: raises $30 to $45
Rabarber77: calls $30
*** FLOP *** [2h Kc 4d]
Rabarber77: checks
RAidakCo: bets $26.10
Rabarber77: calls $26.10
*** TURN *** [2h Kc 4d] [Tc]
Rabarber77: bets $69.60
RAidakCo: calls $69.60
*** RIVER *** [2h Kc 4d Tc] [3d]
Rabarber77: bets $278.40
RAidakCo: calls $278.40
*** SHOW DOWN ***
Rabarber77: shows [5s 6h] (a straight, Deuce to Six)
RAidakCo: mucks hand
Rabarber77 collected $835.20 from pot
*** SUMMARY ***
Total pot $838.20 | Rake $3
Board [2h Kc 4d Tc 3d]
Seat 1: Rabarber77 (small blind) showed [5s 6h] and won ($835.20) with a straight, Deuce to Six
Seat 2: RAidakCo (big blind) mucked
Seat 3: IdrinkBEERI folded before Flop (didn't bet)
Seat 4: supbigdiaper folded before Flop (didn't bet)
Seat 5: Yaaaazz folded before Flop (didn't bet)
Seat 6: Labuns (button) folded before Flop (didn't bet)


PokerStars Hand #222986488034:  Hold'em No Limit ($2.50/$5.00 USD) - 2021/01/24 0:22:05 ET
Table 'Aaltje II' 6-max Seat #1 is the button
Seat 1: Rabarber77 ($4000.68 in chips)
Seat 2: RAidakCo ($500 in chips)
Seat 3: IdrinkBEERI ($655.50 in chips)
Seat 4: supbigdiaper ($813.07 in chips)
Seat 5: Yaaaazz ($500 in chips)
Seat 6: Labuns ($512.50 in chips)
RAidakCo: posts small blind $2.50
IdrinkBEERI: posts big blind $5
*** HOLE CARDS ***
supbigdiaper: folds
Yaaaazz: calls $5
Labuns: folds
Rabarber77: folds
RAidakCo: folds
IdrinkBEERI: checks
*** FLOP *** [Qd 7s 9h]
IdrinkBEERI: checks
Yaaaazz: bets $5
IdrinkBEERI: folds
Uncalled bet ($5) returned to Yaaaazz
Yaaaazz collected $11.88 from pot
Yaaaazz: doesn't show hand
*** SUMMARY ***
Total pot $12.50 | Rake $0.62
Board [Qd 7s 9h]
Seat 1: Rabarber77 (button) folded before Flop (didn't bet)
Seat 2: RAidakCo (small blind) folded before Flop
Seat 3: IdrinkBEERI (big blind) folded on the Flop
Seat 4: supbigdiaper folded before Flop (didn't bet)
Seat 5: Yaaaazz collected ($11.88)
Seat 6: Labuns folded before Flop (didn't bet)


PokerStars Hand #222986496962:  Hold'em No Limit ($2.50/$5.00 USD) - 2021/01/24 0:22:42 ET
Table 'Aaltje II' 6-max Seat #2 is the button
Seat 1: Rabarber77 ($4000.68 in chips)
Seat 2: RAidakCo ($500 in chips)
Seat 3: IdrinkBEERI ($650.50 in chips)
Seat 4: supbigdiaper ($813.07 in chips)
Seat 5: Yaaaazz ($506.88 in chips)
Seat 6: Labuns ($512.50 in chips)
IdrinkBEERI: posts small blind $2.50
supbigdiaper: posts big blind $5
*** HOLE CARDS ***
Yaaaazz: raises $6.25 to $11.25
Labuns: folds
Rabarber77: folds
RAidakCo: folds
IdrinkBEERI: folds
supbigdiaper: calls $6.25
*** FLOP *** [5c 7h 2c]
supbigdiaper: checks
Yaaaazz: bets $20
supbigdiaper: folds
Uncalled bet ($20) returned to Yaaaazz
Yaaaazz collected $23.75 from pot
Yaaaazz: doesn't show hand
*** SUMMARY ***
Total pot $25 | Rake $1.25
Board [5c 7h 2c]
Seat 1: Rabarber77 folded before Flop (didn't bet)
Seat 2: RAidakCo (button) folded before Flop (didn't bet)
Seat 3: IdrinkBEERI (small blind) folded before Flop
Seat 4: supbigdiaper (big blind) folded on the Flop
Seat 5: Yaaaazz collected ($23.75)
Seat 6: Labuns folded before Flop (didn't bet)


PokerStars Hand #222986502000:  Hold'em No Limit ($2.50/$5.00 USD) - 2021/01/24 0:23:02 ET
Table 'Aaltje II' 6-max Seat #3 is the button
Seat 1: Rabarber77 ($4000.68 in chips)
Seat 2: RAidakCo ($500 in chips)
Seat 3: IdrinkBEERI ($648 in chips)
Seat 4: supbigdiaper ($801.82 in chips)
Seat 5: Yaaaazz ($519.38 in chips)
Seat 6: Labuns ($512.50 in chips)
supbigdiaper: posts small blind $2.50
Yaaaazz: posts big blind $5
*** HOLE CARDS ***
Labuns: folds
Rabarber77: folds
RAidakCo: folds
IdrinkBEERI: raises $9.65 to $14.65
supbigdiaper: folds
Yaaaazz: calls $9.65
*** FLOP *** [2d 2s 2h]
Yaaaazz: checks
IdrinkBEERI: bets $7.85
Yaaaazz: folds
Uncalled bet ($7.85) returned to IdrinkBEERI
IdrinkBEERI collected $30.21 from pot
IdrinkBEERI: doesn't show hand
*** SUMMARY ***
Total pot $31.80 | Rake $1.59
Board [2d 2s 2h]
Seat 1: Rabarber77 folded before Flop (didn't bet)
Seat 2: RAidakCo folded before Flop (didn't bet)
Seat 3: IdrinkBEERI (button) collected ($30.21)
Seat 4: supbigdiaper (small blind) folded before Flop
Seat 5: Yaaaazz (big blind) folded on the Flop
Seat 6: Labuns folded before Flop (didn't bet)


PokerStars Hand #222986518133:  Hold'em No Limit ($2.50/$5.00 USD) - 2021/01/24 0:24:08 ET
Table 'Aaltje II' 6-max Seat #4 is the button
Seat 1: Rabarber77 ($4000.68 in chips)
Seat 2: RAidakCo ($500 in chips)
Seat 3: IdrinkBEERI ($663.56 in chips)
Seat 4: supbigdiaper ($799.32 in chips)
Seat 5: Yaaaazz ($504.73 in chips)
Seat 6: Labuns ($512.50 in chips)
Yaaaazz: posts small blind $2.50
Labuns: posts big blind $5
*** HOLE CARDS ***
Rabarber77: folds
RAidakCo: folds
IdrinkBEERI: folds
supbigdiaper: raises $7.50 to $12.50
Yaaaazz: folds
Labuns: raises $47.50 to $60
supbigdiaper: raises $70 to $130
Labuns: folds
Uncalled bet ($70) returned to supbigdiaper
supbigdiaper collected $122.50 from pot
supbigdiaper: doesn't show hand
*** SUMMARY ***
Total pot $122.50 | Rake $0
Seat 1: Rabarber77 folded before Flop (didn't bet)
Seat 2: RAidakCo folded before Flop (didn't bet)
Seat 3: IdrinkBEERI folded before Flop (didn't bet)
Seat 4: supbigdiaper (button) collected ($122.50)
Seat 5: Yaaaazz (small blind) folded before Flop
Seat 6: Labuns (big blind) folded before Flop


PokerStars Hand #222986526279:  Hold'em No Limit ($2.50/$5.00 USD) - 2021/01/24 0:24:42 ET
Table 'Aaltje II' 6-max Seat #5 is the button
Seat 1: Rabarber77 ($4000.68 in chips)
Seat 2: RAidakCo ($500 in chips)
Seat 3: IdrinkBEERI ($663.56 in chips)
Seat 4: supbigdiaper ($861.82 in chips)
Seat 5: Yaaaazz ($502.23 in chips)
Seat 6: Labuns ($500 in chips)
Labuns: posts small blind $2.50
Rabarber77: posts big blind $5
*** HOLE CARDS ***
RAidakCo: folds
IdrinkBEERI: folds
supbigdiaper: folds
Yaaaazz: folds
Labuns: raises $10 to $15
Rabarber77: calls $10
*** FLOP *** [3c 2h 8d]
Labuns: bets $8.55
Rabarber77: raises $22.80 to $31.35
Labuns: folds
Uncalled bet ($22.80) returned to Rabarber77
Rabarber77 collected $44.74 from pot
Rabarber77: doesn't show hand
*** SUMMARY ***
Total pot $47.10 | Rake $2.36
Board [3c 2h 8d]
Seat 1: Rabarber77 (big blind) collected ($44.74)
Seat 2: RAidakCo folded before Flop (didn't bet)
Seat 3: IdrinkBEERI folded before Flop (didn't bet)
Seat 4: supbigdiaper folded before Flop (didn't bet)
Seat 5: Yaaaazz (button) folded before Flop (didn't bet)
Seat 6: Labuns (small blind) folded on the Flop


PokerStars Hand #222986533276:  Hold'em No Limit ($2.50/$5.00 USD) - 2021/01/24 0:25:11 ET
Table 'Aaltje II' 6-max Seat #6 is the button
Seat 1: Rabarber77 ($4021.87 in chips)
Seat 2: RAidakCo ($500 in chips)
Seat 3: IdrinkBEERI ($663.56 in chips)
Seat 4: supbigdiaper ($861.82 in chips)
Seat 5: Yaaaazz ($502.23 in chips)
Seat 6: Labuns ($500 in chips)
Rabarber77: posts small blind $2.50
RAidakCo: posts big blind $5
*** HOLE CARDS ***
IdrinkBEERI: folds
supbigdiaper: folds
Yaaaazz: folds
Labuns: raises $7.25 to $12.25
Rabarber77: folds
RAidakCo: calls $7.25
*** FLOP *** [9d Ac 7d]
RAidakCo: checks
Labuns: checks
*** TURN *** [9d Ac 7d] [Td]
RAidakCo: bets $19.24
Labuns: calls $19.24
*** RIVER *** [9d Ac 7d Td] [5s]
RAidakCo: bets $46.86
Labuns: calls $46.86
*** SHOW DOWN ***
RAidakCo: shows [Ad 6h] (a pair of Aces)
Labuns: mucks hand
RAidakCo collected $156.20 from pot
*** SUMMARY ***
Total pot $159.20 | Rake $3
Board [9d Ac 7d Td 5s]
Seat 1: Rabarber77 (small blind) folded before Flop
Seat 2: RAidakCo (big blind) showed [Ad 6h] and won ($156.20) with a pair of Aces
Seat 3: IdrinkBEERI folded before Flop (didn't bet)
Seat 4: supbigdiaper folded before Flop (didn't bet)
Seat 5: Yaaaazz folded before Flop (didn't bet)
Seat 6: Labuns (button) mucked


PokerStars Hand #222986544882:  Hold'em No Limit ($2.50/$5.00 USD) - 2021/01/24 0:25:59 ET
Table 'Aaltje II' 6-max Seat #1 is the button
Seat 1: Rabarber77 ($4019.37 in chips)
Seat 2: RAidakCo ($577.85 in chips)
Seat 3: IdrinkBEERI ($663.56 in chips)
Seat 4: supbigdiaper ($861.82 in chips)
Seat 5: Yaaaazz ($502.23 in chips)
Seat 6: Labuns ($500 in chips)
RAidakCo: posts small blind $2.50
IdrinkBEERI: posts big blind $5
*** HOLE CARDS ***
supbigdiaper: folds
Yaaaazz: folds
Labuns: folds
Rabarber77: folds
RAidakCo: raises $10 to $15
IdrinkBEERI: folds
Uncalled bet ($10) returned to RAidakCo
RAidakCo collected $10 from pot
RAidakCo: doesn't show hand
*** SUMMARY ***
Total pot $10 | Rake $0
Seat 1: Rabarber77 (button) folded before Flop (didn't bet)
Seat 2: RAidakCo (small blind) collected ($10)
Seat 3: IdrinkBEERI (big blind) folded before Flop
Seat 4: supbigdiaper folded before Flop (didn't bet)
Seat 5: Yaaaazz folded before Flop (didn't bet)
Seat 6: Labuns folded before Flop (didn't bet)


PokerStars Hand #222986548984:  Hold'em No Limit ($2.50/$5.00 USD) - 2021/01/24 0:26:16 ET
Table 'Aaltje II' 6-max Seat #2 is the button
Seat 1: Rabarber77 ($4019.37 in chips)
Seat 2: RAidakCo ($582.85 in chips)
Seat 3: IdrinkBEERI ($658.56 in chips)
Seat 4: supbigdiaper ($861.82 in chips)
Seat 5: Yaaaazz ($502.23 in chips)
Seat 6: Labuns ($500 in chips)
IdrinkBEERI: posts small blind $2.50
supbigdiaper: posts big blind $5
*** HOLE CARDS ***
Yaaaazz: folds
Labuns: folds
Rabarber77: folds
RAidakCo: folds
IdrinkBEERI: raises $9.85 to $14.85
supbigdiaper: folds
Uncalled bet ($9.85) returned to IdrinkBEERI
IdrinkBEERI collected $10 from pot
IdrinkBEERI: doesn't show hand
*** SUMMARY ***
Total pot $10 | Rake $0
Seat 1: Rabarber77 folded before Flop (didn't bet)
Seat 2: RAidakCo (button) folded before Flop (didn't bet)
Seat 3: IdrinkBEERI (small blind) collected ($10)
Seat 4: supbigdiaper (big blind) folded before Flop
Seat 5: Yaaaazz folded before Flop (didn't bet)
Seat 6: Labuns folded before Flop (didn't bet)


PokerStars Hand #222986552276:  Hold'em No Limit ($2.50/$5.00 USD) - 2021/01/24 0:26:30 ET
Table 'Aaltje II' 6-max Seat #3 is the button
Seat 1: Rabarber77 ($4019.37 in chips)
Seat 2: RAidakCo ($582.85 in chips)
Seat 3: IdrinkBEERI ($663.56 in chips)
Seat 4: supbigdiaper ($856.82 in chips)
Seat 5: Yaaaazz ($502.23 in chips)
Seat 6: Labuns ($500 in chips)
supbigdiaper: posts small blind $2.50
Yaaaazz: posts big blind $5
*** HOLE CARDS ***
Labuns: folds
Rabarber77: raises $10 to $15
RAidakCo: raises $30 to $45
IdrinkBEERI: folds
supbigdiaper: calls $42.50
Yaaaazz: folds
Rabarber77: calls $30
*** FLOP *** [Tc Kc Jd]
supbigdiaper: checks
Rabarber77: checks
RAidakCo: bets $41.10
supbigdiaper: calls $41.10
Rabarber77: raises $3933.27 to $3974.37 and is all-in
RAidakCo: calls $496.75 and is all-in
supbigdiaper: folds
Uncalled bet ($3436.52) returned to Rabarber77
*** TURN *** [Tc Kc Jd] [6s]
*** RIVER *** [Tc Kc Jd 6s] [8d]
*** SHOW DOWN ***
Rabarber77: shows [Qd Ad] (a straight, Ten to Ace)
RAidakCo: shows [Qc Td] (a pair of Tens)
Rabarber77 collected $1253.80 from pot
*** SUMMARY ***
Total pot $1256.80 | Rake $3
Board [Tc Kc Jd 6s 8d]
Seat 1: Rabarber77 showed [Qd Ad] and won ($1253.80) with a straight, Ten to Ace
Seat 2: RAidakCo showed [Qc Td] and lost with a pair of Tens
Seat 3: IdrinkBEERI (button) folded before Flop (didn't bet)
Seat 4: supbigdiaper (small blind) folded on the Flop
Seat 5: Yaaaazz (big blind) folded before Flop
Seat 6: Labuns folded before Flop (didn't bet)


PokerStars Hand #222986567816:  Hold'em No Limit ($2.50/$5.00 USD) - 2021/01/24 0:27:35 ET
Table 'Aaltje II' 6-max Seat #4 is the button
Seat 1: Rabarber77 ($4690.32 in chips)
Seat 2: RAidakCo ($500 in chips)
Seat 3: IdrinkBEERI ($663.56 in chips)
Seat 4: supbigdiaper ($770.72 in chips)
Seat 5: Yaaaazz ($500 in chips)
Seat 6: Labuns ($500 in chips)
Yaaaazz: posts small blind $2.50
Labuns: posts big blind $5
*** HOLE CARDS ***
Rabarber77: folds
RAidakCo: folds
IdrinkBEERI: folds
supbigdiaper: raises $7.50 to $12.50
Yaaaazz: folds
Labuns: folds
Uncalled bet ($7.50) returned to supbigdiaper
supbigdiaper collected $12.50 from pot
supbigdiaper: doesn't show hand
*** SUMMARY ***
Total pot $12.50 | Rake $0
Seat 1: Rabarber77 folded before Flop (didn't bet)
Seat 2: RAidakCo folded before Flop (didn't bet)
Seat 3: IdrinkBEERI folded before Flop (didn't bet)
Seat 4: supbigdiaper (button) collected ($12.50)
Seat 5: Yaaaazz (small blind) folded before Flop
Seat 6: Labuns (big blind) folded before Flop


PokerStars Hand #222986572933:  Hold'em No Limit ($2.50/$5.00 USD) - 2021/01/24 0:27:56 ET
Table 'Aaltje II' 6-max Seat #5 is the button
Seat 1: Rabarber77 ($4690.32 in chips)
Seat 2: RAidakCo ($500 in chips)
Seat 3: IdrinkBEERI ($663.56 in chips)
Seat 4: supbigdiaper ($778.22 in chips)
Seat 5: Yaaaazz ($500 in chips)
Seat 6: Labuns ($500 in chips)
Labuns: posts small blind $2.50
Rabarber77: posts big blind $5
*** HOLE CARDS ***
RAidakCo: raises $6 to $11
IdrinkBEERI: folds
supbigdiaper: folds
Yaaaazz: folds
Labuns: folds
Rabarber77: calls $6
*** FLOP *** [Ac 5h 6s]
Rabarber77: checks
RAidakCo: bets $6.98
Rabarber77: calls $6.98
*** TURN *** [Ac 5h 6s] [7h]
Rabarber77: bets $18.27
RAidakCo: calls $18.27
*** RIVER *** [Ac 5h 6s 7h] [Kh]
Rabarber77: checks
RAidakCo: bets $100
Rabarber77: folds
Uncalled bet ($100) returned to RAidakCo
RAidakCo collected $72 from pot
RAidakCo: doesn't show hand
*** SUMMARY ***
Total pot $75 | Rake $3
Board [Ac 5h 6s 7h Kh]
Seat 1: Rabarber77 (big blind) folded on the River
Seat 2: RAidakCo collected ($72)
Seat 3: IdrinkBEERI folded before Flop (didn't bet)
Seat 4: supbigdiaper folded before Flop (didn't bet)
Seat 5: Yaaaazz (button) folded before Flop (didn't bet)
Seat 6: Labuns (small blind) folded before Flop


PokerStars Hand #222986585715:  Hold'em No Limit ($2.50/$5.00 USD) - 2021/01/24 0:28:50 ET
Table 'Aaltje II' 6-max Seat #6 is the button
Seat 1: Rabarber77 ($4654.07 in chips)
Seat 2: RAidakCo ($535.75 in chips)
Seat 3: IdrinkBEERI ($663.56 in chips)
Seat 4: supbigdiaper ($778.22 in chips)
Seat 5: Yaaaazz ($500 in chips)
Seat 6: Labuns ($500 in chips)
Rabarber77: posts small blind $2.50
RAidakCo: posts big blind $5
*** HOLE CARDS ***
IdrinkBEERI: raises $5.50 to $10.50
supbigdiaper: folds
Yaaaazz: folds
Labuns: folds
Rabarber77: calls $8
RAidakCo: folds
*** FLOP *** [7h 4h 6s]
Rabarber77: checks
IdrinkBEERI: bets $16.55
Rabarber77: calls $16.55
*** TURN *** [7h 4h 6s] [8c]
Rabarber77: bets $28.07
IdrinkBEERI: calls $28.07
*** RIVER *** [7h 4h 6s 8c] [3c]
Rabarber77: checks
IdrinkBEERI: checks
*** SHOW DOWN ***
Rabarber77: shows [Ac Jc] (high card Ace)
IdrinkBEERI: shows [Ad 7d] (a pair of Sevens)
IdrinkBEERI collected $112.24 from pot
*** SUMMARY ***
Total pot $115.24 | Rake $3
Board [7h 4h 6s 8c 3c]
Seat 1: Rabarber77 (small blind) showed [Ac Jc] and lost with high card Ace
Seat 2: RAidakCo (big blind) folded before Flop
Seat 3: IdrinkBEERI showed [Ad 7d] and won ($112.24) with a pair of Sevens
Seat 4: supbigdiaper folded before Flop (didn't bet)
Seat 5: Yaaaazz folded before Flop (didn't bet)
Seat 6: Labuns (button) folded before Flop (didn't bet)


PokerStars Hand #222986597324:  Hold'em No Limit ($2.50/$5.00 USD) - 2021/01/24 0:29:38 ET
Table 'Aaltje II' 6-max Seat #1 is the button
Seat 1: Rabarber77 ($4598.95 in chips)
Seat 2: RAidakCo ($530.75 in chips)
Seat 3: IdrinkBEERI ($720.68 in chips)
Seat 4: supbigdiaper ($778.22 in chips)
Seat 5: Yaaaazz ($500 in chips)
Seat 6: Labuns ($500 in chips)
RAidakCo: posts small blind $2.50
IdrinkBEERI: posts big blind $5
*** HOLE CARDS ***
supbigdiaper: folds
Yaaaazz: raises $6.25 to $11.25
Labuns: folds
Rabarber77: calls $11.25
RAidakCo: folds
IdrinkBEERI: folds
*** FLOP *** [Qh 2c 4h]
Yaaaazz: checks
Rabarber77: bets $28.50
Yaaaazz: calls $28.50
*** TURN *** [Qh 2c 4h] [Kd]
Yaaaazz: checks
Rabarber77: bets $60
Yaaaazz: calls $60
*** RIVER *** [Qh 2c 4h Kd] [3h]
Yaaaazz: checks
Rabarber77: checks
*** SHOW DOWN ***
Yaaaazz: shows [Ah Kc] (a pair of Kings)
Rabarber77: mucks hand
Yaaaazz collected $204 from pot
*** SUMMARY ***
Total pot $207 | Rake $3
Board [Qh 2c 4h Kd 3h]
Seat 1: Rabarber77 (button) mucked
Seat 2: RAidakCo (small blind) folded before Flop
Seat 3: IdrinkBEERI (big blind) folded before Flop
Seat 4: supbigdiaper folded before Flop (didn't bet)
Seat 5: Yaaaazz showed [Ah Kc] and won ($204) with a pair of Kings
Seat 6: Labuns folded before Flop (didn't bet)


PokerStars Hand #222986620962:  Hold'em No Limit ($2.50/$5.00 USD) - 2021/01/24 0:31:19 ET
Table 'Aaltje II' 6-max Seat #2 is the button
Seat 1: Rabarber77 ($4499.20 in chips)
Seat 2: RAidakCo ($528.25 in chips)
Seat 3: IdrinkBEERI ($715.68 in chips)
Seat 4: supbigdiaper ($778.22 in chips)
Seat 5: Yaaaazz ($604.25 in chips)
Seat 6: Labuns ($500 in chips)
IdrinkBEERI: posts small blind $2.50
supbigdiaper: posts big blind $5
*** HOLE CARDS ***
Yaaaazz: raises $6.25 to $11.25
Labuns: raises $22.50 to $33.75
Rabarber77: folds
RAidakCo: folds
IdrinkBEERI: folds
supbigdiaper: folds
Yaaaazz: folds
Uncalled bet ($22.50) returned to Labuns
Labuns collected $30 from pot
Labuns: doesn't show hand
*** SUMMARY ***
Total pot $30 | Rake $0
Seat 1: Rabarber77 folded before Flop (didn't bet)
Seat 2: RAidakCo (button) folded before Flop (didn't bet)
Seat 3: IdrinkBEERI (small blind) folded before Flop
Seat 4: supbigdiaper (big blind) folded before Flop
Seat 5: Yaaaazz folded before Flop
Seat 6: Labuns collected ($30)


PokerStars Hand #222986625981:  Hold'em No Limit ($2.50/$5.00 USD) - 2021/01/24 0:31:40 ET
Table 'Aaltje II' 6-max Seat #3 is the button
Seat 1: Rabarber77 ($4499.20 in chips)
Seat 2: RAidakCo ($528.25 in chips)
Seat 3: IdrinkBEERI ($713.18 in chips)
Seat 4: supbigdiaper ($773.22 in chips)
Seat 5: Yaaaazz ($593 in chips)
Seat 6: Labuns ($518.75 in chips)
supbigdiaper: posts small blind $2.50
Yaaaazz: posts big blind $5
*** HOLE CARDS ***
Labuns: folds
Rabarber77: folds
RAidakCo: folds
IdrinkBEERI: raises $9.65 to $14.65
supbigdiaper: raises $51.45 to $66.10
Yaaaazz: folds
IdrinkBEERI: folds
Uncalled bet ($51.45) returned to supbigdiaper
supbigdiaper collected $34.30 from pot
supbigdiaper: doesn't show hand
*** SUMMARY ***
Total pot $34.30 | Rake $0
Seat 1: Rabarber77 folded before Flop (didn't bet)
Seat 2: RAidakCo folded before Flop (didn't bet)
Seat 3: IdrinkBEERI (button) folded before Flop
Seat 4: supbigdiaper (small blind) collected ($34.30)
Seat 5: Yaaaazz (big blind) folded before Flop
Seat 6: Labuns folded before Flop (didn't bet)


PokerStars Hand #222986637187:  Hold'em No Limit ($2.50/$5.00 USD) - 2021/01/24 0:32:27 ET
Table 'Aaltje II' 6-max Seat #4 is the button
Seat 1: Rabarber77 ($4499.20 in chips)
Seat 2: RAidakCo ($528.25 in chips)
Seat 3: IdrinkBEERI ($698.53 in chips)
Seat 4: supbigdiaper ($792.87 in chips)
Seat 5: Yaaaazz ($588 in chips)
Seat 6: Labuns ($518.75 in chips)
Yaaaazz: posts small blind $2.50
Labuns: posts big blind $5
*** HOLE CARDS ***
Rabarber77: folds
RAidakCo: folds
IdrinkBEERI: folds
supbigdiaper: folds
Yaaaazz: folds
Uncalled bet ($2.50) returned to Labuns
Labuns collected $5 from pot
Labuns: doesn't show hand
*** SUMMARY ***
Total pot $5 | Rake $0
Seat 1: Rabarber77 folded before Flop (didn't bet)
Seat 2: RAidakCo folded before Flop (didn't bet)
Seat 3: IdrinkBEERI folded before Flop (didn't bet)
Seat 4: supbigdiaper (button) folded before Flop (didn't bet)
Seat 5: Yaaaazz (small blind) folded before Flop
Seat 6: Labuns (big blind) collected ($5)


PokerStars Hand #222986639587:  Hold'em No Limit ($2.50/$5.00 USD) - 2021/01/24 0:32:37 ET
Table 'Aaltje II' 6-max Seat #5 is the button
Seat 2: RAidakCo ($528.25 in chips)
Seat 3: IdrinkBEERI ($698.53 in chips)
Seat 4: supbigdiaper ($792.87 in chips)
Seat 5: Yaaaazz ($585.50 in chips)
Seat 6: Labuns ($521.25 in chips)
Labuns: posts small blind $2.50
RAidakCo: posts big blind $5
*** HOLE CARDS ***
IdrinkBEERI: folds
supbigdiaper: raises $7.50 to $12.50
Yaaaazz: folds
Labuns: folds
RAidakCo: calls $7.50
*** FLOP *** [Qh 2c As]
RAidakCo: checks
supbigdiaper: bets $8.62
RAidakCo: calls $8.62
*** TURN *** [Qh 2c As] [Kd]
RAidakCo: checks
supbigdiaper: checks
*** RIVER *** [Qh 2c As Kd] [Ks]
RAidakCo: checks
supbigdiaper: checks
*** SHOW DOWN ***
RAidakCo: shows [Qc Ah] (two pair, Aces and Kings)
supbigdiaper: mucks hand
RAidakCo collected $42.50 from pot
*** SUMMARY ***
Total pot $44.74 | Rake $2.24
Board [Qh 2c As Kd Ks]
Seat 2: RAidakCo (big blind) showed [Qc Ah] and won ($42.50) with two pair, Aces and Kings
Seat 3: IdrinkBEERI folded before Flop (didn't bet)
Seat 4: supbigdiaper mucked
Seat 5: Yaaaazz (button) folded before Flop (didn't bet)
Seat 6: Labuns (small blind) folded before Flop


PokerStars Hand #222986652293:  Hold'em No Limit ($2.50/$5.00 USD) - 2021/01/24 0:33:32 ET
Table 'Aaltje II' 6-max Seat #6 is the button
Seat 2: RAidakCo ($549.63 in chips)
Seat 3: IdrinkBEERI ($698.53 in chips)
Seat 4: supbigdiaper ($771.75 in chips)
Seat 5: Yaaaazz ($585.50 in chips)
Seat 6: Labuns ($518.75 in chips)
RAidakCo: posts small blind $2.50
IdrinkBEERI: posts big blind $5
*** HOLE CARDS ***
supbigdiaper: folds
Yaaaazz: folds
Labuns: folds
RAidakCo: raises $10 to $15
IdrinkBEERI: calls $10
*** FLOP *** [2d 2c Kc]
RAidakCo: bets $8.55
IdrinkBEERI: raises $23.26 to $31.81
RAidakCo: calls $23.26
*** TURN *** [2d 2c Kc] [Qh]
RAidakCo: checks
IdrinkBEERI: bets $69.78
RAidakCo: calls $69.78
*** RIVER *** [2d 2c Kc Qh] [Qd]
RAidakCo: checks
IdrinkBEERI: checks
*** SHOW DOWN ***
RAidakCo: shows [Ad Qs] (a full house, Queens full of Deuces)
IdrinkBEERI: mucks hand
RAidakCo collected $230.18 from pot
*** SUMMARY ***
Total pot $233.18 | Rake $3
Board [2d 2c Kc Qh Qd]
Seat 2: RAidakCo (small blind) showed [Ad Qs] and won ($230.18) with a full house, Queens full of Deuces
Seat 3: IdrinkBEERI (big blind) mucked
Seat 4: supbigdiaper folded before Flop (didn't bet)
Seat 5: Yaaaazz folded before Flop (didn't bet)
Seat 6: Labuns (button) folded before Flop (didn't bet)


PokerStars Hand #222986670644:  Hold'em No Limit ($2.50/$5.00 USD) - 2021/01/24 0:34:50 ET
Table 'Aaltje II' 6-max Seat #2 is the button
Seat 2: RAidakCo ($663.22 in chips)
Seat 3: IdrinkBEERI ($581.94 in chips)
Seat 4: supbigdiaper ($771.75 in chips)
Seat 5: Yaaaazz ($585.50 in chips)
Seat 6: Labuns ($518.75 in chips)
IdrinkBEERI: posts small blind $2.50
supbigdiaper: posts big blind $5
*** HOLE CARDS ***
Yaaaazz: folds
Labuns: raises $7.25 to $12.25
RAidakCo: folds
IdrinkBEERI: folds
supbigdiaper: folds
Uncalled bet ($7.25) returned to Labuns
Labuns collected $12.50 from pot
Labuns: doesn't show hand
*** SUMMARY ***
Total pot $12.50 | Rake $0
Seat 2: RAidakCo (button) folded before Flop (didn't bet)
Seat 3: IdrinkBEERI (small blind) folded before Flop
Seat 4: supbigdiaper (big blind) folded before Flop
Seat 5: Yaaaazz folded before Flop (didn't bet)
Seat 6: Labuns collected ($12.50)


PokerStars Hand #222986674341:  Hold'em No Limit ($2.50/$5.00 USD) - 2021/01/24 0:35:06 ET
Table 'Aaltje II' 6-max Seat #3 is the button
Seat 2: RAidakCo ($663.22 in chips)
Seat 3: IdrinkBEERI ($579.44 in chips)
Seat 4: supbigdiaper ($766.75 in chips)
Seat 5: Yaaaazz ($585.50 in chips)
Seat 6: Labuns ($526.25 in chips)
supbigdiaper: posts small blind $2.50
Yaaaazz: posts big blind $5
Rabarber77: sits out
*** HOLE CARDS ***
Labuns: folds
RAidakCo: raises $6 to $11
IdrinkBEERI has timed out
IdrinkBEERI: folds
supbigdiaper: folds
Yaaaazz: folds
Uncalled bet ($6) returned to RAidakCo
RAidakCo collected $12.50 from pot
RAidakCo: doesn't show hand
*** SUMMARY ***
Total pot $12.50 | Rake $0
Seat 2: RAidakCo collected ($12.50)
Seat 3: IdrinkBEERI (button) folded before Flop (didn't bet)
Seat 4: supbigdiaper (small blind) folded before Flop
Seat 5: Yaaaazz (big blind) folded before Flop
Seat 6: Labuns folded before Flop (didn't bet)


PokerStars Hand #222986680903:  Hold'em No Limit ($2.50/$5.00 USD) - 2021/01/24 0:35:35 ET
Table 'Aaltje II' 6-max Seat #4 is the button
Seat 2: RAidakCo ($670.72 in chips)
Seat 3: IdrinkBEERI ($579.44 in chips)
Seat 4: supbigdiaper ($764.25 in chips)
Seat 5: Yaaaazz ($580.50 in chips)
Seat 6: Labuns ($526.25 in chips)
Yaaaazz: posts small blind $2.50
Labuns: posts big blind $5
Rabarber77: sits out
*** HOLE CARDS ***
RAidakCo: folds
IdrinkBEERI: folds
supbigdiaper: raises $7.50 to $12.50
Yaaaazz: folds
Labuns: calls $7.50
*** FLOP *** [Kc 5s Ks]
Labuns: checks
supbigdiaper: bets $8.62
Labuns: calls $8.62
*** TURN *** [Kc 5s Ks] [9s]
Labuns: checks
supbigdiaper: bets $21.25
Labuns: calls $21.25
*** RIVER *** [Kc 5s Ks 9s] [6h]
Labuns: checks
supbigdiaper: checks
*** SHOW DOWN ***
Labuns: shows [8s Kh] (three of a kind, Kings)
supbigdiaper: mucks hand
Labuns collected $84.24 from pot
*** SUMMARY ***
Total pot $87.24 | Rake $3
Board [Kc 5s Ks 9s 6h]
Seat 2: RAidakCo folded before Flop (didn't bet)
Seat 3: IdrinkBEERI folded before Flop (didn't bet)
Seat 4: supbigdiaper (button) mucked
Seat 5: Yaaaazz (small blind) folded before Flop
Seat 6: Labuns (big blind) showed [8s Kh] and won ($84.24) with three of a kind, Kings


PokerStars Hand #222986691392:  Hold'em No Limit ($2.50/$5.00 USD) - 2021/01/24 0:36:20 ET
Table 'Aaltje II' 6-max Seat #5 is the button
Seat 1: Rabarber77 ($4499.20 in chips)
Seat 2: RAidakCo ($670.72 in chips)
Seat 3: IdrinkBEERI ($579.44 in chips)
Seat 4: supbigdiaper ($721.88 in chips)
Seat 5: Yaaaazz ($578 in chips)
Seat 6: Labuns ($568.12 in chips)
Labuns: posts small blind $2.50
Rabarber77: posts big blind $5
*** HOLE CARDS ***
RAidakCo: folds
IdrinkBEERI: folds
supbigdiaper: folds
Yaaaazz: folds
Labuns: raises $10 to $15
Rabarber77: calls $10
*** FLOP *** [Qc 3h 9d]
Labuns: bets $8.55
Rabarber77: folds
Uncalled bet ($8.55) returned to Labuns
Labuns collected $28.50 from pot
Labuns: doesn't show hand
*** SUMMARY ***
Total pot $30 | Rake $1.50
Board [Qc 3h 9d]
Seat 1: Rabarber77 (big blind) folded on the Flop
Seat 2: RAidakCo folded before Flop (didn't bet)
Seat 3: IdrinkBEERI folded before Flop (didn't bet)
Seat 4: supbigdiaper folded before Flop (didn't bet)
Seat 5: Yaaaazz (button) folded before Flop (didn't bet)
Seat 6: Labuns (small blind) collected ($28.50)


PokerStars Hand #222986712341:  Hold'em No Limit ($2.50/$5.00 USD) - 2021/01/24 0:37:52 ET
Table 'Aaltje II' 6-max Seat #1 is the button
Seat 1: Rabarber77 ($4369.20 in chips)
Seat 2: RAidakCo ($665.72 in chips)
Seat 3: IdrinkBEERI ($579.44 in chips)
Seat 4: supbigdiaper ($721.88 in chips)
Seat 5: Yaaaazz ($578 in chips)
Seat 6: Labuns ($698.62 in chips)
RAidakCo: posts small blind $2.50
IdrinkBEERI: posts big blind $5
*** HOLE CARDS ***
supbigdiaper: folds
Yaaaazz: folds
Labuns: raises $7.25 to $12.25
Rabarber77: calls $12.25
RAidakCo: folds
IdrinkBEERI: folds
*** FLOP *** [8s 9s Tc]
Labuns: checks
Rabarber77: bets $15.20
Labuns: calls $15.20
*** TURN *** [8s 9s Tc] [Jh]
Labuns: checks
Rabarber77: checks
*** RIVER *** [8s 9s Tc Jh] [7d]
Labuns: bets $44.55
Rabarber77: folds
Uncalled bet ($44.55) returned to Labuns
Labuns collected $59.40 from pot
Labuns: doesn't show hand
*** SUMMARY ***
Total pot $62.40 | Rake $3
Board [8s 9s Tc Jh 7d]
Seat 1: Rabarber77 (button) folded on the River
Seat 2: RAidakCo (small blind) folded before Flop
Seat 3: IdrinkBEERI (big blind) folded before Flop
Seat 4: supbigdiaper folded before Flop (didn't bet)
Seat 5: Yaaaazz folded before Flop (didn't bet)
Seat 6: Labuns collected ($59.40)


PokerStars Hand #222986725909:  Hold'em No Limit ($2.50/$5.00 USD) - 2021/01/24 0:38:41 ET
Table 'Aaltje II' 6-max Seat #2 is the button
Seat 1: Rabarber77 ($4341.75 in chips)
Seat 2: RAidakCo ($663.22 in chips)
Seat 3: IdrinkBEERI ($574.44 in chips)
Seat 4: supbigdiaper ($721.88 in chips)
Seat 5: Yaaaazz ($578 in chips)
Seat 6: Labuns ($730.57 in chips)
IdrinkBEERI: posts small blind $2.50
supbigdiaper: posts big blind $5
*** HOLE CARDS ***
Yaaaazz: folds
Labuns: folds
Rabarber77: folds
RAidakCo: raises $7.50 to $12.50
IdrinkBEERI: folds
supbigdiaper: folds
Uncalled bet ($7.50) returned to RAidakCo
RAidakCo collected $12.50 from pot
RAidakCo: doesn't show hand
*** SUMMARY ***
Total pot $12.50 | Rake $0
Seat 1: Rabarber77 folded before Flop (didn't bet)
Seat 2: RAidakCo (button) collected ($12.50)
Seat 3: IdrinkBEERI (small blind) folded before Flop
Seat 4: supbigdiaper (big blind) folded before Flop
Seat 5: Yaaaazz folded before Flop (didn't bet)
Seat 6: Labuns folded before Flop (didn't bet)


PokerStars Hand #222986728368:  Hold'em No Limit ($2.50/$5.00 USD) - 2021/01/24 0:38:51 ET
Table 'Aaltje II' 6-max Seat #3 is the button
Seat 1: Rabarber77 ($4341.75 in chips)
Seat 2: RAidakCo ($670.72 in chips)
Seat 3: IdrinkBEERI ($571.94 in chips)
Seat 4: supbigdiaper ($716.88 in chips)
Seat 5: Yaaaazz ($578 in chips)
Seat 6: Labuns ($730.57 in chips)
supbigdiaper: posts small blind $2.50
Yaaaazz: posts big blind $5
*** HOLE CARDS ***
Labuns: folds
Rabarber77: folds
RAidakCo: folds
IdrinkBEERI: raises $9.65 to $14.65
supbigdiaper: folds
Yaaaazz: folds
Uncalled bet ($9.65) returned to IdrinkBEERI
IdrinkBEERI collected $12.50 from pot
IdrinkBEERI: doesn't show hand
*** SUMMARY ***
Total pot $12.50 | Rake $0
Seat 1: Rabarber77 folded before Flop (didn't bet)
Seat 2: RAidakCo folded before Flop (didn't bet)
Seat 3: IdrinkBEERI (button) collected ($12.50)
Seat 4: supbigdiaper (small blind) folded before Flop
Seat 5: Yaaaazz (big blind) folded before Flop
Seat 6: Labuns folded before Flop (didn't bet)


PokerStars Hand #222986731351:  Hold'em No Limit ($2.50/$5.00 USD) - 2021/01/24 0:39:04 ET
Table 'Aaltje II' 6-max Seat #4 is the button
Seat 1: Rabarber77 ($4341.75 in chips)
Seat 2: RAidakCo ($670.72 in chips)
Seat 3: IdrinkBEERI ($579.44 in chips)
Seat 4: supbigdiaper ($714.38 in chips)
Seat 5: Yaaaazz ($573 in chips)
Seat 6: Labuns ($730.57 in chips)
Yaaaazz: posts small blind $2.50
Labuns: posts big blind $5
*** HOLE CARDS ***
Rabarber77: folds
RAidakCo: folds
IdrinkBEERI: folds
supbigdiaper: folds
Yaaaazz: folds
Uncalled bet ($2.50) returned to Labuns
Labuns collected $5 from pot
Labuns: doesn't show hand
*** SUMMARY ***
Total pot $5 | Rake $0
Seat 1: Rabarber77 folded before Flop (didn't bet)
Seat 2: RAidakCo folded before Flop (didn't bet)
Seat 3: IdrinkBEERI folded before Flop (didn't bet)
Seat 4: supbigdiaper (button) folded before Flop (didn't bet)
Seat 5: Yaaaazz (small blind) folded before Flop
Seat 6: Labuns (big blind) collected ($5)


PokerStars Hand #222986734774:  Hold'em No Limit ($2.50/$5.00 USD) - 2021/01/24 0:39:20 ET
Table 'Aaltje II' 6-max Seat #5 is the button
Seat 1: Rabarber77 ($4341.75 in chips)
Seat 2: RAidakCo ($670.72 in chips)
Seat 3: IdrinkBEERI ($579.44 in chips)
Seat 4: supbigdiaper ($714.38 in chips)
Seat 5: Yaaaazz ($570.50 in chips)
Seat 6: Labuns ($733.07 in chips)
Labuns: posts small blind $2.50
Rabarber77: posts big blind $5
*** HOLE CARDS ***
RAidakCo: folds
IdrinkBEERI: folds
supbigdiaper: raises $7.50 to $12.50
Yaaaazz: folds
Labuns: folds
Rabarber77: calls $7.50
*** FLOP *** [Tc 5h 5c]
Rabarber77: checks
supbigdiaper: checks
*** TURN *** [Tc 5h 5c] [Qc]
Rabarber77: bets $26.12
supbigdiaper: folds
Uncalled bet ($26.12) returned to Rabarber77
Rabarber77 collected $26.12 from pot
Rabarber77: doesn't show hand
*** SUMMARY ***
Total pot $27.50 | Rake $1.38
Board [Tc 5h 5c Qc]
Seat 1: Rabarber77 (big blind) collected ($26.12)
Seat 2: RAidakCo folded before Flop (didn't bet)
Seat 3: IdrinkBEERI folded before Flop (didn't bet)
Seat 4: supbigdiaper folded on the Turn
Seat 5: Yaaaazz (button) folded before Flop (didn't bet)
Seat 6: Labuns (small blind) folded before Flop


PokerStars Hand #222986744122:  Hold'em No Limit ($2.50/$5.00 USD) - 2021/01/24 0:40:01 ET
Table 'Aaltje II' 6-max Seat #1 is the button
Seat 1: Rabarber77 ($4352.87 in chips)
Seat 2: RAidakCo ($665.72 in chips)
Seat 3: IdrinkBEERI ($579.44 in chips)
Seat 4: supbigdiaper ($701.88 in chips)
Seat 5: Yaaaazz ($578 in chips)
Seat 6: Labuns ($730.57 in chips)
RAidakCo: posts small blind $2.50
IdrinkBEERI: posts big blind $5
*** HOLE CARDS ***
supbigdiaper: raises $7.50 to $12.50
Yaaaazz: raises $25 to $37.50
Labuns: folds
Rabarber77: calls $37.50
RAidakCo: folds
IdrinkBEERI: folds
supbigdiaper: calls $25
*** FLOP *** [2s 9d 5c]
supbigdiaper: checks
Yaaaazz: bets $58.50
Rabarber77: calls $58.50
supbigdiaper: calls $58.50
*** TURN *** [2s 9d 5c] [Qh]
supbigdiaper: checks
Yaaaazz: bets $146.25
Rabarber77: folds
supbigdiaper: raises $459.63 to $605.88 and is all-in
Yaaaazz: folds
Uncalled bet ($459.63) returned to supbigdiaper
supbigdiaper collected $585 from pot
supbigdiaper: doesn't show hand
*** SUMMARY ***
Total pot $588 | Rake $3
Board [2s 9d 5c Qh]
Seat 1: Rabarber77 (button) folded on the Turn
Seat 2: RAidakCo (small blind) folded before Flop
Seat 3: IdrinkBEERI (big blind) folded before Flop
Seat 4: supbigdiaper collected ($585)
Seat 5: Yaaaazz folded on the Turn
Seat 6: Labuns folded before Flop (didn't bet)


PokerStars Hand #222986765008:  Hold'em No Limit ($2.50/$5.00 USD) - 2021/01/24 0:41:35 ET
Table 'Aaltje II' 6-max Seat #2 is the button
Seat 1: Rabarber77 ($4256.87 in chips)
Seat 2: RAidakCo ($663.22 in chips)
Seat 3: IdrinkBEERI ($574.44 in chips)
Seat 4: supbigdiaper ($1044.63 in chips)
Seat 5: Yaaaazz ($500 in chips)
Seat 6: Labuns ($730.57 in chips)
IdrinkBEERI: posts small blind $2.50
supbigdiaper: posts big blind $5
*** HOLE CARDS ***
Yaaaazz: raises $6.25 to $11.25
Labuns: raises $22.50 to $33.75
Rabarber77: folds
RAidakCo: folds
IdrinkBEERI: folds
supbigdiaper: folds
Yaaaazz: raises $67.50 to $101.25
Labuns: folds
Uncalled bet ($67.50) returned to Yaaaazz
Yaaaazz collected $75 from pot
Yaaaazz: doesn't show hand
*** SUMMARY ***
Total pot $75 | Rake $0
Seat 1: Rabarber77 folded before Flop (didn't bet)
Seat 2: RAidakCo (button) folded before Flop (didn't bet)
Seat 3: IdrinkBEERI (small blind) folded before Flop
Seat 4: supbigdiaper (big blind) folded before Flop
Seat 5: Yaaaazz collected ($75)
Seat 6: Labuns folded before Flop


PokerStars Hand #222986770010:  Hold'em No Limit ($2.50/$5.00 USD) - 2021/01/24 0:41:57 ET
Table 'Aaltje II' 6-max Seat #3 is the button
Seat 1: Rabarber77 ($4256.87 in chips)
Seat 2: RAidakCo ($663.22 in chips)
Seat 3: IdrinkBEERI ($571.94 in chips)
Seat 4: supbigdiaper ($1039.63 in chips)
Seat 5: Yaaaazz ($541.25 in chips)
Seat 6: Labuns ($696.82 in chips)
supbigdiaper: posts small blind $2.50
Yaaaazz: posts big blind $5
*** HOLE CARDS ***
Labuns: raises $5.50 to $10.50
Rabarber77: calls $10.50
RAidakCo: folds
IdrinkBEERI: calls $10.50
supbigdiaper: raises $58.75 to $69.25
Yaaaazz: folds
Labuns: folds
Rabarber77: calls $58.75
IdrinkBEERI: calls $58.75
*** FLOP *** [3h 2d 6h]
supbigdiaper: checks
Rabarber77: bets $110
IdrinkBEERI: calls $110
supbigdiaper: folds
*** TURN *** [3h 2d 6h] [8d]
Rabarber77: bets $245
IdrinkBEERI: raises $147.69 to $392.69 and is all-in
Rabarber77: calls $147.69
*** RIVER *** [3h 2d 6h 8d] [4d]
*** SHOW DOWN ***
Rabarber77: shows [8c 9c] (a pair of Eights)
IdrinkBEERI: shows [7c 7h] (a pair of Sevens)
Rabarber77 collected $1225.63 from pot
*** SUMMARY ***
Total pot $1228.63 | Rake $3
Board [3h 2d 6h 8d 4d]
Seat 1: Rabarber77 showed [8c 9c] and won ($1225.63) with a pair of Eights
Seat 2: RAidakCo folded before Flop (didn't bet)
Seat 3: IdrinkBEERI (button) showed [7c 7h] and lost with a pair of Sevens
Seat 4: supbigdiaper (small blind) folded on the Flop
Seat 5: Yaaaazz (big blind) folded before Flop
Seat 6: Labuns folded before Flop


PokerStars Hand #222986790909:  Hold'em No Limit ($2.50/$5.00 USD) - 2021/01/24 0:43:30 ET
Table 'Aaltje II' 6-max Seat #4 is the button
Seat 1: Rabarber77 ($4910.56 in chips)
Seat 2: RAidakCo ($663.22 in chips)
Seat 3: IdrinkBEERI ($500 in chips)
Seat 4: supbigdiaper ($970.38 in chips)
Seat 5: Yaaaazz ($536.25 in chips)
Seat 6: Labuns ($686.32 in chips)
Yaaaazz: posts small blind $2.50
Labuns: posts big blind $5
*** HOLE CARDS ***
Rabarber77: folds
RAidakCo: folds
IdrinkBEERI: folds
supbigdiaper: folds
Yaaaazz: raises $10 to $15
Labuns: folds
Uncalled bet ($10) returned to Yaaaazz
Yaaaazz collected $10 from pot
Yaaaazz: doesn't show hand
*** SUMMARY ***
Total pot $10 | Rake $0
Seat 1: Rabarber77 folded before Flop (didn't bet)
Seat 2: RAidakCo folded before Flop (didn't bet)
Seat 3: IdrinkBEERI folded before Flop (didn't bet)
Seat 4: supbigdiaper (button) folded before Flop (didn't bet)
Seat 5: Yaaaazz (small blind) collected ($10)
Seat 6: Labuns (big blind) folded before Flop


PokerStars Hand #222986793464:  Hold'em No Limit ($2.50/$5.00 USD) - 2021/01/24 0:43:41 ET
Table 'Aaltje II' 6-max Seat #5 is the button
Seat 1: Rabarber77 ($4910.56 in chips)
Seat 2: RAidakCo ($663.22 in chips)
Seat 3: IdrinkBEERI ($500 in chips)
Seat 4: supbigdiaper ($970.38 in chips)
Seat 5: Yaaaazz ($541.25 in chips)
Seat 6: Labuns ($681.32 in chips)
Labuns: posts small blind $2.50
Rabarber77: posts big blind $5
*** HOLE CARDS ***
RAidakCo: folds
IdrinkBEERI: folds
supbigdiaper: raises $7.50 to $12.50
Yaaaazz: folds
Labuns: folds
Rabarber77: calls $7.50
*** FLOP *** [6d 3s Jd]
Rabarber77: checks
supbigdiaper: checks
*** TURN *** [6d 3s Jd] [Qs]
Rabarber77: bets $13.06
supbigdiaper: calls $13.06
*** RIVER *** [6d 3s Jd Qs] [Kd]
Rabarber77: checks
supbigdiaper: bets $25.47
Rabarber77: folds
Uncalled bet ($25.47) returned to supbigdiaper
supbigdiaper collected $50.94 from pot
supbigdiaper: doesn't show hand
*** SUMMARY ***
Total pot $53.62 | Rake $2.68
Board [6d 3s Jd Qs Kd]
Seat 1: Rabarber77 (big blind) folded on the River
Seat 2: RAidakCo folded before Flop (didn't bet)
Seat 3: IdrinkBEERI folded before Flop (didn't bet)
Seat 4: supbigdiaper collected ($50.94)
Seat 5: Yaaaazz (button) folded before Flop (didn't bet)
Seat 6: Labuns (small blind) folded before Flop


PokerStars Hand #222986802696:  Hold'em No Limit ($2.50/$5.00 USD) - 2021/01/24 0:44:22 ET
Table 'Aaltje II' 6-max Seat #6 is the button
Seat 1: Rabarber77 ($4885 in chips)
Seat 2: RAidakCo ($663.22 in chips)
Seat 3: IdrinkBEERI ($500 in chips)
Seat 4: supbigdiaper ($995.76 in chips)
Seat 5: Yaaaazz ($541.25 in chips)
Seat 6: Labuns ($678.82 in chips)
Rabarber77: posts small blind $2.50
RAidakCo: posts big blind $5
*** HOLE CARDS ***
IdrinkBEERI has timed out
IdrinkBEERI: folds
supbigdiaper: folds
Yaaaazz: folds
Labuns: raises $7.25 to $12.25
Rabarber77: raises $29.50 to $41.75
RAidakCo: folds
Labuns: folds
Uncalled bet ($29.50) returned to Rabarber77
Rabarber77 collected $29.50 from pot
Rabarber77: doesn't show hand
*** SUMMARY ***
Total pot $29.50 | Rake $0
Seat 1: Rabarber77 (small blind) collected ($29.50)
Seat 2: RAidakCo (big blind) folded before Flop
Seat 3: IdrinkBEERI folded before Flop (didn't bet)
Seat 4: supbigdiaper folded before Flop (didn't bet)
Seat 5: Yaaaazz folded before Flop (didn't bet)
Seat 6: Labuns (button) folded before Flop


PokerStars Hand #222986808295:  Hold'em No Limit ($2.50/$5.00 USD) - 2021/01/24 0:44:47 ET
Table 'Aaltje II' 6-max Seat #1 is the button
Seat 1: Rabarber77 ($4902.25 in chips)
Seat 2: RAidakCo ($658.22 in chips)
Seat 3: IdrinkBEERI ($500 in chips)
Seat 4: supbigdiaper ($995.76 in chips)
Seat 5: Yaaaazz ($541.25 in chips)
Seat 6: Labuns ($666.57 in chips)
RAidakCo: posts small blind $2.50
IdrinkBEERI: posts big blind $5
*** HOLE CARDS ***
supbigdiaper: folds
Yaaaazz: folds
Labuns: folds
Rabarber77: folds
RAidakCo: raises $10 to $15
IdrinkBEERI: raises $30 to $45
RAidakCo: folds
Uncalled bet ($30) returned to IdrinkBEERI
IdrinkBEERI collected $30 from pot
IdrinkBEERI: doesn't show hand
*** SUMMARY ***
Total pot $30 | Rake $0
Seat 1: Rabarber77 (button) folded before Flop (didn't bet)
Seat 2: RAidakCo (small blind) folded before Flop
Seat 3: IdrinkBEERI (big blind) collected ($30)
Seat 4: supbigdiaper folded before Flop (didn't bet)
Seat 5: Yaaaazz folded before Flop (didn't bet)
Seat 6: Labuns folded before Flop (didn't bet)


PokerStars Hand #222986813314:  Hold'em No Limit ($2.50/$5.00 USD) - 2021/01/24 0:45:09 ET
Table 'Aaltje II' 6-max Seat #2 is the button
Seat 1: Rabarber77 ($4902.25 in chips)
Seat 2: RAidakCo ($643.22 in chips)
Seat 3: IdrinkBEERI ($515 in chips)
Seat 4: supbigdiaper ($995.76 in chips)
Seat 5: Yaaaazz ($541.25 in chips)
Seat 6: Labuns ($666.57 in chips)
IdrinkBEERI: posts small blind $2.50
supbigdiaper: posts big blind $5
*** HOLE CARDS ***
Yaaaazz: folds
Labuns: folds
Rabarber77: folds
RAidakCo: folds
IdrinkBEERI: folds
Uncalled bet ($2.50) returned to supbigdiaper
supbigdiaper collected $5 from pot
supbigdiaper: doesn't show hand
*** SUMMARY ***
Total pot $5 | Rake $0
Seat 1: Rabarber77 folded before Flop (didn't bet)
Seat 2: RAidakCo (button) folded before Flop (didn't bet)
Seat 3: IdrinkBEERI (small blind) folded before Flop
Seat 4: supbigdiaper (big blind) collected ($5)
Seat 5: Yaaaazz folded before Flop (didn't bet)
Seat 6: Labuns folded before Flop (didn't bet)


PokerStars Hand #222986820337:  Hold'em No Limit ($2.50/$5.00 USD) - 2021/01/24 0:45:18 ET
Table 'Aaltje II' 6-max Seat #3 is the button
Seat 1: Rabarber77 ($4902.25 in chips)
Seat 2: RAidakCo ($643.22 in chips)
Seat 3: IdrinkBEERI ($512.50 in chips)
Seat 4: supbigdiaper ($998.26 in chips)
Seat 5: Yaaaazz ($541.25 in chips)
Seat 6: Labuns ($666.57 in chips)
supbigdiaper: posts small blind $2.50
Yaaaazz: posts big blind $5
*** HOLE CARDS ***
Labuns: folds
Rabarber77: folds
RAidakCo: folds
IdrinkBEERI: folds
supbigdiaper: raises $7.50 to $12.50
Yaaaazz: folds
Uncalled bet ($7.50) returned to supbigdiaper
supbigdiaper collected $10 from pot
supbigdiaper: doesn't show hand
*** SUMMARY ***
Total pot $10 | Rake $0
Seat 1: Rabarber77 folded before Flop (didn't bet)
Seat 2: RAidakCo folded before Flop (didn't bet)
Seat 3: IdrinkBEERI (button) folded before Flop (didn't bet)
Seat 4: supbigdiaper (small blind) collected ($10)
Seat 5: Yaaaazz (big blind) folded before Flop
Seat 6: Labuns folded before Flop (didn't bet)


PokerStars Hand #222986824111:  Hold'em No Limit ($2.50/$5.00 USD) - 2021/01/24 0:45:35 ET
Table 'Aaltje II' 6-max Seat #4 is the button
Seat 1: Rabarber77 ($4902.25 in chips)
Seat 2: RAidakCo ($643.22 in chips)
Seat 3: IdrinkBEERI ($512.50 in chips)
Seat 4: supbigdiaper ($1003.26 in chips)
Seat 5: Yaaaazz ($536.25 in chips)
Seat 6: Labuns ($666.57 in chips)
Yaaaazz: posts small blind $2.50
Labuns: posts big blind $5
*** HOLE CARDS ***
Rabarber77: raises $10 to $15
RAidakCo: folds
IdrinkBEERI: folds
supbigdiaper: raises $37.88 to $52.88
Yaaaazz: folds
Labuns: folds
Rabarber77: calls $37.88
*** FLOP *** [Qs Ad 7c]
Rabarber77: checks
supbigdiaper: checks
*** TURN *** [Qs Ad 7c] [5d]
Rabarber77: bets $55.13
supbigdiaper: calls $55.13
*** RIVER *** [Qs Ad 7c 5d] [3c]
Rabarber77: bets $220.52
supbigdiaper: folds
Uncalled bet ($220.52) returned to Rabarber77
Rabarber77 collected $220.52 from pot
Rabarber77: doesn't show hand
*** SUMMARY ***
Total pot $223.52 | Rake $3
Board [Qs Ad 7c 5d 3c]
Seat 1: Rabarber77 collected ($220.52)
Seat 2: RAidakCo folded before Flop (didn't bet)
Seat 3: IdrinkBEERI folded before Flop (didn't bet)
Seat 4: supbigdiaper (button) folded on the River
Seat 5: Yaaaazz (small blind) folded before Flop
Seat 6: Labuns (big blind) folded before Flop


PokerStars Hand #222986837324:  Hold'em No Limit ($2.50/$5.00 USD) - 2021/01/24 0:46:33 ET
Table 'Aaltje II' 6-max Seat #5 is the button
Seat 1: Rabarber77 ($5014.76 in chips)
Seat 2: RAidakCo ($643.22 in chips)
Seat 3: IdrinkBEERI ($512.50 in chips)
Seat 4: supbigdiaper ($895.25 in chips)
Seat 5: Yaaaazz ($533.75 in chips)
Seat 6: Labuns ($661.57 in chips)
Labuns: posts small blind $2.50
Rabarber77: posts big blind $5
*** HOLE CARDS ***
RAidakCo: raises $6 to $11
IdrinkBEERI: folds
supbigdiaper: folds
Yaaaazz: folds
Labuns: folds
Rabarber77: raises $6 to $17
RAidakCo: calls $6
*** FLOP *** [2s 2d Kd]
Rabarber77: bets $34.68
RAidakCo: calls $34.68
*** TURN *** [2s 2d Kd] [5h]
Rabarber77: bets $102.86
RAidakCo: folds
Uncalled bet ($102.86) returned to Rabarber77
Rabarber77 collected $102.86 from pot
Rabarber77: doesn't show hand
*** SUMMARY ***
Total pot $105.86 | Rake $3
Board [2s 2d Kd 5h]
Seat 1: Rabarber77 (big blind) collected ($102.86)
Seat 2: RAidakCo folded on the Turn
Seat 3: IdrinkBEERI folded before Flop (didn't bet)
Seat 4: supbigdiaper folded before Flop (didn't bet)
Seat 5: Yaaaazz (button) folded before Flop (didn't bet)
Seat 6: Labuns (small blind) folded before Flop


PokerStars Hand #222986851010:  Hold'em No Limit ($2.50/$5.00 USD) - 2021/01/24 0:47:33 ET
Table 'Aaltje II' 6-max Seat #6 is the button
Seat 1: Rabarber77 ($5065.94 in chips)
Seat 2: RAidakCo ($591.54 in chips)
Seat 3: IdrinkBEERI ($512.50 in chips)
Seat 4: supbigdiaper ($895.25 in chips)
Seat 5: Yaaaazz ($533.75 in chips)
Seat 6: Labuns ($659.07 in chips)
Rabarber77: posts small blind $2.50
RAidakCo: posts big blind $5
*** HOLE CARDS ***
IdrinkBEERI: raises $11.20 to $16.20
supbigdiaper: folds
Yaaaazz: folds
Labuns: folds
Rabarber77: calls $13.70
RAidakCo: folds
*** FLOP *** [Ad 2h 5h]
Rabarber77: checks
IdrinkBEERI: bets $12.08
Rabarber77: folds
Uncalled bet ($12.08) returned to IdrinkBEERI
IdrinkBEERI collected $35.53 from pot
IdrinkBEERI: doesn't show hand
*** SUMMARY ***
Total pot $37.40 | Rake $1.87
Board [Ad 2h 5h]
Seat 1: Rabarber77 (small blind) folded on the Flop
Seat 2: RAidakCo (big blind) folded before Flop
Seat 3: IdrinkBEERI collected ($35.53)
Seat 4: supbigdiaper folded before Flop (didn't bet)
Seat 5: Yaaaazz folded before Flop (didn't bet)
Seat 6: Labuns (button) folded before Flop (didn't bet)


PokerStars Hand #222986859508:  Hold'em No Limit ($2.50/$5.00 USD) - 2021/01/24 0:48:09 ET
Table 'Aaltje II' 6-max Seat #1 is the button
Seat 1: Rabarber77 ($5049.74 in chips)
Seat 2: RAidakCo ($586.54 in chips)
Seat 3: IdrinkBEERI ($531.83 in chips)
Seat 4: supbigdiaper ($895.25 in chips)
Seat 5: Yaaaazz ($533.75 in chips)
Seat 6: Labuns ($659.07 in chips)
RAidakCo: posts small blind $2.50
IdrinkBEERI: posts big blind $5
*** HOLE CARDS ***
supbigdiaper: folds
Yaaaazz: folds
Labuns: folds
Rabarber77: folds
RAidakCo: folds
Uncalled bet ($2.50) returned to IdrinkBEERI
IdrinkBEERI collected $5 from pot
IdrinkBEERI: doesn't show hand
*** SUMMARY ***
Total pot $5 | Rake $0
Seat 1: Rabarber77 (button) folded before Flop (didn't bet)
Seat 2: RAidakCo (small blind) folded before Flop
Seat 3: IdrinkBEERI (big blind) collected ($5)
Seat 4: supbigdiaper folded before Flop (didn't bet)
Seat 5: Yaaaazz folded before Flop (didn't bet)
Seat 6: Labuns folded before Flop (didn't bet)


PokerStars Hand #222986861603:  Hold'em No Limit ($2.50/$5.00 USD) - 2021/01/24 0:48:19 ET
Table 'Aaltje II' 6-max Seat #2 is the button
Seat 1: Rabarber77 ($5049.74 in chips)
Seat 2: RAidakCo ($584.04 in chips)
Seat 3: IdrinkBEERI ($534.33 in chips)
Seat 4: supbigdiaper ($895.25 in chips)
Seat 5: Yaaaazz ($533.75 in chips)
Seat 6: Labuns ($659.07 in chips)
IdrinkBEERI: posts small blind $2.50
supbigdiaper: posts big blind $5
*** HOLE CARDS ***
Yaaaazz: raises $6.25 to $11.25
Labuns: folds
Rabarber77: raises $26.25 to $37.50
RAidakCo: folds
IdrinkBEERI: folds
supbigdiaper: folds
Yaaaazz: folds
Uncalled bet ($26.25) returned to Rabarber77
Rabarber77 collected $30 from pot
Rabarber77: doesn't show hand
*** SUMMARY ***
Total pot $30 | Rake $0
Seat 1: Rabarber77 collected ($30)
Seat 2: RAidakCo (button) folded before Flop (didn't bet)
Seat 3: IdrinkBEERI (small blind) folded before Flop
Seat 4: supbigdiaper (big blind) folded before Flop
Seat 5: Yaaaazz folded before Flop
Seat 6: Labuns folded before Flop (didn't bet)


PokerStars Hand #222986866156:  Hold'em No Limit ($2.50/$5.00 USD) - 2021/01/24 0:48:38 ET
Table 'Aaltje II' 6-max Seat #3 is the button
Seat 1: Rabarber77 ($5068.49 in chips)
Seat 2: RAidakCo ($584.04 in chips)
Seat 3: IdrinkBEERI ($531.83 in chips)
Seat 4: supbigdiaper ($890.25 in chips)
Seat 5: Yaaaazz ($522.50 in chips)
Seat 6: Labuns ($659.07 in chips)
supbigdiaper: posts small blind $2.50
Yaaaazz: posts big blind $5
*** HOLE CARDS ***
Labuns: folds
Rabarber77: raises $10 to $15
RAidakCo: raises $35 to $50
IdrinkBEERI: folds
supbigdiaper: calls $47.50
Yaaaazz: folds
Rabarber77: calls $35
*** FLOP *** [Jd Th Qs]
supbigdiaper: checks
Rabarber77: checks
RAidakCo: bets $45.60
supbigdiaper: folds
Rabarber77: calls $45.60
*** TURN *** [Jd Th Qs] [3s]
Rabarber77: checks
RAidakCo: bets $182.40
Rabarber77: calls $182.40
*** RIVER *** [Jd Th Qs 3s] [5c]
Rabarber77: bets $4790.49 and is all-in
RAidakCo: calls $306.04 and is all-in
Uncalled bet ($4484.45) returned to Rabarber77
*** SHOW DOWN ***
Rabarber77: shows [Js Ts] (two pair, Jacks and Tens)
RAidakCo: shows [Kh Kc] (a pair of Kings)
Rabarber77 collected $1220.08 from pot
*** SUMMARY ***
Total pot $1223.08 | Rake $3
Board [Jd Th Qs 3s 5c]
Seat 1: Rabarber77 showed [Js Ts] and won ($1220.08) with two pair, Jacks and Tens
Seat 2: RAidakCo showed [Kh Kc] and lost with a pair of Kings
Seat 3: IdrinkBEERI (button) folded before Flop (didn't bet)
Seat 4: supbigdiaper (small blind) folded on the Flop
Seat 5: Yaaaazz (big blind) folded before Flop
Seat 6: Labuns folded before Flop (didn't bet)


PokerStars Hand #222986879016:  Hold'em No Limit ($2.50/$5.00 USD) - 2021/01/24 0:49:34 ET
Table 'Aaltje II' 6-max Seat #4 is the button
Seat 1: Rabarber77 ($5704.53 in chips)
Seat 2: RAidakCo ($500 in chips)
Seat 3: IdrinkBEERI ($531.83 in chips)
Seat 4: supbigdiaper ($840.25 in chips)
Seat 5: Yaaaazz ($517.50 in chips)
Seat 6: Labuns ($659.07 in chips)
Yaaaazz: posts small blind $2.50
Labuns: posts big blind $5
*** HOLE CARDS ***
Rabarber77: folds
RAidakCo: folds
IdrinkBEERI: raises $11.25 to $16.25
supbigdiaper: folds
Yaaaazz: folds
Labuns: folds
Uncalled bet ($11.25) returned to IdrinkBEERI
IdrinkBEERI collected $12.50 from pot
IdrinkBEERI: doesn't show hand
*** SUMMARY ***
Total pot $12.50 | Rake $0
Seat 1: Rabarber77 folded before Flop (didn't bet)
Seat 2: RAidakCo folded before Flop (didn't bet)
Seat 3: IdrinkBEERI collected ($12.50)
Seat 4: supbigdiaper (button) folded before Flop (didn't bet)
Seat 5: Yaaaazz (small blind) folded before Flop
Seat 6: Labuns (big blind) folded before Flop


PokerStars Hand #222986885059:  Hold'em No Limit ($2.50/$5.00 USD) - 2021/01/24 0:50:01 ET
Table 'Aaltje II' 6-max Seat #5 is the button
Seat 1: Rabarber77 ($5704.53 in chips)
Seat 2: RAidakCo ($500 in chips)
Seat 3: IdrinkBEERI ($539.33 in chips)
Seat 4: supbigdiaper ($840.25 in chips)
Seat 5: Yaaaazz ($515 in chips)
Seat 6: Labuns ($654.07 in chips)
Labuns: posts small blind $2.50
Rabarber77: posts big blind $5
*** HOLE CARDS ***
RAidakCo: folds
IdrinkBEERI: folds
supbigdiaper: raises $7.50 to $12.50
Yaaaazz: folds
Labuns: folds
Rabarber77: folds
Uncalled bet ($7.50) returned to supbigdiaper
supbigdiaper collected $12.50 from pot
supbigdiaper: doesn't show hand
*** SUMMARY ***
Total pot $12.50 | Rake $0
Seat 1: Rabarber77 (big blind) folded before Flop
Seat 2: RAidakCo folded before Flop (didn't bet)
Seat 3: IdrinkBEERI folded before Flop (didn't bet)
Seat 4: supbigdiaper collected ($12.50)
Seat 5: Yaaaazz (button) folded before Flop (didn't bet)
Seat 6: Labuns (small blind) folded before Flop


PokerStars Hand #222986888651:  Hold'em No Limit ($2.50/$5.00 USD) - 2021/01/24 0:50:16 ET
Table 'Aaltje II' 6-max Seat #6 is the button
Seat 1: Rabarber77 ($5699.53 in chips)
Seat 2: RAidakCo ($500 in chips)
Seat 3: IdrinkBEERI ($539.33 in chips)
Seat 4: supbigdiaper ($847.75 in chips)
Seat 5: Yaaaazz ($515 in chips)
Seat 6: Labuns ($651.57 in chips)
Rabarber77: posts small blind $2.50
RAidakCo: posts big blind $5
*** HOLE CARDS ***
IdrinkBEERI: folds
supbigdiaper: folds
Yaaaazz: folds
Labuns: folds
Rabarber77: folds
Uncalled bet ($2.50) returned to RAidakCo
RAidakCo collected $5 from pot
RAidakCo: doesn't show hand
*** SUMMARY ***
Total pot $5 | Rake $0
Seat 1: Rabarber77 (small blind) folded before Flop
Seat 2: RAidakCo (big blind) collected ($5)
Seat 3: IdrinkBEERI folded before Flop (didn't bet)
Seat 4: supbigdiaper folded before Flop (didn't bet)
Seat 5: Yaaaazz folded before Flop (didn't bet)
Seat 6: Labuns (button) folded before Flop (didn't bet)


PokerStars Hand #222986890810:  Hold'em No Limit ($2.50/$5.00 USD) - 2021/01/24 0:50:26 ET
Table 'Aaltje II' 6-max Seat #1 is the button
Seat 1: Rabarber77 ($5697.03 in chips)
Seat 2: RAidakCo ($502.50 in chips)
Seat 3: IdrinkBEERI ($539.33 in chips)
Seat 4: supbigdiaper ($847.75 in chips)
Seat 5: Yaaaazz ($515 in chips)
Seat 6: Labuns ($651.57 in chips)
RAidakCo: posts small blind $2.50
IdrinkBEERI: posts big blind $5
*** HOLE CARDS ***
supbigdiaper: folds
Yaaaazz: raises $6.25 to $11.25
Labuns: folds
Rabarber77: folds
RAidakCo: folds
IdrinkBEERI: folds
Uncalled bet ($6.25) returned to Yaaaazz
Yaaaazz collected $12.50 from pot
Yaaaazz: doesn't show hand
*** SUMMARY ***
Total pot $12.50 | Rake $0
Seat 1: Rabarber77 (button) folded before Flop (didn't bet)
Seat 2: RAidakCo (small blind) folded before Flop
Seat 3: IdrinkBEERI (big blind) folded before Flop
Seat 4: supbigdiaper folded before Flop (didn't bet)
Seat 5: Yaaaazz collected ($12.50)
Seat 6: Labuns folded before Flop (didn't bet)


PokerStars Hand #222986892770:  Hold'em No Limit ($2.50/$5.00 USD) - 2021/01/24 0:50:35 ET
Table 'Aaltje II' 6-max Seat #2 is the button
Seat 1: Rabarber77 ($5697.03 in chips)
Seat 2: RAidakCo ($500 in chips)
Seat 3: IdrinkBEERI ($534.33 in chips)
Seat 4: supbigdiaper ($847.75 in chips)
Seat 5: Yaaaazz ($522.50 in chips)
Seat 6: Labuns ($651.57 in chips)
IdrinkBEERI: posts small blind $2.50
supbigdiaper: posts big blind $5
*** HOLE CARDS ***
Yaaaazz: raises $6.25 to $11.25
Labuns: folds
Rabarber77: folds
RAidakCo: folds
IdrinkBEERI: folds
supbigdiaper: folds
Uncalled bet ($6.25) returned to Yaaaazz
Yaaaazz collected $12.50 from pot
Yaaaazz: doesn't show hand
*** SUMMARY ***
Total pot $12.50 | Rake $0
Seat 1: Rabarber77 folded before Flop (didn't bet)
Seat 2: RAidakCo (button) folded before Flop (didn't bet)
Seat 3: IdrinkBEERI (small blind) folded before Flop
Seat 4: supbigdiaper (big blind) folded before Flop
Seat 5: Yaaaazz collected ($12.50)
Seat 6: Labuns folded before Flop (didn't bet)


PokerStars Hand #222986898767:  Hold'em No Limit ($2.50/$5.00 USD) - 2021/01/24 0:51:01 ET
Table 'Aaltje II' 6-max Seat #3 is the button
Seat 1: Rabarber77 ($5697.03 in chips)
Seat 2: RAidakCo ($500 in chips)
Seat 3: IdrinkBEERI ($531.83 in chips)
Seat 4: supbigdiaper ($842.75 in chips)
Seat 5: Yaaaazz ($530 in chips)
Seat 6: Labuns ($651.57 in chips)
supbigdiaper: posts small blind $2.50
Yaaaazz: posts big blind $5
*** HOLE CARDS ***
Labuns: folds
Rabarber77: folds
RAidakCo: folds
IdrinkBEERI: folds
supbigdiaper: folds
Uncalled bet ($2.50) returned to Yaaaazz
Yaaaazz collected $5 from pot
Yaaaazz: doesn't show hand
*** SUMMARY ***
Total pot $5 | Rake $0
Seat 1: Rabarber77 folded before Flop (didn't bet)
Seat 2: RAidakCo folded before Flop (didn't bet)
Seat 3: IdrinkBEERI (button) folded before Flop (didn't bet)
Seat 4: supbigdiaper (small blind) folded before Flop
Seat 5: Yaaaazz (big blind) collected ($5)
Seat 6: Labuns folded before Flop (didn't bet)


PokerStars Hand #222986903142:  Hold'em No Limit ($2.50/$5.00 USD) - 2021/01/24 0:51:21 ET
Table 'Aaltje II' 6-max Seat #4 is the button
Seat 1: Rabarber77 ($5697.03 in chips)
Seat 2: RAidakCo ($500 in chips)
Seat 3: IdrinkBEERI ($531.83 in chips)
Seat 4: supbigdiaper ($840.25 in chips)
Seat 5: Yaaaazz ($532.50 in chips)
Seat 6: Labuns ($651.57 in chips)
Yaaaazz: posts small blind $2.50
Labuns: posts big blind $5
*** HOLE CARDS ***
Rabarber77: raises $10 to $15
RAidakCo: folds
IdrinkBEERI: folds
supbigdiaper: folds
Yaaaazz: folds
Labuns: calls $10
*** FLOP *** [5c 3s 2s]
Labuns: checks
Rabarber77: bets $30.88
Labuns: calls $30.88
*** TURN *** [5c 3s 2s] [4d]
Labuns: checks
Rabarber77: bets $35
Labuns: folds
Uncalled bet ($35) returned to Rabarber77
Rabarber77 collected $91.26 from pot
Rabarber77: doesn't show hand
*** SUMMARY ***
Total pot $94.26 | Rake $3
Board [5c 3s 2s 4d]
Seat 1: Rabarber77 collected ($91.26)
Seat 2: RAidakCo folded before Flop (didn't bet)
Seat 3: IdrinkBEERI folded before Flop (didn't bet)
Seat 4: supbigdiaper (button) folded before Flop (didn't bet)
Seat 5: Yaaaazz (small blind) folded before Flop
Seat 6: Labuns (big blind) folded on the Turn


PokerStars Hand #222986912967:  Hold'em No Limit ($2.50/$5.00 USD) - 2021/01/24 0:52:03 ET
Table 'Aaltje II' 6-max Seat #5 is the button
Seat 1: Rabarber77 ($5742.41 in chips)
Seat 2: RAidakCo ($500 in chips)
Seat 3: IdrinkBEERI ($531.83 in chips)
Seat 4: supbigdiaper ($840.25 in chips)
Seat 5: Yaaaazz ($530 in chips)
Seat 6: Labuns ($605.69 in chips)
Labuns: posts small blind $2.50
Rabarber77: posts big blind $5
*** HOLE CARDS ***
RAidakCo: raises $6 to $11
IdrinkBEERI: folds
supbigdiaper: folds
Yaaaazz: folds
Labuns: folds
Rabarber77: folds
Uncalled bet ($6) returned to RAidakCo
RAidakCo collected $12.50 from pot
RAidakCo: doesn't show hand
*** SUMMARY ***
Total pot $12.50 | Rake $0
Seat 1: Rabarber77 (big blind) folded before Flop
Seat 2: RAidakCo collected ($12.50)
Seat 3: IdrinkBEERI folded before Flop (didn't bet)
Seat 4: supbigdiaper folded before Flop (didn't bet)
Seat 5: Yaaaazz (button) folded before Flop (didn't bet)
Seat 6: Labuns (small blind) folded before Flop


PokerStars Hand #222986917386:  Hold'em No Limit ($2.50/$5.00 USD) - 2021/01/24 0:52:23 ET
Table 'Aaltje II' 6-max Seat #6 is the button
Seat 1: Rabarber77 ($5737.41 in chips)
Seat 2: RAidakCo ($507.50 in chips)
Seat 3: IdrinkBEERI ($531.83 in chips)
Seat 4: supbigdiaper ($840.25 in chips)
Seat 5: Yaaaazz ($530 in chips)
Seat 6: Labuns ($603.19 in chips)
Rabarber77: posts small blind $2.50
RAidakCo: posts big blind $5
*** HOLE CARDS ***
IdrinkBEERI: folds
supbigdiaper: folds
Yaaaazz: folds
Labuns: folds
Rabarber77: raises $10 to $15
RAidakCo: raises $35 to $50
Rabarber77: calls $35
*** FLOP *** [Kh 4c 2c]
Rabarber77: checks
RAidakCo: bets $29.10
Rabarber77: raises $55.90 to $85
RAidakCo: raises $155 to $240
Rabarber77: folds
Uncalled bet ($155) returned to RAidakCo
RAidakCo collected $267 from pot
RAidakCo: doesn't show hand
*** SUMMARY ***
Total pot $270 | Rake $3
Board [Kh 4c 2c]
Seat 1: Rabarber77 (small blind) folded on the Flop
Seat 2: RAidakCo (big blind) collected ($267)
Seat 3: IdrinkBEERI folded before Flop (didn't bet)
Seat 4: supbigdiaper folded before Flop (didn't bet)
Seat 5: Yaaaazz folded before Flop (didn't bet)
Seat 6: Labuns (button) folded before Flop (didn't bet)


PokerStars Hand #222986930774:  Hold'em No Limit ($2.50/$5.00 USD) - 2021/01/24 0:53:21 ET
Table 'Aaltje II' 6-max Seat #1 is the button
Seat 1: Rabarber77 ($5602.41 in chips)
Seat 2: RAidakCo ($639.50 in chips)
Seat 3: IdrinkBEERI ($531.83 in chips)
Seat 4: supbigdiaper ($840.25 in chips)
Seat 5: Yaaaazz ($530 in chips)
Seat 6: Labuns ($603.19 in chips)
RAidakCo: posts small blind $2.50
IdrinkBEERI: posts big blind $5
*** HOLE CARDS ***
supbigdiaper: raises $7.50 to $12.50
Yaaaazz: folds
Labuns: raises $24.38 to $36.88
Rabarber77: folds
RAidakCo: folds
IdrinkBEERI: folds
supbigdiaper: folds
Uncalled bet ($24.38) returned to Labuns
Labuns collected $32.50 from pot
Labuns: doesn't show hand
*** SUMMARY ***
Total pot $32.50 | Rake $0
Seat 1: Rabarber77 (button) folded before Flop (didn't bet)
Seat 2: RAidakCo (small blind) folded before Flop
Seat 3: IdrinkBEERI (big blind) folded before Flop
Seat 4: supbigdiaper folded before Flop
Seat 5: Yaaaazz folded before Flop (didn't bet)
Seat 6: Labuns collected ($32.50)


PokerStars Hand #222986935329:  Hold'em No Limit ($2.50/$5.00 USD) - 2021/01/24 0:53:40 ET
Table 'Aaltje II' 6-max Seat #2 is the button
Seat 1: Rabarber77 ($5602.41 in chips)
Seat 2: RAidakCo ($637 in chips)
Seat 3: IdrinkBEERI ($526.83 in chips)
Seat 4: supbigdiaper ($827.75 in chips)
Seat 5: Yaaaazz ($530 in chips)
Seat 6: Labuns ($623.19 in chips)
IdrinkBEERI: posts small blind $2.50
supbigdiaper: posts big blind $5
*** HOLE CARDS ***
Yaaaazz: raises $6.25 to $11.25
Labuns: folds
Rabarber77: folds
RAidakCo: folds
IdrinkBEERI: calls $8.75
supbigdiaper: folds
*** FLOP *** [6s Jd 3s]
IdrinkBEERI: checks
Yaaaazz: bets $20.90
IdrinkBEERI: folds
Uncalled bet ($20.90) returned to Yaaaazz
Yaaaazz collected $26.12 from pot
Yaaaazz: doesn't show hand
*** SUMMARY ***
Total pot $27.50 | Rake $1.38
Board [6s Jd 3s]
Seat 1: Rabarber77 folded before Flop (didn't bet)
Seat 2: RAidakCo (button) folded before Flop (didn't bet)
Seat 3: IdrinkBEERI (small blind) folded on the Flop
Seat 4: supbigdiaper (big blind) folded before Flop
Seat 5: Yaaaazz collected ($26.12)
Seat 6: Labuns folded before Flop (didn't bet)


PokerStars Hand #222986943110:  Hold'em No Limit ($2.50/$5.00 USD) - 2021/01/24 0:54:14 ET
Table 'Aaltje II' 6-max Seat #3 is the button
Seat 1: Rabarber77 ($5602.41 in chips)
Seat 2: RAidakCo ($637 in chips)
Seat 3: IdrinkBEERI ($515.58 in chips)
Seat 4: supbigdiaper ($822.75 in chips)
Seat 5: Yaaaazz ($544.87 in chips)
Seat 6: Labuns ($623.19 in chips)
supbigdiaper: posts small blind $2.50
Yaaaazz: posts big blind $5
*** HOLE CARDS ***
Labuns: folds
Rabarber77: folds
RAidakCo: folds
IdrinkBEERI: raises $9.65 to $14.65
supbigdiaper: raises $51.45 to $66.10
Yaaaazz: folds
IdrinkBEERI: folds
Uncalled bet ($51.45) returned to supbigdiaper
supbigdiaper collected $34.30 from pot
supbigdiaper: doesn't show hand
*** SUMMARY ***
Total pot $34.30 | Rake $0
Seat 1: Rabarber77 folded before Flop (didn't bet)
Seat 2: RAidakCo folded before Flop (didn't bet)
Seat 3: IdrinkBEERI (button) folded before Flop
Seat 4: supbigdiaper (small blind) collected ($34.30)
Seat 5: Yaaaazz (big blind) folded before Flop
Seat 6: Labuns folded before Flop (didn't bet)


PokerStars Hand #222986951586:  Hold'em No Limit ($2.50/$5.00 USD) - 2021/01/24 0:54:51 ET
Table 'Aaltje II' 6-max Seat #4 is the button
Seat 1: Rabarber77 ($5602.41 in chips)
Seat 2: RAidakCo ($637 in chips)
Seat 3: IdrinkBEERI ($500.93 in chips)
Seat 4: supbigdiaper ($842.40 in chips)
Seat 5: Yaaaazz ($539.87 in chips)
Seat 6: Labuns ($623.19 in chips)
Yaaaazz: posts small blind $2.50
Labuns: posts big blind $5
*** HOLE CARDS ***
Rabarber77: raises $10 to $15
RAidakCo: folds
IdrinkBEERI: folds
supbigdiaper: raises $37.88 to $52.88
Yaaaazz: folds
Labuns: folds
Rabarber77: calls $37.88
*** FLOP *** [3d 3h Ts]
Rabarber77: checks
supbigdiaper: bets $36.39
Rabarber77: calls $36.39
*** TURN *** [3d 3h Ts] [7c]
Rabarber77: bets $91.52
supbigdiaper: raises $183.04 to $274.56
Rabarber77: folds
Uncalled bet ($183.04) returned to supbigdiaper
supbigdiaper collected $366.08 from pot
supbigdiaper: doesn't show hand
*** SUMMARY ***
Total pot $369.08 | Rake $3
Board [3d 3h Ts 7c]
Seat 1: Rabarber77 folded on the Turn
Seat 2: RAidakCo folded before Flop (didn't bet)
Seat 3: IdrinkBEERI folded before Flop (didn't bet)
Seat 4: supbigdiaper (button) collected ($366.08)
Seat 5: Yaaaazz (small blind) folded before Flop
Seat 6: Labuns (big blind) folded before Flop


PokerStars Hand #222986962000:  Hold'em No Limit ($2.50/$5.00 USD) - 2021/01/24 0:55:42 ET
Table 'Aaltje II' 6-max Seat #5 is the button
Seat 1: Rabarber77 ($5421.62 in chips)
Seat 2: RAidakCo ($637 in chips)
Seat 3: IdrinkBEERI ($500.93 in chips)
Seat 4: supbigdiaper ($1027.69 in chips)
Seat 5: Yaaaazz ($537.37 in chips)
Seat 6: Labuns ($618.19 in chips)
Labuns: posts small blind $2.50
Rabarber77: posts big blind $5
*** HOLE CARDS ***
RAidakCo: folds
IdrinkBEERI: folds
supbigdiaper: folds
Yaaaazz: raises $7.50 to $12.50
Labuns: folds
Rabarber77: calls $7.50
*** FLOP *** [Jc 4c 3h]
Rabarber77: checks
Yaaaazz: checks
*** TURN *** [Jc 4c 3h] [2d]
Rabarber77: bets $26.12
Yaaaazz: calls $26.12
*** RIVER *** [Jc 4c 3h 2d] [Qs]
Rabarber77: bets $60
Yaaaazz: folds
Uncalled bet ($60) returned to Rabarber77
Rabarber77 collected $76.74 from pot
Rabarber77: doesn't show hand
*** SUMMARY ***
Total pot $79.74 | Rake $3
Board [Jc 4c 3h 2d Qs]
Seat 1: Rabarber77 (big blind) collected ($76.74)
Seat 2: RAidakCo folded before Flop (didn't bet)
Seat 3: IdrinkBEERI folded before Flop (didn't bet)
Seat 4: supbigdiaper folded before Flop (didn't bet)
Seat 5: Yaaaazz (button) folded on the River
Seat 6: Labuns (small blind) folded before Flop


PokerStars Hand #222986969686:  Hold'em No Limit ($2.50/$5.00 USD) - 2021/01/24 0:56:23 ET
Table 'Aaltje II' 6-max Seat #6 is the button
Seat 1: Rabarber77 ($5459.74 in chips)
Seat 2: RAidakCo ($637 in chips)
Seat 3: IdrinkBEERI ($500.93 in chips)
Seat 4: supbigdiaper ($1027.69 in chips)
Seat 5: Yaaaazz ($500 in chips)
Seat 6: Labuns ($615.69 in chips)
Rabarber77: posts small blind $2.50
RAidakCo: posts big blind $5
*** HOLE CARDS ***
IdrinkBEERI: raises $11.20 to $16.20
supbigdiaper: raises $40.30 to $56.50
Yaaaazz: folds
Labuns: folds
Rabarber77: folds
RAidakCo: folds
IdrinkBEERI: raises $68.50 to $125
supbigdiaper: folds
Uncalled bet ($68.50) returned to IdrinkBEERI
IdrinkBEERI collected $120.50 from pot
IdrinkBEERI: doesn't show hand
*** SUMMARY ***
Total pot $120.50 | Rake $0
Seat 1: Rabarber77 (small blind) folded before Flop
Seat 2: RAidakCo (big blind) folded before Flop
Seat 3: IdrinkBEERI collected ($120.50)
Seat 4: supbigdiaper folded before Flop
Seat 5: Yaaaazz folded before Flop (didn't bet)
Seat 6: Labuns (button) folded before Flop (didn't bet)


PokerStars Hand #222986977458:  Hold'em No Limit ($2.50/$5.00 USD) - 2021/01/24 0:57:05 ET
Table 'Aaltje II' 6-max Seat #1 is the button
Seat 1: Rabarber77 ($5457.24 in chips)
Seat 2: RAidakCo ($632 in chips)
Seat 3: IdrinkBEERI ($564.93 in chips)
Seat 4: supbigdiaper ($971.19 in chips)
Seat 5: Yaaaazz ($500 in chips)
Seat 6: Labuns ($615.69 in chips)
RAidakCo: posts small blind $2.50
IdrinkBEERI: posts big blind $5
*** HOLE CARDS ***
supbigdiaper: folds
Yaaaazz: folds
Labuns: folds
Rabarber77: raises $10 to $15
RAidakCo: folds
IdrinkBEERI: folds
Uncalled bet ($10) returned to Rabarber77
Rabarber77 collected $12.50 from pot
Rabarber77: doesn't show hand
*** SUMMARY ***
Total pot $12.50 | Rake $0
Seat 1: Rabarber77 (button) collected ($12.50)
Seat 2: RAidakCo (small blind) folded before Flop
Seat 3: IdrinkBEERI (big blind) folded before Flop
Seat 4: supbigdiaper folded before Flop (didn't bet)
Seat 5: Yaaaazz folded before Flop (didn't bet)
Seat 6: Labuns folded before Flop (didn't bet)


PokerStars Hand #222986981825:  Hold'em No Limit ($2.50/$5.00 USD) - 2021/01/24 0:57:28 ET
Table 'Aaltje II' 6-max Seat #3 is the button
Seat 1: Rabarber77 ($5464.74 in chips)
Seat 2: RAidakCo ($629.50 in chips)
Seat 3: IdrinkBEERI ($557.43 in chips)
Seat 4: supbigdiaper ($973.69 in chips)
Seat 5: Yaaaazz ($500 in chips)
Seat 6: Labuns ($615.69 in chips)
supbigdiaper: posts small blind $2.50
Yaaaazz: posts big blind $5
*** HOLE CARDS ***
Labuns: folds
Rabarber77: folds
RAidakCo: folds
IdrinkBEERI: raises $9.65 to $14.65
supbigdiaper: folds
Yaaaazz: calls $9.65
*** FLOP *** [4s Kh 8h]
Yaaaazz: checks
IdrinkBEERI: bets $10.27
Yaaaazz: folds
Uncalled bet ($10.27) returned to IdrinkBEERI
IdrinkBEERI collected $30.21 from pot
IdrinkBEERI: doesn't show hand
*** SUMMARY ***
Total pot $31.80 | Rake $1.59
Board [4s Kh 8h]
Seat 1: Rabarber77 folded before Flop (didn't bet)
Seat 2: RAidakCo folded before Flop (didn't bet)
Seat 3: IdrinkBEERI (button) collected ($30.21)
Seat 4: supbigdiaper (small blind) folded before Flop
Seat 5: Yaaaazz (big blind) folded on the Flop
Seat 6: Labuns folded before Flop (didn't bet)


PokerStars Hand #222986988730:  Hold'em No Limit ($2.50/$5.00 USD) - 2021/01/24 0:58:05 ET
Table 'Aaltje II' 6-max Seat #4 is the button
Seat 1: Rabarber77 ($5464.74 in chips)
Seat 2: RAidakCo ($629.50 in chips)
Seat 3: IdrinkBEERI ($572.99 in chips)
Seat 4: supbigdiaper ($971.19 in chips)
Seat 5: Yaaaazz ($500 in chips)
Seat 6: Labuns ($615.69 in chips)
Yaaaazz: posts small blind $2.50
Labuns: posts big blind $5
*** HOLE CARDS ***
Rabarber77: folds
RAidakCo: folds
IdrinkBEERI: folds
supbigdiaper: raises $7.50 to $12.50
Yaaaazz: folds
Labuns: calls $7.50
*** FLOP *** [9c 9d 7s]
Labuns: checks
supbigdiaper: checks
*** TURN *** [9c 9d 7s] [Tc]
Labuns: checks
supbigdiaper: checks
*** RIVER *** [9c 9d 7s Tc] [5h]
Labuns: bets $19.59
supbigdiaper: calls $19.59
*** SHOW DOWN ***
Labuns: shows [Td 4d] (two pair, Tens and Nines)
supbigdiaper: mucks hand
Labuns collected $63.68 from pot
*** SUMMARY ***
Total pot $66.68 | Rake $3
Board [9c 9d 7s Tc 5h]
Seat 1: Rabarber77 folded before Flop (didn't bet)
Seat 2: RAidakCo folded before Flop (didn't bet)
Seat 3: IdrinkBEERI folded before Flop (didn't bet)
Seat 4: supbigdiaper (button) mucked
Seat 5: Yaaaazz (small blind) folded before Flop
Seat 6: Labuns (big blind) showed [Td 4d] and won ($63.68) with two pair, Tens and Nines


PokerStars Hand #222986994624:  Hold'em No Limit ($2.50/$5.00 USD) - 2021/01/24 0:58:36 ET
Table 'Aaltje II' 6-max Seat #5 is the button
Seat 1: Rabarber77 ($5464.74 in chips)
Seat 2: RAidakCo ($629.50 in chips)
Seat 3: IdrinkBEERI ($572.99 in chips)
Seat 4: supbigdiaper ($939.10 in chips)
Seat 5: Yaaaazz ($500 in chips)
Seat 6: Labuns ($647.28 in chips)
Labuns: posts small blind $2.50
Rabarber77: posts big blind $5
*** HOLE CARDS ***
RAidakCo: raises $6 to $11
IdrinkBEERI: calls $11
supbigdiaper: folds
Yaaaazz: folds
Labuns: folds
Rabarber77: calls $6
*** FLOP *** [5c Ah 2s]
Rabarber77: checks
RAidakCo: checks
IdrinkBEERI: checks
*** TURN *** [5c Ah 2s] [Kd]
Rabarber77: checks
RAidakCo: checks
IdrinkBEERI: checks
*** RIVER *** [5c Ah 2s Kd] [Ac]
Rabarber77: checks
RAidakCo: bets $25.29
IdrinkBEERI: calls $25.29
Rabarber77: folds
*** SHOW DOWN ***
RAidakCo: shows [Th 8h] (a pair of Aces)
IdrinkBEERI: shows [Td Tc] (two pair, Aces and Tens)
IdrinkBEERI collected $83.08 from pot
*** SUMMARY ***
Total pot $86.08 | Rake $3
Board [5c Ah 2s Kd Ac]
Seat 1: Rabarber77 (big blind) folded on the River
Seat 2: RAidakCo showed [Th 8h] and lost with a pair of Aces
Seat 3: IdrinkBEERI showed [Td Tc] and won ($83.08) with two pair, Aces and Tens
Seat 4: supbigdiaper folded before Flop (didn't bet)
Seat 5: Yaaaazz (button) folded before Flop (didn't bet)
Seat 6: Labuns (small blind) folded before Flop


PokerStars Hand #222987008996:  Hold'em No Limit ($2.50/$5.00 USD) - 2021/01/24 0:59:54 ET
Table 'Aaltje II' 6-max Seat #6 is the button
Seat 1: Rabarber77 ($5453.74 in chips)
Seat 2: RAidakCo ($593.21 in chips)
Seat 3: IdrinkBEERI ($619.78 in chips)
Seat 4: supbigdiaper ($939.10 in chips)
Seat 5: Yaaaazz ($500 in chips)
Seat 6: Labuns ($644.78 in chips)
Rabarber77: posts small blind $2.50
RAidakCo: posts big blind $5
*** HOLE CARDS ***
IdrinkBEERI: folds
supbigdiaper: folds
Yaaaazz: raises $6.25 to $11.25
Labuns: folds
Rabarber77: calls $8.75
RAidakCo: folds
*** FLOP *** [Qh Ah 7c]
Rabarber77: checks
Yaaaazz: bets $8.62
Rabarber77: folds
Uncalled bet ($8.62) returned to Yaaaazz
Yaaaazz collected $26.12 from pot
Yaaaazz: doesn't show hand
*** SUMMARY ***
Total pot $27.50 | Rake $1.38
Board [Qh Ah 7c]
Seat 1: Rabarber77 (small blind) folded on the Flop
Seat 2: RAidakCo (big blind) folded before Flop
Seat 3: IdrinkBEERI folded before Flop (didn't bet)
Seat 4: supbigdiaper folded before Flop (didn't bet)
Seat 5: Yaaaazz collected ($26.12)
Seat 6: Labuns (button) folded before Flop (didn't bet)


PokerStars Hand #222987014798:  Hold'em No Limit ($2.50/$5.00 USD) - 2021/01/24 1:00:23 ET
Table 'Aaltje II' 6-max Seat #1 is the button
Seat 1: Rabarber77 ($5442.49 in chips)
Seat 2: RAidakCo ($588.21 in chips)
Seat 3: IdrinkBEERI ($619.78 in chips)
Seat 4: supbigdiaper ($939.10 in chips)
Seat 5: Yaaaazz ($514.87 in chips)
Seat 6: Labuns ($644.78 in chips)
RAidakCo: posts small blind $2.50
IdrinkBEERI: posts big blind $5
*** HOLE CARDS ***
supbigdiaper: folds
Yaaaazz: folds
Labuns: folds
Rabarber77: raises $10 to $15
RAidakCo: folds
IdrinkBEERI: calls $10
*** FLOP *** [9c Ks 3h]
IdrinkBEERI: checks
Rabarber77: bets $15.44
IdrinkBEERI: raises $31.50 to $46.94
Rabarber77: raises $63.06 to $110
IdrinkBEERI: folds
Uncalled bet ($63.06) returned to Rabarber77
Rabarber77 collected $123.38 from pot
Rabarber77: doesn't show hand
*** SUMMARY ***
Total pot $126.38 | Rake $3
Board [9c Ks 3h]
Seat 1: Rabarber77 (button) collected ($123.38)
Seat 2: RAidakCo (small blind) folded before Flop
Seat 3: IdrinkBEERI (big blind) folded on the Flop
Seat 4: supbigdiaper folded before Flop (didn't bet)
Seat 5: Yaaaazz folded before Flop (didn't bet)
Seat 6: Labuns folded before Flop (didn't bet)


PokerStars Hand #222987028542:  Hold'em No Limit ($2.50/$5.00 USD) - 2021/01/24 1:01:26 ET
Table 'Aaltje II' 6-max Seat #2 is the button
Seat 1: Rabarber77 ($5503.93 in chips)
Seat 2: RAidakCo ($585.71 in chips)
Seat 3: IdrinkBEERI ($557.84 in chips)
Seat 4: supbigdiaper ($939.10 in chips)
Seat 5: Yaaaazz ($514.87 in chips)
Seat 6: Labuns ($644.78 in chips)
IdrinkBEERI: posts small blind $2.50
supbigdiaper: posts big blind $5
*** HOLE CARDS ***
Yaaaazz: folds
Labuns: folds
Rabarber77: folds
RAidakCo: raises $7.50 to $12.50
IdrinkBEERI: folds
supbigdiaper: folds
Uncalled bet ($7.50) returned to RAidakCo
RAidakCo collected $12.50 from pot
RAidakCo: doesn't show hand
*** SUMMARY ***
Total pot $12.50 | Rake $0
Seat 1: Rabarber77 folded before Flop (didn't bet)
Seat 2: RAidakCo (button) collected ($12.50)
Seat 3: IdrinkBEERI (small blind) folded before Flop
Seat 4: supbigdiaper (big blind) folded before Flop
Seat 5: Yaaaazz folded before Flop (didn't bet)
Seat 6: Labuns folded before Flop (didn't bet)


PokerStars Hand #222987041484:  Hold'em No Limit ($2.50/$5.00 USD) - 2021/01/24 1:01:43 ET
Table 'Aaltje II' 6-max Seat #3 is the button
Seat 1: Rabarber77 ($5503.93 in chips)
Seat 2: RAidakCo ($593.21 in chips)
Seat 3: IdrinkBEERI ($555.34 in chips)
Seat 4: supbigdiaper ($934.10 in chips)
Seat 5: Yaaaazz ($514.87 in chips)
Seat 6: Labuns ($644.78 in chips)
supbigdiaper: posts small blind $2.50
Yaaaazz: posts big blind $5
*** HOLE CARDS ***
Labuns: folds
Rabarber77: folds
RAidakCo: folds
IdrinkBEERI: raises $9.65 to $14.65
supbigdiaper: folds
Yaaaazz: calls $9.65
*** FLOP *** [6h Qs 2h]
Yaaaazz: bets $24.17
IdrinkBEERI: calls $24.17
*** TURN *** [6h Qs 2h] [2c]
Yaaaazz: bets $61.71
IdrinkBEERI: calls $61.71
*** RIVER *** [6h Qs 2h 2c] [Jh]
Yaaaazz: checks
IdrinkBEERI: bets $102.29
Yaaaazz: raises $312.05 to $414.34 and is all-in
IdrinkBEERI: calls $312.05
*** SHOW DOWN ***
Yaaaazz: shows [6d Qd] (two pair, Queens and Sixes)
IdrinkBEERI: shows [Jc Js] (a full house, Jacks full of Deuces)
IdrinkBEERI collected $1029.24 from pot
*** SUMMARY ***
Total pot $1032.24 | Rake $3
Board [6h Qs 2h 2c Jh]
Seat 1: Rabarber77 folded before Flop (didn't bet)
Seat 2: RAidakCo folded before Flop (didn't bet)
Seat 3: IdrinkBEERI (button) showed [Jc Js] and won ($1029.24) with a full house, Jacks full of Deuces
Seat 4: supbigdiaper (small blind) folded before Flop
Seat 5: Yaaaazz (big blind) showed [6d Qd] and lost with two pair, Queens and Sixes
Seat 6: Labuns folded before Flop (didn't bet)


PokerStars Hand #222987070043:  Hold'em No Limit ($2.50/$5.00 USD) - 2021/01/24 1:03:48 ET
Table 'Aaltje II' 6-max Seat #4 is the button
Seat 1: Rabarber77 ($5503.93 in chips)
Seat 2: RAidakCo ($593.21 in chips)
Seat 3: IdrinkBEERI ($1069.71 in chips)
Seat 4: supbigdiaper ($931.60 in chips)
Seat 5: Yaaaazz ($500 in chips)
Seat 6: Labuns ($644.78 in chips)
Yaaaazz: posts small blind $2.50
Labuns: posts big blind $5
*** HOLE CARDS ***
Rabarber77: folds
RAidakCo: folds
IdrinkBEERI: folds
supbigdiaper: folds
Yaaaazz: folds
Uncalled bet ($2.50) returned to Labuns
Labuns collected $5 from pot
Labuns: doesn't show hand
*** SUMMARY ***
Total pot $5 | Rake $0
Seat 1: Rabarber77 folded before Flop (didn't bet)
Seat 2: RAidakCo folded before Flop (didn't bet)
Seat 3: IdrinkBEERI folded before Flop (didn't bet)
Seat 4: supbigdiaper (button) folded before Flop (didn't bet)
Seat 5: Yaaaazz (small blind) folded before Flop
Seat 6: Labuns (big blind) collected ($5)


PokerStars Hand #222987074150:  Hold'em No Limit ($2.50/$5.00 USD) - 2021/01/24 1:04:06 ET
Table 'Aaltje II' 6-max Seat #5 is the button
Seat 1: Rabarber77 ($5503.93 in chips)
Seat 2: RAidakCo ($593.21 in chips)
Seat 3: IdrinkBEERI ($1069.71 in chips)
Seat 4: supbigdiaper ($931.60 in chips)
Seat 5: Yaaaazz ($500 in chips)
Seat 6: Labuns ($647.28 in chips)
Labuns: posts small blind $2.50
Rabarber77: posts big blind $5
*** HOLE CARDS ***
RAidakCo: folds
IdrinkBEERI: folds
supbigdiaper: raises $7.50 to $12.50
Yaaaazz: folds
Labuns: folds
Rabarber77: calls $7.50
*** FLOP *** [5d 4s 7d]
Rabarber77: checks
supbigdiaper: checks
*** TURN *** [5d 4s 7d] [As]
Rabarber77: checks
supbigdiaper: bets $8.62
Rabarber77: folds
Uncalled bet ($8.62) returned to supbigdiaper
supbigdiaper collected $26.12 from pot
supbigdiaper: doesn't show hand
*** SUMMARY ***
Total pot $27.50 | Rake $1.38
Board [5d 4s 7d As]
Seat 1: Rabarber77 (big blind) folded on the Turn
Seat 2: RAidakCo folded before Flop (didn't bet)
Seat 3: IdrinkBEERI folded before Flop (didn't bet)
Seat 4: supbigdiaper collected ($26.12)
Seat 5: Yaaaazz (button) folded before Flop (didn't bet)
Seat 6: Labuns (small blind) folded before Flop


PokerStars Hand #222987081199:  Hold'em No Limit ($2.50/$5.00 USD) - 2021/01/24 1:04:37 ET
Table 'Aaltje II' 6-max Seat #6 is the button
Seat 1: Rabarber77 ($5491.43 in chips)
Seat 2: RAidakCo ($593.21 in chips)
Seat 3: IdrinkBEERI ($1069.71 in chips)
Seat 4: supbigdiaper ($945.22 in chips)
Seat 5: Yaaaazz ($500 in chips)
Seat 6: Labuns ($644.78 in chips)
Rabarber77: posts small blind $2.50
RAidakCo: posts big blind $5
*** HOLE CARDS ***
IdrinkBEERI: folds
supbigdiaper: folds
Yaaaazz: folds
Labuns: folds
Rabarber77: raises $10 to $15
RAidakCo: calls $10
*** FLOP *** [Qc Js 4d]
Rabarber77: bets $14.25
RAidakCo: raises $28.50 to $42.75
Rabarber77: raises $28.50 to $71.25
RAidakCo: calls $28.50
*** TURN *** [Qc Js 4d] [9s]
Rabarber77: checks
RAidakCo: bets $127.13
Rabarber77: folds
Uncalled bet ($127.13) returned to RAidakCo
RAidakCo collected $169.50 from pot
RAidakCo: doesn't show hand
*** SUMMARY ***
Total pot $172.50 | Rake $3
Board [Qc Js 4d 9s]
Seat 1: Rabarber77 (small blind) folded on the Turn
Seat 2: RAidakCo (big blind) collected ($169.50)
Seat 3: IdrinkBEERI folded before Flop (didn't bet)
Seat 4: supbigdiaper folded before Flop (didn't bet)
Seat 5: Yaaaazz folded before Flop (didn't bet)
Seat 6: Labuns (button) folded before Flop (didn't bet)


PokerStars Hand #222987096558:  Hold'em No Limit ($2.50/$5.00 USD) - 2021/01/24 1:05:44 ET
Table 'Aaltje II' 6-max Seat #1 is the button
Seat 1: Rabarber77 ($5405.18 in chips)
Seat 2: RAidakCo ($676.46 in chips)
Seat 3: IdrinkBEERI ($1069.71 in chips)
Seat 4: supbigdiaper ($945.22 in chips)
Seat 5: Yaaaazz ($500 in chips)
Seat 6: Labuns ($644.78 in chips)
RAidakCo: posts small blind $2.50
IdrinkBEERI: posts big blind $5
*** HOLE CARDS ***
supbigdiaper: raises $7.50 to $12.50
Yaaaazz: folds
Labuns: folds
Rabarber77: folds
RAidakCo: folds
IdrinkBEERI: folds
Uncalled bet ($7.50) returned to supbigdiaper
supbigdiaper collected $12.50 from pot
supbigdiaper: doesn't show hand
*** SUMMARY ***
Total pot $12.50 | Rake $0
Seat 1: Rabarber77 (button) folded before Flop (didn't bet)
Seat 2: RAidakCo (small blind) folded before Flop
Seat 3: IdrinkBEERI (big blind) folded before Flop
Seat 4: supbigdiaper collected ($12.50)
Seat 5: Yaaaazz folded before Flop (didn't bet)
Seat 6: Labuns folded before Flop (didn't bet)


PokerStars Hand #222987101979:  Hold'em No Limit ($2.50/$5.00 USD) - 2021/01/24 1:06:07 ET
Table 'Aaltje II' 6-max Seat #2 is the button
Seat 1: Rabarber77 ($5405.18 in chips)
Seat 2: RAidakCo ($673.96 in chips)
Seat 3: IdrinkBEERI ($1064.71 in chips)
Seat 4: supbigdiaper ($952.72 in chips)
Seat 5: Yaaaazz ($500 in chips)
Seat 6: Labuns ($644.78 in chips)
IdrinkBEERI: posts small blind $2.50
supbigdiaper: posts big blind $5
*** HOLE CARDS ***
Yaaaazz: raises $6.25 to $11.25
Labuns: folds
Rabarber77: folds
RAidakCo: folds
IdrinkBEERI: folds
supbigdiaper: folds
Uncalled bet ($6.25) returned to Yaaaazz
Yaaaazz collected $12.50 from pot
Yaaaazz: doesn't show hand
*** SUMMARY ***
Total pot $12.50 | Rake $0
Seat 1: Rabarber77 folded before Flop (didn't bet)
Seat 2: RAidakCo (button) folded before Flop (didn't bet)
Seat 3: IdrinkBEERI (small blind) folded before Flop
Seat 4: supbigdiaper (big blind) folded before Flop
Seat 5: Yaaaazz collected ($12.50)
Seat 6: Labuns folded before Flop (didn't bet)


PokerStars Hand #222987104111:  Hold'em No Limit ($2.50/$5.00 USD) - 2021/01/24 1:06:17 ET
Table 'Aaltje II' 6-max Seat #3 is the button
Seat 1: Rabarber77 ($5405.18 in chips)
Seat 2: RAidakCo ($673.96 in chips)
Seat 3: IdrinkBEERI ($1062.21 in chips)
Seat 4: supbigdiaper ($947.72 in chips)
Seat 5: Yaaaazz ($507.50 in chips)
Seat 6: Labuns ($644.78 in chips)
supbigdiaper: posts small blind $2.50
Yaaaazz: posts big blind $5
*** HOLE CARDS ***
Labuns: folds
Rabarber77: raises $10 to $15
RAidakCo: folds
IdrinkBEERI: calls $15
supbigdiaper: folds
Yaaaazz: folds
*** FLOP *** [Qd 3s 7s]
Rabarber77: bets $35.62
IdrinkBEERI: folds
Uncalled bet ($35.62) returned to Rabarber77
Rabarber77 collected $35.62 from pot
Rabarber77: doesn't show hand
*** SUMMARY ***
Total pot $37.50 | Rake $1.88
Board [Qd 3s 7s]
Seat 1: Rabarber77 collected ($35.62)
Seat 2: RAidakCo folded before Flop (didn't bet)
Seat 3: IdrinkBEERI (button) folded on the Flop
Seat 4: supbigdiaper (small blind) folded before Flop
Seat 5: Yaaaazz (big blind) folded before Flop
Seat 6: Labuns folded before Flop (didn't bet)


PokerStars Hand #222987109998:  Hold'em No Limit ($2.50/$5.00 USD) - 2021/01/24 1:06:42 ET
Table 'Aaltje II' 6-max Seat #4 is the button
Seat 1: Rabarber77 ($5425.80 in chips)
Seat 2: RAidakCo ($673.96 in chips)
Seat 3: IdrinkBEERI ($1047.21 in chips)
Seat 4: supbigdiaper ($945.22 in chips)
Seat 5: Yaaaazz ($502.50 in chips)
Seat 6: Labuns ($644.78 in chips)
Yaaaazz: posts small blind $2.50
Labuns: posts big blind $5
*** HOLE CARDS ***
Rabarber77: folds
RAidakCo: folds
IdrinkBEERI: folds
supbigdiaper: raises $7.50 to $12.50
Yaaaazz: folds
Labuns: raises $47.50 to $60
supbigdiaper: folds
Uncalled bet ($47.50) returned to Labuns
Labuns collected $27.50 from pot
Labuns: doesn't show hand
*** SUMMARY ***
Total pot $27.50 | Rake $0
Seat 1: Rabarber77 folded before Flop (didn't bet)
Seat 2: RAidakCo folded before Flop (didn't bet)
Seat 3: IdrinkBEERI folded before Flop (didn't bet)
Seat 4: supbigdiaper (button) folded before Flop
Seat 5: Yaaaazz (small blind) folded before Flop
Seat 6: Labuns (big blind) collected ($27.50)


PokerStars Hand #222987123848:  Hold'em No Limit ($2.50/$5.00 USD) - 2021/01/24 1:07:43 ET
Table 'Aaltje II' 6-max Seat #6 is the button
Seat 1: Rabarber77 ($5404.68 in chips)
Seat 2: RAidakCo ($673.96 in chips)
Seat 3: IdrinkBEERI ($1047.21 in chips)
Seat 4: supbigdiaper ($932.72 in chips)
Seat 5: Yaaaazz ($521.38 in chips)
Seat 6: Labuns ($657.28 in chips)
Rabarber77: posts small blind $2.50
RAidakCo: posts big blind $5
*** HOLE CARDS ***
IdrinkBEERI: folds
supbigdiaper: folds
Yaaaazz: folds
Labuns: folds
Rabarber77: folds
Uncalled bet ($2.50) returned to RAidakCo
RAidakCo collected $5 from pot
RAidakCo: doesn't show hand
*** SUMMARY ***
Total pot $5 | Rake $0
Seat 1: Rabarber77 (small blind) folded before Flop
Seat 2: RAidakCo (big blind) collected ($5)
Seat 3: IdrinkBEERI folded before Flop (didn't bet)
Seat 4: supbigdiaper folded before Flop (didn't bet)
Seat 5: Yaaaazz folded before Flop (didn't bet)
Seat 6: Labuns (button) folded before Flop (didn't bet)


PokerStars Hand #222987114397:  Hold'em No Limit ($2.50/$5.00 USD) - 2021/01/24 1:07:01 ET
Table 'Aaltje II' 6-max Seat #5 is the button
Seat 1: Rabarber77 ($5425.80 in chips)
Seat 2: RAidakCo ($673.96 in chips)
Seat 3: IdrinkBEERI ($1047.21 in chips)
Seat 4: supbigdiaper ($932.72 in chips)
Seat 5: Yaaaazz ($500 in chips)
Seat 6: Labuns ($659.78 in chips)
Labuns: posts small blind $2.50
Rabarber77: posts big blind $5
*** HOLE CARDS ***
RAidakCo: folds
IdrinkBEERI has timed out
IdrinkBEERI: folds
supbigdiaper: folds
Yaaaazz: raises $7.50 to $12.50
Labuns: folds
Rabarber77: calls $7.50
*** FLOP *** [Th 2d 3d]
Rabarber77: checks
Yaaaazz: bets $8.62
Rabarber77: calls $8.62
*** TURN *** [Th 2d 3d] [Jh]
Rabarber77: checks
Yaaaazz: bets $63.75
Rabarber77: folds
Uncalled bet ($63.75) returned to Yaaaazz
Yaaaazz collected $42.50 from pot
Yaaaazz: doesn't show hand
*** SUMMARY ***
Total pot $44.74 | Rake $2.24
Board [Th 2d 3d Jh]
Seat 1: Rabarber77 (big blind) folded on the Turn
Seat 2: RAidakCo folded before Flop (didn't bet)
Seat 3: IdrinkBEERI folded before Flop (didn't bet)
Seat 4: supbigdiaper folded before Flop (didn't bet)
Seat 5: Yaaaazz (button) collected ($42.50)
Seat 6: Labuns (small blind) folded before Flop


PokerStars Hand #222987125585:  Hold'em No Limit ($2.50/$5.00 USD) - 2021/01/24 1:07:50 ET
Table 'Aaltje II' 6-max Seat #1 is the button
Seat 1: Rabarber77 ($5402.18 in chips)
Seat 2: RAidakCo ($676.46 in chips)
Seat 3: IdrinkBEERI ($1047.21 in chips)
Seat 4: supbigdiaper ($932.72 in chips)
Seat 5: Yaaaazz ($521.38 in chips)
Seat 6: Labuns ($657.28 in chips)
RAidakCo: posts small blind $2.50
IdrinkBEERI: posts big blind $5
*** HOLE CARDS ***
supbigdiaper: raises $7.50 to $12.50
Yaaaazz: folds
Labuns: folds
Rabarber77: folds
RAidakCo: folds
IdrinkBEERI: calls $7.50
*** FLOP *** [Qh 8h 7s]
IdrinkBEERI: checks
supbigdiaper: checks
*** TURN *** [Qh 8h 7s] [Th]
IdrinkBEERI: checks
supbigdiaper: checks
*** RIVER *** [Qh 8h 7s Th] [Qd]
IdrinkBEERI: checks
supbigdiaper: bets $19.59
IdrinkBEERI: folds
Uncalled bet ($19.59) returned to supbigdiaper
supbigdiaper collected $26.12 from pot
supbigdiaper: doesn't show hand
*** SUMMARY ***
Total pot $27.50 | Rake $1.38
Board [Qh 8h 7s Th Qd]
Seat 1: Rabarber77 (button) folded before Flop (didn't bet)
Seat 2: RAidakCo (small blind) folded before Flop
Seat 3: IdrinkBEERI (big blind) folded on the River
Seat 4: supbigdiaper collected ($26.12)
Seat 5: Yaaaazz folded before Flop (didn't bet)
Seat 6: Labuns folded before Flop (didn't bet)


PokerStars Hand #222987140239:  Hold'em No Limit ($2.50/$5.00 USD) - 2021/01/24 1:08:54 ET
Table 'Aaltje II' 6-max Seat #2 is the button
Seat 1: Rabarber77 ($5402.18 in chips)
Seat 2: RAidakCo ($673.96 in chips)
Seat 3: IdrinkBEERI ($1034.71 in chips)
Seat 4: supbigdiaper ($946.34 in chips)
Seat 5: Yaaaazz ($521.38 in chips)
Seat 6: Labuns ($657.28 in chips)
IdrinkBEERI: posts small blind $2.50
supbigdiaper: posts big blind $5
*** HOLE CARDS ***
Yaaaazz: raises $6.25 to $11.25
Labuns: folds
Rabarber77: folds
RAidakCo: folds
IdrinkBEERI: folds
supbigdiaper: calls $6.25
*** FLOP *** [Jc 5d 8c]
supbigdiaper: checks
Yaaaazz: checks
*** TURN *** [Jc 5d 8c] [Qh]
supbigdiaper: checks
Yaaaazz: checks
*** RIVER *** [Jc 5d 8c Qh] [Ts]
supbigdiaper: checks
Yaaaazz: checks
*** SHOW DOWN ***
supbigdiaper: shows [Th Td] (three of a kind, Tens)
Yaaaazz: mucks hand
supbigdiaper collected $23.75 from pot
*** SUMMARY ***
Total pot $25 | Rake $1.25
Board [Jc 5d 8c Qh Ts]
Seat 1: Rabarber77 folded before Flop (didn't bet)
Seat 2: RAidakCo (button) folded before Flop (didn't bet)
Seat 3: IdrinkBEERI (small blind) folded before Flop
Seat 4: supbigdiaper (big blind) showed [Th Td] and won ($23.75) with three of a kind, Tens
Seat 5: Yaaaazz mucked
Seat 6: Labuns folded before Flop (didn't bet)


PokerStars Hand #222987149649:  Hold'em No Limit ($2.50/$5.00 USD) - 2021/01/24 1:09:35 ET
Table 'Aaltje II' 6-max Seat #3 is the button
Seat 1: Rabarber77 ($5402.18 in chips)
Seat 2: RAidakCo ($673.96 in chips)
Seat 3: IdrinkBEERI ($1032.21 in chips)
Seat 4: supbigdiaper ($958.84 in chips)
Seat 5: Yaaaazz ($510.13 in chips)
Seat 6: Labuns ($657.28 in chips)
supbigdiaper: posts small blind $2.50
Yaaaazz: posts big blind $5
*** HOLE CARDS ***
Labuns: folds
Rabarber77: folds
RAidakCo: raises $6 to $11
IdrinkBEERI: folds
supbigdiaper: folds
Yaaaazz: folds
Uncalled bet ($6) returned to RAidakCo
RAidakCo collected $12.50 from pot
RAidakCo: doesn't show hand
*** SUMMARY ***
Total pot $12.50 | Rake $0
Seat 1: Rabarber77 folded before Flop (didn't bet)
Seat 2: RAidakCo collected ($12.50)
Seat 3: IdrinkBEERI (button) folded before Flop (didn't bet)
Seat 4: supbigdiaper (small blind) folded before Flop
Seat 5: Yaaaazz (big blind) folded before Flop
Seat 6: Labuns folded before Flop (didn't bet)


PokerStars Hand #222987154032:  Hold'em No Limit ($2.50/$5.00 USD) - 2021/01/24 1:09:55 ET
Table 'Aaltje II' 6-max Seat #4 is the button
Seat 1: Rabarber77 ($5402.18 in chips)
Seat 2: RAidakCo ($681.46 in chips)
Seat 3: IdrinkBEERI ($1032.21 in chips)
Seat 4: supbigdiaper ($956.34 in chips)
Seat 5: Yaaaazz ($505.13 in chips)
Seat 6: Labuns ($657.28 in chips)
Yaaaazz: posts small blind $2.50
Labuns: posts big blind $5
*** HOLE CARDS ***
Rabarber77: folds
RAidakCo: folds
IdrinkBEERI: raises $11.25 to $16.25
supbigdiaper: folds
Yaaaazz: folds
Labuns: folds
Uncalled bet ($11.25) returned to IdrinkBEERI
IdrinkBEERI collected $12.50 from pot
IdrinkBEERI: doesn't show hand
*** SUMMARY ***
Total pot $12.50 | Rake $0
Seat 1: Rabarber77 folded before Flop (didn't bet)
Seat 2: RAidakCo folded before Flop (didn't bet)
Seat 3: IdrinkBEERI collected ($12.50)
Seat 4: supbigdiaper (button) folded before Flop (didn't bet)
Seat 5: Yaaaazz (small blind) folded before Flop
Seat 6: Labuns (big blind) folded before Flop


PokerStars Hand #222987159423:  Hold'em No Limit ($2.50/$5.00 USD) - 2021/01/24 1:10:18 ET
Table 'Aaltje II' 6-max Seat #5 is the button
Seat 1: Rabarber77 ($5402.18 in chips)
Seat 2: RAidakCo ($681.46 in chips)
Seat 3: IdrinkBEERI ($1039.71 in chips)
Seat 4: supbigdiaper ($956.34 in chips)
Seat 5: Yaaaazz ($502.63 in chips)
Seat 6: Labuns ($652.28 in chips)
Labuns: posts small blind $2.50
Rabarber77: posts big blind $5
*** HOLE CARDS ***
RAidakCo: raises $6 to $11
IdrinkBEERI: calls $11
supbigdiaper: folds
Yaaaazz: calls $11
Labuns: folds
Rabarber77: raises $61 to $72
RAidakCo: calls $61
IdrinkBEERI: calls $61
Yaaaazz: calls $61
*** FLOP *** [4c 5h 5d]
Rabarber77: bets $160
RAidakCo: folds
IdrinkBEERI: calls $160
Yaaaazz: folds
*** TURN *** [4c 5h 5d] [6h]
Rabarber77: bets $5170.18 and is all-in
IdrinkBEERI: calls $807.71 and is all-in
Uncalled bet ($4362.47) returned to Rabarber77
*** RIVER *** [4c 5h 5d 6h] [9h]
*** SHOW DOWN ***
Rabarber77: shows [Ah Kh] (a flush, Ace high)
IdrinkBEERI: shows [4d 4h] (a full house, Fours full of Fives)
IdrinkBEERI collected $2222.92 from pot
*** SUMMARY ***
Total pot $2225.92 | Rake $3
Board [4c 5h 5d 6h 9h]
Seat 1: Rabarber77 (big blind) showed [Ah Kh] and lost with a flush, Ace high
Seat 2: RAidakCo folded on the Flop
Seat 3: IdrinkBEERI showed [4d 4h] and won ($2222.92) with a full house, Fours full of Fives
Seat 4: supbigdiaper folded before Flop (didn't bet)
Seat 5: Yaaaazz (button) folded on the Flop
Seat 6: Labuns (small blind) folded before Flop


PokerStars Hand #222987180572:  Hold'em No Limit ($2.50/$5.00 USD) - 2021/01/24 1:11:53 ET
Table 'Aaltje II' 6-max Seat #6 is the button
Seat 1: Rabarber77 ($4362.47 in chips)
Seat 2: RAidakCo ($609.46 in chips)
Seat 3: IdrinkBEERI ($2222.92 in chips)
Seat 4: supbigdiaper ($956.34 in chips)
Seat 5: Yaaaazz ($500 in chips)
Seat 6: Labuns ($649.78 in chips)
Rabarber77: posts small blind $2.50
RAidakCo: posts big blind $5
*** HOLE CARDS ***
IdrinkBEERI: folds
supbigdiaper: folds
Yaaaazz: raises $6.25 to $11.25
Labuns: folds
Rabarber77: raises $27.50 to $38.75
RAidakCo: folds
Yaaaazz: calls $27.50
*** FLOP *** [9c 8h 5s]
Rabarber77: bets $39.75
Yaaaazz: calls $39.75
*** TURN *** [9c 8h 5s] [2c]
Rabarber77: bets $79.50
Yaaaazz: folds
Uncalled bet ($79.50) returned to Rabarber77
Rabarber77 collected $159 from pot
Rabarber77: doesn't show hand
*** SUMMARY ***
Total pot $162 | Rake $3
Board [9c 8h 5s 2c]
Seat 1: Rabarber77 (small blind) collected ($159)
Seat 2: RAidakCo (big blind) folded before Flop
Seat 3: IdrinkBEERI folded before Flop (didn't bet)
Seat 4: supbigdiaper folded before Flop (didn't bet)
Seat 5: Yaaaazz folded on the Turn
Seat 6: Labuns (button) folded before Flop (didn't bet)


PokerStars Hand #222987188957:  Hold'em No Limit ($2.50/$5.00 USD) - 2021/01/24 1:12:29 ET
Table 'Aaltje II' 6-max Seat #1 is the button
Seat 1: Rabarber77 ($4442.97 in chips)
Seat 2: RAidakCo ($604.46 in chips)
Seat 3: IdrinkBEERI ($2222.92 in chips)
Seat 4: supbigdiaper ($956.34 in chips)
Seat 5: Yaaaazz ($500 in chips)
Seat 6: Labuns ($649.78 in chips)
RAidakCo: posts small blind $2.50
IdrinkBEERI: posts big blind $5
*** HOLE CARDS ***
supbigdiaper: folds
Yaaaazz: folds
Labuns: raises $7.25 to $12.25
Rabarber77: folds
RAidakCo: folds
IdrinkBEERI: folds
Uncalled bet ($7.25) returned to Labuns
Labuns collected $12.50 from pot
Labuns: doesn't show hand
*** SUMMARY ***
Total pot $12.50 | Rake $0
Seat 1: Rabarber77 (button) folded before Flop (didn't bet)
Seat 2: RAidakCo (small blind) folded before Flop
Seat 3: IdrinkBEERI (big blind) folded before Flop
Seat 4: supbigdiaper folded before Flop (didn't bet)
Seat 5: Yaaaazz folded before Flop (didn't bet)
Seat 6: Labuns collected ($12.50)


PokerStars Hand #222987192081:  Hold'em No Limit ($2.50/$5.00 USD) - 2021/01/24 1:12:43 ET
Table 'Aaltje II' 6-max Seat #2 is the button
Seat 1: Rabarber77 ($4442.97 in chips)
Seat 2: RAidakCo ($601.96 in chips)
Seat 3: IdrinkBEERI ($2217.92 in chips)
Seat 4: supbigdiaper ($956.34 in chips)
Seat 5: Yaaaazz ($500 in chips)
Seat 6: Labuns ($657.28 in chips)
IdrinkBEERI: posts small blind $2.50
supbigdiaper: posts big blind $5
*** HOLE CARDS ***
Yaaaazz: folds
Labuns: folds
Rabarber77: raises $10 to $15
RAidakCo: folds
IdrinkBEERI: folds
supbigdiaper: calls $10
*** FLOP *** [3h 6c Kh]
supbigdiaper: checks
Rabarber77: bets $15.44
supbigdiaper: calls $15.44
*** TURN *** [3h 6c Kh] [5d]
supbigdiaper: checks
Rabarber77: checks
*** RIVER *** [3h 6c Kh 5d] [Jc]
supbigdiaper: checks
Rabarber77: checks
*** SHOW DOWN ***
supbigdiaper: shows [7d 6s] (a pair of Sixes)
Rabarber77: mucks hand
supbigdiaper collected $60.38 from pot
*** SUMMARY ***
Total pot $63.38 | Rake $3
Board [3h 6c Kh 5d Jc]
Seat 1: Rabarber77 mucked
Seat 2: RAidakCo (button) folded before Flop (didn't bet)
Seat 3: IdrinkBEERI (small blind) folded before Flop
Seat 4: supbigdiaper (big blind) showed [7d 6s] and won ($60.38) with a pair of Sixes
Seat 5: Yaaaazz folded before Flop (didn't bet)
Seat 6: Labuns folded before Flop (didn't bet)


PokerStars Hand #222987208386:  Hold'em No Limit ($2.50/$5.00 USD) - 2021/01/24 1:13:21 ET
Table 'Aaltje II' 6-max Seat #3 is the button
Seat 1: Rabarber77 ($4412.53 in chips)
Seat 2: RAidakCo ($601.96 in chips)
Seat 3: IdrinkBEERI ($2215.42 in chips)
Seat 4: supbigdiaper ($986.28 in chips)
Seat 5: Yaaaazz ($500 in chips)
Seat 6: Labuns ($657.28 in chips)
supbigdiaper: posts small blind $2.50
Yaaaazz: posts big blind $5
*** HOLE CARDS ***
Labuns: folds
Rabarber77: folds
RAidakCo: folds
IdrinkBEERI: folds
supbigdiaper: raises $7.50 to $12.50
Yaaaazz: folds
Uncalled bet ($7.50) returned to supbigdiaper
supbigdiaper collected $10 from pot
supbigdiaper: doesn't show hand
*** SUMMARY ***
Total pot $10 | Rake $0
Seat 1: Rabarber77 folded before Flop (didn't bet)
Seat 2: RAidakCo folded before Flop (didn't bet)
Seat 3: IdrinkBEERI (button) folded before Flop (didn't bet)
Seat 4: supbigdiaper (small blind) collected ($10)
Seat 5: Yaaaazz (big blind) folded before Flop
Seat 6: Labuns folded before Flop (didn't bet)


PokerStars Hand #222987211832:  Hold'em No Limit ($2.50/$5.00 USD) - 2021/01/24 1:13:36 ET
Table 'Aaltje II' 6-max Seat #4 is the button
Seat 1: Rabarber77 ($4412.53 in chips)
Seat 2: RAidakCo ($601.96 in chips)
Seat 3: IdrinkBEERI ($2215.42 in chips)
Seat 4: supbigdiaper ($991.28 in chips)
Seat 5: Yaaaazz ($500 in chips)
Seat 6: Labuns ($657.28 in chips)
Yaaaazz: posts small blind $2.50
Labuns: posts big blind $5
*** HOLE CARDS ***
Rabarber77: raises $10 to $15
RAidakCo: calls $15
IdrinkBEERI: calls $15
supbigdiaper: folds
Yaaaazz: folds
Labuns: folds
*** FLOP *** [6s Jc 5d]
Rabarber77: bets $49.88
RAidakCo: calls $49.88
IdrinkBEERI: folds
*** TURN *** [6s Jc 5d] [6d]
Rabarber77: bets $74.63
RAidakCo: raises $125.37 to $200
Rabarber77: raises $4147.65 to $4347.65 and is all-in
RAidakCo: calls $337.08 and is all-in
Uncalled bet ($3810.57) returned to Rabarber77
*** RIVER *** [6s Jc 5d 6d] [Ac]
*** SHOW DOWN ***
Rabarber77: shows [Ks Kd] (two pair, Kings and Sixes)
RAidakCo: shows [Ah 6h] (a full house, Sixes full of Aces)
RAidakCo collected $1223.42 from pot
*** SUMMARY ***
Total pot $1226.42 | Rake $3
Board [6s Jc 5d 6d Ac]
Seat 1: Rabarber77 showed [Ks Kd] and lost with two pair, Kings and Sixes
Seat 2: RAidakCo showed [Ah 6h] and won ($1223.42) with a full house, Sixes full of Aces
Seat 3: IdrinkBEERI folded on the Flop
Seat 4: supbigdiaper (button) folded before Flop (didn't bet)
Seat 5: Yaaaazz (small blind) folded before Flop
Seat 6: Labuns (big blind) folded before Flop


PokerStars Hand #222987225430:  Hold'em No Limit ($2.50/$5.00 USD) - 2021/01/24 1:14:36 ET
Table 'Aaltje II' 6-max Seat #5 is the button
Seat 1: Rabarber77 ($3810.57 in chips)
Seat 2: RAidakCo ($1223.42 in chips)
Seat 3: IdrinkBEERI ($2200.42 in chips)
Seat 4: supbigdiaper ($991.28 in chips)
Seat 5: Yaaaazz ($500 in chips)
Seat 6: Labuns ($652.28 in chips)
Labuns: posts small blind $2.50
Rabarber77: posts big blind $5
*** HOLE CARDS ***
RAidakCo: raises $6 to $11
IdrinkBEERI: folds
supbigdiaper: folds
Yaaaazz: folds
Labuns: folds
Rabarber77: folds
Uncalled bet ($6) returned to RAidakCo
RAidakCo collected $12.50 from pot
RAidakCo: doesn't show hand
*** SUMMARY ***
Total pot $12.50 | Rake $0
Seat 1: Rabarber77 (big blind) folded before Flop
Seat 2: RAidakCo collected ($12.50)
Seat 3: IdrinkBEERI folded before Flop (didn't bet)
Seat 4: supbigdiaper folded before Flop (didn't bet)
Seat 5: Yaaaazz (button) folded before Flop (didn't bet)
Seat 6: Labuns (small blind) folded before Flop


PokerStars Hand #222987229947:  Hold'em No Limit ($2.50/$5.00 USD) - 2021/01/24 1:14:56 ET
Table 'Aaltje II' 6-max Seat #6 is the button
Seat 1: Rabarber77 ($3805.57 in chips)
Seat 2: RAidakCo ($1230.92 in chips)
Seat 3: IdrinkBEERI ($2200.42 in chips)
Seat 4: supbigdiaper ($991.28 in chips)
Seat 5: Yaaaazz ($500 in chips)
Seat 6: Labuns ($649.78 in chips)
Rabarber77: posts small blind $2.50
RAidakCo: posts big blind $5
*** HOLE CARDS ***
IdrinkBEERI: folds
supbigdiaper: folds
Yaaaazz: folds
Labuns: folds
Rabarber77: raises $10 to $15
RAidakCo: raises $30 to $45
Rabarber77: calls $30
*** FLOP *** [9d 5h Jc]
Rabarber77: checks
RAidakCo: checks
*** TURN *** [9d 5h Jc] [7c]
Rabarber77: bets $43.50
RAidakCo: calls $43.50
*** RIVER *** [9d 5h Jc 7c] [4d]
Rabarber77: checks
RAidakCo: bets $191.40
Rabarber77: folds
Uncalled bet ($191.40) returned to RAidakCo
RAidakCo collected $174 from pot
RAidakCo: doesn't show hand
*** SUMMARY ***
Total pot $177 | Rake $3
Board [9d 5h Jc 7c 4d]
Seat 1: Rabarber77 (small blind) folded on the River
Seat 2: RAidakCo (big blind) collected ($174)
Seat 3: IdrinkBEERI folded before Flop (didn't bet)
Seat 4: supbigdiaper folded before Flop (didn't bet)
Seat 5: Yaaaazz folded before Flop (didn't bet)
Seat 6: Labuns (button) folded before Flop (didn't bet)


PokerStars Hand #222987243180:  Hold'em No Limit ($2.50/$5.00 USD) - 2021/01/24 1:15:54 ET
Table 'Aaltje II' 6-max Seat #1 is the button
Seat 1: Rabarber77 ($3717.07 in chips)
Seat 2: RAidakCo ($1316.42 in chips)
Seat 3: IdrinkBEERI ($2200.42 in chips)
Seat 4: supbigdiaper ($991.28 in chips)
Seat 5: Yaaaazz ($500 in chips)
Seat 6: Labuns ($649.78 in chips)
RAidakCo: posts small blind $2.50
IdrinkBEERI: posts big blind $5
*** HOLE CARDS ***
supbigdiaper: raises $10 to $15
Yaaaazz: folds
Labuns: folds
Rabarber77: folds
RAidakCo: folds
IdrinkBEERI: folds
Uncalled bet ($10) returned to supbigdiaper
supbigdiaper collected $12.50 from pot
supbigdiaper: doesn't show hand
*** SUMMARY ***
Total pot $12.50 | Rake $0
Seat 1: Rabarber77 (button) folded before Flop (didn't bet)
Seat 2: RAidakCo (small blind) folded before Flop
Seat 3: IdrinkBEERI (big blind) folded before Flop
Seat 4: supbigdiaper collected ($12.50)
Seat 5: Yaaaazz folded before Flop (didn't bet)
Seat 6: Labuns folded before Flop (didn't bet)


PokerStars Hand #222987245834:  Hold'em No Limit ($2.50/$5.00 USD) - 2021/01/24 1:16:06 ET
Table 'Aaltje II' 6-max Seat #2 is the button
Seat 1: Rabarber77 ($3717.07 in chips)
Seat 2: RAidakCo ($1313.92 in chips)
Seat 3: IdrinkBEERI ($2195.42 in chips)
Seat 4: supbigdiaper ($998.78 in chips)
Seat 5: Yaaaazz ($500 in chips)
Seat 6: Labuns ($649.78 in chips)
IdrinkBEERI: posts small blind $2.50
supbigdiaper: posts big blind $5
*** HOLE CARDS ***
Yaaaazz: folds
Labuns: folds
Rabarber77: folds
RAidakCo: folds
IdrinkBEERI: raises $9.85 to $14.85
supbigdiaper: folds
Uncalled bet ($9.85) returned to IdrinkBEERI
IdrinkBEERI collected $10 from pot
IdrinkBEERI: doesn't show hand
*** SUMMARY ***
Total pot $10 | Rake $0
Seat 1: Rabarber77 folded before Flop (didn't bet)
Seat 2: RAidakCo (button) folded before Flop (didn't bet)
Seat 3: IdrinkBEERI (small blind) collected ($10)
Seat 4: supbigdiaper (big blind) folded before Flop
Seat 5: Yaaaazz folded before Flop (didn't bet)
Seat 6: Labuns folded before Flop (didn't bet)


PokerStars Hand #222987249256:  Hold'em No Limit ($2.50/$5.00 USD) - 2021/01/24 1:16:21 ET
Table 'Aaltje II' 6-max Seat #3 is the button
Seat 1: Rabarber77 ($3717.07 in chips)
Seat 2: RAidakCo ($1313.92 in chips)
Seat 3: IdrinkBEERI ($2200.42 in chips)
Seat 4: supbigdiaper ($993.78 in chips)
Seat 5: Yaaaazz ($500 in chips)
Seat 6: Labuns ($649.78 in chips)
supbigdiaper: posts small blind $2.50
Yaaaazz: posts big blind $5
*** HOLE CARDS ***
Labuns: folds
Rabarber77: raises $10 to $15
RAidakCo: folds
IdrinkBEERI: calls $15
supbigdiaper: folds
Yaaaazz: folds
*** FLOP *** [6s Ks Kc]
Rabarber77: bets $35.62
IdrinkBEERI: calls $35.62
*** TURN *** [6s Ks Kc] [9c]
Rabarber77: checks
IdrinkBEERI: checks
*** RIVER *** [6s Ks Kc 9c] [6c]
Rabarber77: checks
IdrinkBEERI: checks
*** SHOW DOWN ***
Rabarber77: shows [Qh Ah] (two pair, Kings and Sixes)
IdrinkBEERI: shows [7s As] (two pair, Kings and Sixes)
Rabarber77 collected $52.87 from pot
IdrinkBEERI collected $52.87 from pot
*** SUMMARY ***
Total pot $108.74 | Rake $3
Board [6s Ks Kc 9c 6c]
Seat 1: Rabarber77 showed [Qh Ah] and won ($52.87) with two pair, Kings and Sixes
Seat 2: RAidakCo folded before Flop (didn't bet)
Seat 3: IdrinkBEERI (button) showed [7s As] and won ($52.87) with two pair, Kings and Sixes
Seat 4: supbigdiaper (small blind) folded before Flop
Seat 5: Yaaaazz (big blind) folded before Flop
Seat 6: Labuns folded before Flop (didn't bet)


PokerStars Hand #222987265306:  Hold'em No Limit ($2.50/$5.00 USD) - 2021/01/24 1:17:32 ET
Table 'Aaltje II' 6-max Seat #4 is the button
Seat 1: Rabarber77 ($3719.32 in chips)
Seat 2: RAidakCo ($1313.92 in chips)
Seat 3: IdrinkBEERI ($2202.67 in chips)
Seat 4: supbigdiaper ($991.28 in chips)
Seat 5: Yaaaazz ($500 in chips)
Seat 6: Labuns ($649.78 in chips)
Yaaaazz: posts small blind $2.50
Labuns: posts big blind $5
*** HOLE CARDS ***
Rabarber77: folds
RAidakCo: folds
IdrinkBEERI: raises $11.25 to $16.25
supbigdiaper: folds
Yaaaazz: folds
Labuns: calls $11.25
*** FLOP *** [Th 8c 3c]
Labuns: checks
IdrinkBEERI: checks
*** TURN *** [Th 8c 3c] [Ts]
Labuns: bets $46.55
IdrinkBEERI: calls $46.55
*** RIVER *** [Th 8c 3c Ts] [4h]
Labuns: bets $175.14
IdrinkBEERI: folds
Uncalled bet ($175.14) returned to Labuns
Labuns collected $125.10 from pot
Labuns: doesn't show hand
*** SUMMARY ***
Total pot $128.10 | Rake $3
Board [Th 8c 3c Ts 4h]
Seat 1: Rabarber77 folded before Flop (didn't bet)
Seat 2: RAidakCo folded before Flop (didn't bet)
Seat 3: IdrinkBEERI folded on the River
Seat 4: supbigdiaper (button) folded before Flop (didn't bet)
Seat 5: Yaaaazz (small blind) folded before Flop
Seat 6: Labuns (big blind) collected ($125.10)


PokerStars Hand #222987279983:  Hold'em No Limit ($2.50/$5.00 USD) - 2021/01/24 1:18:36 ET
Table 'Aaltje II' 6-max Seat #5 is the button
Seat 1: Rabarber77 ($3719.32 in chips)
Seat 2: RAidakCo ($1313.92 in chips)
Seat 3: IdrinkBEERI ($2139.87 in chips)
Seat 4: supbigdiaper ($991.28 in chips)
Seat 5: Yaaaazz ($500 in chips)
Seat 6: Labuns ($712.08 in chips)
Labuns: posts small blind $2.50
Rabarber77: posts big blind $5
*** HOLE CARDS ***
RAidakCo: folds
IdrinkBEERI: folds
supbigdiaper: folds
Yaaaazz: folds
Labuns: folds
Uncalled bet ($2.50) returned to Rabarber77
Rabarber77 collected $5 from pot
Rabarber77: doesn't show hand
*** SUMMARY ***
Total pot $5 | Rake $0
Seat 1: Rabarber77 (big blind) collected ($5)
Seat 2: RAidakCo folded before Flop (didn't bet)
Seat 3: IdrinkBEERI folded before Flop (didn't bet)
Seat 4: supbigdiaper folded before Flop (didn't bet)
Seat 5: Yaaaazz (button) folded before Flop (didn't bet)
Seat 6: Labuns (small blind) folded before Flop


PokerStars Hand #222987283433:  Hold'em No Limit ($2.50/$5.00 USD) - 2021/01/24 1:18:51 ET
Table 'Aaltje II' 6-max Seat #6 is the button
Seat 1: Rabarber77 ($3721.82 in chips)
Seat 2: RAidakCo ($1313.92 in chips)
Seat 3: IdrinkBEERI ($2139.87 in chips)
Seat 4: supbigdiaper ($991.28 in chips)
Seat 5: Yaaaazz ($500 in chips)
Seat 6: Labuns ($709.58 in chips)
Rabarber77: posts small blind $2.50
RAidakCo: posts big blind $5
*** HOLE CARDS ***
IdrinkBEERI: folds
supbigdiaper: folds
Yaaaazz: folds
Labuns: folds
Rabarber77: folds
Uncalled bet ($2.50) returned to RAidakCo
RAidakCo collected $5 from pot
RAidakCo: doesn't show hand
*** SUMMARY ***
Total pot $5 | Rake $0
Seat 1: Rabarber77 (small blind) folded before Flop
Seat 2: RAidakCo (big blind) collected ($5)
Seat 3: IdrinkBEERI folded before Flop (didn't bet)
Seat 4: supbigdiaper folded before Flop (didn't bet)
Seat 5: Yaaaazz folded before Flop (didn't bet)
Seat 6: Labuns (button) folded before Flop (didn't bet)


PokerStars Hand #222987286281:  Hold'em No Limit ($2.50/$5.00 USD) - 2021/01/24 1:19:04 ET
Table 'Aaltje II' 6-max Seat #1 is the button
Seat 1: Rabarber77 ($3719.32 in chips)
Seat 2: RAidakCo ($1316.42 in chips)
Seat 3: IdrinkBEERI ($2139.87 in chips)
Seat 4: supbigdiaper ($991.28 in chips)
Seat 5: Yaaaazz ($500 in chips)
Seat 6: Labuns ($709.58 in chips)
RAidakCo: posts small blind $2.50
IdrinkBEERI: posts big blind $5
*** HOLE CARDS ***
supbigdiaper: folds
Yaaaazz: folds
Labuns: raises $7.25 to $12.25
Rabarber77: folds
RAidakCo: folds
IdrinkBEERI: folds
Uncalled bet ($7.25) returned to Labuns
Labuns collected $12.50 from pot
Labuns: doesn't show hand
*** SUMMARY ***
Total pot $12.50 | Rake $0
Seat 1: Rabarber77 (button) folded before Flop (didn't bet)
Seat 2: RAidakCo (small blind) folded before Flop
Seat 3: IdrinkBEERI (big blind) folded before Flop
Seat 4: supbigdiaper folded before Flop (didn't bet)
Seat 5: Yaaaazz folded before Flop (didn't bet)
Seat 6: Labuns collected ($12.50)


PokerStars Hand #222987289774:  Hold'em No Limit ($2.50/$5.00 USD) - 2021/01/24 1:19:19 ET
Table 'Aaltje II' 6-max Seat #2 is the button
Seat 1: Rabarber77 ($3719.32 in chips)
Seat 2: RAidakCo ($1313.92 in chips)
Seat 3: IdrinkBEERI ($2134.87 in chips)
Seat 4: supbigdiaper ($991.28 in chips)
Seat 5: Yaaaazz ($500 in chips)
Seat 6: Labuns ($717.08 in chips)
IdrinkBEERI: posts small blind $2.50
supbigdiaper: posts big blind $5
*** HOLE CARDS ***
Yaaaazz: folds
Labuns: folds
Rabarber77: raises $10 to $15
RAidakCo: folds
IdrinkBEERI: folds
supbigdiaper: calls $10
*** FLOP *** [8d 7s 6d]
supbigdiaper: checks
Rabarber77: bets $15.44
supbigdiaper: calls $15.44
*** TURN *** [8d 7s 6d] [Kd]
supbigdiaper: checks
Rabarber77: checks
*** RIVER *** [8d 7s 6d Kd] [5s]
supbigdiaper: checks
Rabarber77: checks
*** SHOW DOWN ***
supbigdiaper: shows [Ks Td] (a pair of Kings)
Rabarber77: mucks hand
supbigdiaper collected $60.38 from pot
*** SUMMARY ***
Total pot $63.38 | Rake $3
Board [8d 7s 6d Kd 5s]
Seat 1: Rabarber77 mucked
Seat 2: RAidakCo (button) folded before Flop (didn't bet)
Seat 3: IdrinkBEERI (small blind) folded before Flop
Seat 4: supbigdiaper (big blind) showed [Ks Td] and won ($60.38) with a pair of Kings
Seat 5: Yaaaazz folded before Flop (didn't bet)
Seat 6: Labuns folded before Flop (didn't bet)


PokerStars Hand #222987296904:  Hold'em No Limit ($2.50/$5.00 USD) - 2021/01/24 1:19:50 ET
Table 'Aaltje II' 6-max Seat #3 is the button
Seat 1: Rabarber77 ($3688.88 in chips)
Seat 2: RAidakCo ($1313.92 in chips)
Seat 3: IdrinkBEERI ($2132.37 in chips)
Seat 4: supbigdiaper ($1021.22 in chips)
Seat 5: Yaaaazz ($500 in chips)
Seat 6: Labuns ($717.08 in chips)
supbigdiaper: posts small blind $2.50
Yaaaazz: posts big blind $5
*** HOLE CARDS ***
Labuns: folds
Rabarber77: folds
RAidakCo: folds
IdrinkBEERI: raises $9.65 to $14.65
supbigdiaper: folds
Yaaaazz: calls $9.65
*** FLOP *** [8s 5d 6h]
Yaaaazz: checks
IdrinkBEERI: bets $10.27
Yaaaazz: folds
Uncalled bet ($10.27) returned to IdrinkBEERI
IdrinkBEERI collected $30.21 from pot
IdrinkBEERI: doesn't show hand
*** SUMMARY ***
Total pot $31.80 | Rake $1.59
Board [8s 5d 6h]
Seat 1: Rabarber77 folded before Flop (didn't bet)
Seat 2: RAidakCo folded before Flop (didn't bet)
Seat 3: IdrinkBEERI (button) collected ($30.21)
Seat 4: supbigdiaper (small blind) folded before Flop
Seat 5: Yaaaazz (big blind) folded on the Flop
Seat 6: Labuns folded before Flop (didn't bet)


PokerStars Hand #222987311044:  Hold'em No Limit ($2.50/$5.00 USD) - 2021/01/24 1:20:51 ET
Table 'Aaltje II' 6-max Seat #4 is the button
Seat 1: Rabarber77 ($3688.88 in chips)
Seat 2: RAidakCo ($1313.92 in chips)
Seat 3: IdrinkBEERI ($2147.93 in chips)
Seat 4: supbigdiaper ($1018.72 in chips)
Seat 5: Yaaaazz ($500 in chips)
Seat 6: Labuns ($717.08 in chips)
Yaaaazz: posts small blind $2.50
Labuns: posts big blind $5
*** HOLE CARDS ***
Rabarber77: folds
RAidakCo: folds
IdrinkBEERI: folds
supbigdiaper: folds
Yaaaazz: folds
Uncalled bet ($2.50) returned to Labuns
Labuns collected $5 from pot
Labuns: doesn't show hand
*** SUMMARY ***
Total pot $5 | Rake $0
Seat 1: Rabarber77 folded before Flop (didn't bet)
Seat 2: RAidakCo folded before Flop (didn't bet)
Seat 3: IdrinkBEERI folded before Flop (didn't bet)
Seat 4: supbigdiaper (button) folded before Flop (didn't bet)
Seat 5: Yaaaazz (small blind) folded before Flop
Seat 6: Labuns (big blind) collected ($5)


PokerStars Hand #222987312881:  Hold'em No Limit ($2.50/$5.00 USD) - 2021/01/24 1:21:00 ET
Table 'Aaltje II' 6-max Seat #5 is the button
Seat 1: Rabarber77 ($3688.88 in chips)
Seat 2: RAidakCo ($1313.92 in chips)
Seat 3: IdrinkBEERI ($2147.93 in chips)
Seat 4: supbigdiaper ($1018.72 in chips)
Seat 5: Yaaaazz ($500 in chips)
Seat 6: Labuns ($719.58 in chips)
Labuns: posts small blind $2.50
Rabarber77: posts big blind $5
*** HOLE CARDS ***
RAidakCo: folds
IdrinkBEERI: raises $5.50 to $10.50
supbigdiaper: calls $10.50
Yaaaazz: folds
Labuns: folds
Rabarber77: calls $5.50
*** FLOP *** [7d 5c 9d]
Rabarber77: checks
IdrinkBEERI: checks
supbigdiaper: checks
*** TURN *** [7d 5c 9d] [Ac]
Rabarber77: checks
IdrinkBEERI: bets $16.47
supbigdiaper: calls $16.47
Rabarber77: calls $16.47
*** RIVER *** [7d 5c 9d Ac] [4c]
Rabarber77: checks
IdrinkBEERI: bets $27.34
supbigdiaper: folds
Rabarber77: folds
Uncalled bet ($27.34) returned to IdrinkBEERI
IdrinkBEERI collected $80.41 from pot
IdrinkBEERI: doesn't show hand
*** SUMMARY ***
Total pot $83.41 | Rake $3
Board [7d 5c 9d Ac 4c]
Seat 1: Rabarber77 (big blind) folded on the River
Seat 2: RAidakCo folded before Flop (didn't bet)
Seat 3: IdrinkBEERI collected ($80.41)
Seat 4: supbigdiaper folded on the River
Seat 5: Yaaaazz (button) folded before Flop (didn't bet)
Seat 6: Labuns (small blind) folded before Flop


PokerStars Hand #222987331664:  Hold'em No Limit ($2.50/$5.00 USD) - 2021/01/24 1:22:22 ET
Table 'Aaltje II' 6-max Seat #6 is the button
Seat 1: Rabarber77 ($3661.91 in chips)
Seat 2: RAidakCo ($1313.92 in chips)
Seat 3: IdrinkBEERI ($2201.37 in chips)
Seat 4: supbigdiaper ($991.75 in chips)
Seat 5: Yaaaazz ($500 in chips)
Seat 6: Labuns ($717.08 in chips)
Rabarber77: posts small blind $2.50
RAidakCo: posts big blind $5
*** HOLE CARDS ***
IdrinkBEERI: folds
supbigdiaper: folds
Yaaaazz: folds
Labuns: folds
Rabarber77: raises $10 to $15
RAidakCo: raises $30 to $45
Rabarber77: calls $30
*** FLOP *** [Qc 4s 9h]
Rabarber77: checks
RAidakCo: bets $26.10
Rabarber77: calls $26.10
*** TURN *** [Qc 4s 9h] [5s]
Rabarber77: checks
RAidakCo: checks
*** RIVER *** [Qc 4s 9h 5s] [9s]
Rabarber77: bets $69.60
RAidakCo: calls $69.60
*** SHOW DOWN ***
Rabarber77: shows [4c 7c] (two pair, Nines and Fours)
RAidakCo: mucks hand
Rabarber77 collected $278.40 from pot
*** SUMMARY ***
Total pot $281.40 | Rake $3
Board [Qc 4s 9h 5s 9s]
Seat 1: Rabarber77 (small blind) showed [4c 7c] and won ($278.40) with two pair, Nines and Fours
Seat 2: RAidakCo (big blind) mucked
Seat 3: IdrinkBEERI folded before Flop (didn't bet)
Seat 4: supbigdiaper folded before Flop (didn't bet)
Seat 5: Yaaaazz folded before Flop (didn't bet)
Seat 6: Labuns (button) folded before Flop (didn't bet)


PokerStars Hand #222987339830:  Hold'em No Limit ($2.50/$5.00 USD) - 2021/01/24 1:22:58 ET
Table 'Aaltje II' 6-max Seat #1 is the button
Seat 1: Rabarber77 ($3799.61 in chips)
Seat 2: RAidakCo ($1173.22 in chips)
Seat 3: IdrinkBEERI ($2201.37 in chips)
Seat 4: supbigdiaper ($991.75 in chips)
Seat 5: Yaaaazz ($500 in chips)
Seat 6: Labuns ($717.08 in chips)
RAidakCo: posts small blind $2.50
IdrinkBEERI: posts big blind $5
*** HOLE CARDS ***
supbigdiaper: folds
Yaaaazz: folds
Labuns: folds
Rabarber77: raises $10 to $15
RAidakCo: folds
IdrinkBEERI: folds
Uncalled bet ($10) returned to Rabarber77
Rabarber77 collected $12.50 from pot
Rabarber77: doesn't show hand
*** SUMMARY ***
Total pot $12.50 | Rake $0
Seat 1: Rabarber77 (button) collected ($12.50)
Seat 2: RAidakCo (small blind) folded before Flop
Seat 3: IdrinkBEERI (big blind) folded before Flop
Seat 4: supbigdiaper folded before Flop (didn't bet)
Seat 5: Yaaaazz folded before Flop (didn't bet)
Seat 6: Labuns folded before Flop (didn't bet)


PokerStars Hand #222987343079:  Hold'em No Limit ($2.50/$5.00 USD) - 2021/01/24 1:23:13 ET
Table 'Aaltje II' 6-max Seat #2 is the button
Seat 1: Rabarber77 ($3807.11 in chips)
Seat 2: RAidakCo ($1170.72 in chips)
Seat 3: IdrinkBEERI ($2196.37 in chips)
Seat 4: supbigdiaper ($991.75 in chips)
Seat 5: Yaaaazz ($500 in chips)
Seat 6: Labuns ($717.08 in chips)
IdrinkBEERI: posts small blind $2.50
supbigdiaper: posts big blind $5
*** HOLE CARDS ***
Yaaaazz: raises $6.25 to $11.25
Labuns: folds
Rabarber77: calls $11.25
RAidakCo: folds
IdrinkBEERI: folds
supbigdiaper: folds
*** FLOP *** [2c Jd 3s]
Yaaaazz: bets $9.41
Rabarber77: raises $23.66 to $33.07
Yaaaazz: calls $23.66
*** TURN *** [2c Jd 3s] [As]
Yaaaazz: checks
Rabarber77: bets $46.57
Yaaaazz: folds
Uncalled bet ($46.57) returned to Rabarber77
Rabarber77 collected $93.14 from pot
Rabarber77: doesn't show hand
*** SUMMARY ***
Total pot $96.14 | Rake $3
Board [2c Jd 3s As]
Seat 1: Rabarber77 collected ($93.14)
Seat 2: RAidakCo (button) folded before Flop (didn't bet)
Seat 3: IdrinkBEERI (small blind) folded before Flop
Seat 4: supbigdiaper (big blind) folded before Flop
Seat 5: Yaaaazz folded on the Turn
Seat 6: Labuns folded before Flop (didn't bet)


PokerStars Hand #222987352134:  Hold'em No Limit ($2.50/$5.00 USD) - 2021/01/24 1:23:53 ET
Table 'Aaltje II' 6-max Seat #3 is the button
Seat 1: Rabarber77 ($3855.93 in chips)
Seat 2: RAidakCo ($1170.72 in chips)
Seat 3: IdrinkBEERI ($2193.87 in chips)
Seat 4: supbigdiaper ($986.75 in chips)
Seat 5: Yaaaazz ($500 in chips)
Seat 6: Labuns ($717.08 in chips)
supbigdiaper: posts small blind $2.50
Yaaaazz: posts big blind $5
*** HOLE CARDS ***
Labuns: raises $5.50 to $10.50
Rabarber77: folds
RAidakCo: folds
IdrinkBEERI: calls $10.50
supbigdiaper: folds
Yaaaazz: folds
*** FLOP *** [9c Ks 9s]
Labuns: checks
IdrinkBEERI: checks
*** TURN *** [9c Ks 9s] [As]
Labuns: checks
IdrinkBEERI: checks
*** RIVER *** [9c Ks 9s As] [9h]
Labuns: checks
IdrinkBEERI: checks
*** SHOW DOWN ***
Labuns: shows [Qd Kh] (a full house, Nines full of Kings)
IdrinkBEERI: mucks hand
Labuns collected $27.08 from pot
*** SUMMARY ***
Total pot $28.50 | Rake $1.42
Board [9c Ks 9s As 9h]
Seat 1: Rabarber77 folded before Flop (didn't bet)
Seat 2: RAidakCo folded before Flop (didn't bet)
Seat 3: IdrinkBEERI (button) mucked
Seat 4: supbigdiaper (small blind) folded before Flop
Seat 5: Yaaaazz (big blind) folded before Flop
Seat 6: Labuns showed [Qd Kh] and won ($27.08) with a full house, Nines full of Kings


PokerStars Hand #222987364329:  Hold'em No Limit ($2.50/$5.00 USD) - 2021/01/24 1:24:47 ET
Table 'Aaltje II' 6-max Seat #4 is the button
Seat 1: Rabarber77 ($3855.93 in chips)
Seat 2: RAidakCo ($1170.72 in chips)
Seat 3: IdrinkBEERI ($2183.37 in chips)
Seat 4: supbigdiaper ($984.25 in chips)
Seat 5: Yaaaazz ($500 in chips)
Seat 6: Labuns ($733.66 in chips)
Yaaaazz: posts small blind $2.50
Labuns: posts big blind $5
*** HOLE CARDS ***
Rabarber77: raises $10 to $15
RAidakCo: calls $15
IdrinkBEERI: folds
supbigdiaper: calls $15
Yaaaazz: folds
Labuns: calls $10
*** FLOP *** [Th 5c Jd]
Labuns: checks
Rabarber77: bets $29.75
RAidakCo: calls $29.75
supbigdiaper: folds
Labuns: raises $86.28 to $116.03
Rabarber77: calls $86.28
RAidakCo: folds
*** TURN *** [Th 5c Jd] [Ad]
Labuns: bets $240.98
Rabarber77: calls $240.98
*** RIVER *** [Th 5c Jd Ad] [8c]
Labuns: bets $361.65 and is all-in
Rabarber77: calls $361.65
*** SHOW DOWN ***
Labuns: shows [5d 5h] (three of a kind, Fives)
Rabarber77: shows [Ah Qs] (a pair of Aces)
Labuns collected $1526.57 from pot
*** SUMMARY ***
Total pot $1529.57 | Rake $3
Board [Th 5c Jd Ad 8c]
Seat 1: Rabarber77 showed [Ah Qs] and lost with a pair of Aces
Seat 2: RAidakCo folded on the Flop
Seat 3: IdrinkBEERI folded before Flop (didn't bet)
Seat 4: supbigdiaper (button) folded on the Flop
Seat 5: Yaaaazz (small blind) folded before Flop
Seat 6: Labuns (big blind) showed [5d 5h] and won ($1526.57) with three of a kind, Fives


PokerStars Hand #222987383246:  Hold'em No Limit ($2.50/$5.00 USD) - 2021/01/24 1:26:10 ET
Table 'Aaltje II' 6-max Seat #5 is the button
Seat 1: Rabarber77 ($3122.27 in chips)
Seat 2: RAidakCo ($1125.97 in chips)
Seat 3: IdrinkBEERI ($2183.37 in chips)
Seat 4: supbigdiaper ($969.25 in chips)
Seat 5: Yaaaazz ($500 in chips)
Seat 6: Labuns ($1526.57 in chips)
Labuns: posts small blind $2.50
Rabarber77: posts big blind $5
*** HOLE CARDS ***
RAidakCo: raises $6 to $11
IdrinkBEERI: folds
supbigdiaper: calls $11
Yaaaazz: folds
Labuns: folds
Rabarber77: calls $6
*** FLOP *** [3s As 4d]
Rabarber77: bets $33.72
RAidakCo: folds
supbigdiaper: folds
Uncalled bet ($33.72) returned to Rabarber77
Rabarber77 collected $33.72 from pot
Rabarber77: doesn't show hand
*** SUMMARY ***
Total pot $35.50 | Rake $1.78
Board [3s As 4d]
Seat 1: Rabarber77 (big blind) collected ($33.72)
Seat 2: RAidakCo folded on the Flop
Seat 3: IdrinkBEERI folded before Flop (didn't bet)
Seat 4: supbigdiaper folded on the Flop
Seat 5: Yaaaazz (button) folded before Flop (didn't bet)
Seat 6: Labuns (small blind) folded before Flop


PokerStars Hand #222987389866:  Hold'em No Limit ($2.50/$5.00 USD) - 2021/01/24 1:26:40 ET
Table 'Aaltje II' 6-max Seat #6 is the button
Seat 1: Rabarber77 ($3144.99 in chips)
Seat 2: RAidakCo ($1114.97 in chips)
Seat 3: IdrinkBEERI ($2183.37 in chips)
Seat 4: supbigdiaper ($958.25 in chips)
Seat 5: Yaaaazz ($500 in chips)
Seat 6: Labuns ($1524.07 in chips)
Rabarber77: posts small blind $2.50
RAidakCo: posts big blind $5
*** HOLE CARDS ***
IdrinkBEERI: raises $5.50 to $10.50
supbigdiaper: calls $10.50
Yaaaazz: folds
Labuns: folds
Rabarber77: folds
RAidakCo: calls $5.50
*** FLOP *** [Qs Th 7d]
RAidakCo: checks
IdrinkBEERI: checks
supbigdiaper: checks
*** TURN *** [Qs Th 7d] [8s]
RAidakCo: checks
IdrinkBEERI: checks
supbigdiaper: checks
*** RIVER *** [Qs Th 7d 8s] [9s]
RAidakCo: checks
IdrinkBEERI: checks
supbigdiaper: checks
*** SHOW DOWN ***
RAidakCo: shows [3c 3h] (a pair of Threes)
IdrinkBEERI: shows [Kh Kd] (a pair of Kings)
supbigdiaper: mucks hand
IdrinkBEERI collected $32.30 from pot
*** SUMMARY ***
Total pot $34 | Rake $1.70
Board [Qs Th 7d 8s 9s]
Seat 1: Rabarber77 (small blind) folded before Flop
Seat 2: RAidakCo (big blind) showed [3c 3h] and lost with a pair of Threes
Seat 3: IdrinkBEERI showed [Kh Kd] and won ($32.30) with a pair of Kings
Seat 4: supbigdiaper mucked
Seat 5: Yaaaazz folded before Flop (didn't bet)
Seat 6: Labuns (button) folded before Flop (didn't bet)


PokerStars Hand #222987400982:  Hold'em No Limit ($2.50/$5.00 USD) - 2021/01/24 1:27:28 ET
Table 'Aaltje II' 6-max Seat #1 is the button
Seat 1: Rabarber77 ($3142.49 in chips)
Seat 2: RAidakCo ($1104.47 in chips)
Seat 3: IdrinkBEERI ($2205.17 in chips)
Seat 4: supbigdiaper ($947.75 in chips)
Seat 5: Yaaaazz ($500 in chips)
Seat 6: Labuns ($1524.07 in chips)
RAidakCo: posts small blind $2.50
IdrinkBEERI: posts big blind $5
*** HOLE CARDS ***
supbigdiaper: folds
Yaaaazz: folds
Labuns: folds
Rabarber77: folds
RAidakCo: raises $10 to $15
IdrinkBEERI: calls $10
*** FLOP *** [6c Qh 8c]
RAidakCo: bets $8.55
IdrinkBEERI: calls $8.55
*** TURN *** [6c Qh 8c] [6h]
RAidakCo: checks
IdrinkBEERI: bets $15.21
RAidakCo: calls $15.21
*** RIVER *** [6c Qh 8c 6h] [3c]
RAidakCo: checks
IdrinkBEERI: checks
*** SHOW DOWN ***
RAidakCo: shows [9d 9s] (two pair, Nines and Sixes)
IdrinkBEERI: mucks hand
RAidakCo collected $74.52 from pot
*** SUMMARY ***
Total pot $77.52 | Rake $3
Board [6c Qh 8c 6h 3c]
Seat 1: Rabarber77 (button) folded before Flop (didn't bet)
Seat 2: RAidakCo (small blind) showed [9d 9s] and won ($74.52) with two pair, Nines and Sixes
Seat 3: IdrinkBEERI (big blind) mucked
Seat 4: supbigdiaper folded before Flop (didn't bet)
Seat 5: Yaaaazz folded before Flop (didn't bet)
Seat 6: Labuns folded before Flop (didn't bet)


PokerStars Hand #222987414948:  Hold'em No Limit ($2.50/$5.00 USD) - 2021/01/24 1:28:31 ET
Table 'Aaltje II' 6-max Seat #2 is the button
Seat 1: Rabarber77 ($3142.49 in chips)
Seat 2: RAidakCo ($1140.23 in chips)
Seat 3: IdrinkBEERI ($2166.41 in chips)
Seat 4: supbigdiaper ($947.75 in chips)
Seat 5: Yaaaazz ($500 in chips)
Seat 6: Labuns ($1524.07 in chips)
IdrinkBEERI: posts small blind $2.50
supbigdiaper: posts big blind $5
*** HOLE CARDS ***
Yaaaazz: folds
Labuns: folds
Rabarber77: folds
RAidakCo: raises $7.50 to $12.50
IdrinkBEERI: folds
supbigdiaper: folds
Uncalled bet ($7.50) returned to RAidakCo
RAidakCo collected $12.50 from pot
RAidakCo: doesn't show hand
*** SUMMARY ***
Total pot $12.50 | Rake $0
Seat 1: Rabarber77 folded before Flop (didn't bet)
Seat 2: RAidakCo (button) collected ($12.50)
Seat 3: IdrinkBEERI (small blind) folded before Flop
Seat 4: supbigdiaper (big blind) folded before Flop
Seat 5: Yaaaazz folded before Flop (didn't bet)
Seat 6: Labuns folded before Flop (didn't bet)


PokerStars Hand #222987417691:  Hold'em No Limit ($2.50/$5.00 USD) - 2021/01/24 1:28:43 ET
Table 'Aaltje II' 6-max Seat #3 is the button
Seat 1: Rabarber77 ($3142.49 in chips)
Seat 2: RAidakCo ($1147.73 in chips)
Seat 3: IdrinkBEERI ($2163.91 in chips)
Seat 4: supbigdiaper ($942.75 in chips)
Seat 5: Yaaaazz ($500 in chips)
Seat 6: Labuns ($1524.07 in chips)
supbigdiaper: posts small blind $2.50
Yaaaazz: posts big blind $5
*** HOLE CARDS ***
Labuns: folds
Rabarber77: folds
RAidakCo: folds
IdrinkBEERI: raises $9.65 to $14.65
supbigdiaper: folds
Yaaaazz: folds
Uncalled bet ($9.65) returned to IdrinkBEERI
IdrinkBEERI collected $12.50 from pot
IdrinkBEERI: doesn't show hand
*** SUMMARY ***
Total pot $12.50 | Rake $0
Seat 1: Rabarber77 folded before Flop (didn't bet)
Seat 2: RAidakCo folded before Flop (didn't bet)
Seat 3: IdrinkBEERI (button) collected ($12.50)
Seat 4: supbigdiaper (small blind) folded before Flop
Seat 5: Yaaaazz (big blind) folded before Flop
Seat 6: Labuns folded before Flop (didn't bet)


PokerStars Hand #222987422787:  Hold'em No Limit ($2.50/$5.00 USD) - 2021/01/24 1:29:06 ET
Table 'Aaltje II' 6-max Seat #4 is the button
Seat 1: Rabarber77 ($3142.49 in chips)
Seat 2: RAidakCo ($1147.73 in chips)
Seat 3: IdrinkBEERI ($2171.41 in chips)
Seat 4: supbigdiaper ($940.25 in chips)
Seat 5: Yaaaazz ($500 in chips)
Seat 6: Labuns ($1524.07 in chips)
Yaaaazz: posts small blind $2.50
Labuns: posts big blind $5
*** HOLE CARDS ***
Rabarber77: raises $10 to $15
RAidakCo: folds
IdrinkBEERI: raises $30 to $45
supbigdiaper: calls $45
Yaaaazz: folds
Labuns: folds
Rabarber77: raises $165 to $210
IdrinkBEERI: folds
supbigdiaper: folds
Uncalled bet ($165) returned to Rabarber77
Rabarber77 collected $142.50 from pot
Rabarber77: doesn't show hand
*** SUMMARY ***
Total pot $142.50 | Rake $0
Seat 1: Rabarber77 collected ($142.50)
Seat 2: RAidakCo folded before Flop (didn't bet)
Seat 3: IdrinkBEERI folded before Flop
Seat 4: supbigdiaper (button) folded before Flop
Seat 5: Yaaaazz (small blind) folded before Flop
Seat 6: Labuns (big blind) folded before Flop


PokerStars Hand #222987430793:  Hold'em No Limit ($2.50/$5.00 USD) - 2021/01/24 1:29:42 ET
Table 'Aaltje II' 6-max Seat #5 is the button
Seat 1: Rabarber77 ($3239.99 in chips)
Seat 2: RAidakCo ($1147.73 in chips)
Seat 3: IdrinkBEERI ($2126.41 in chips)
Seat 4: supbigdiaper ($895.25 in chips)
Seat 5: Yaaaazz ($500 in chips)
Seat 6: Labuns ($1519.07 in chips)
Labuns: posts small blind $2.50
Rabarber77: posts big blind $5
*** HOLE CARDS ***
RAidakCo: folds
IdrinkBEERI: raises $5.50 to $10.50
supbigdiaper: raises $28.79 to $39.29
Yaaaazz: folds
Labuns: folds
Rabarber77: calls $34.29
IdrinkBEERI: calls $28.79
*** FLOP *** [Qh 9h Jd]
Rabarber77: checks
IdrinkBEERI: checks
supbigdiaper: checks
*** TURN *** [Qh 9h Jd] [Th]
Rabarber77: checks
IdrinkBEERI: checks
supbigdiaper: bets $88.03
Rabarber77: folds
IdrinkBEERI: folds
Uncalled bet ($88.03) returned to supbigdiaper
supbigdiaper collected $117.37 from pot
supbigdiaper: doesn't show hand
*** SUMMARY ***
Total pot $120.37 | Rake $3
Board [Qh 9h Jd Th]
Seat 1: Rabarber77 (big blind) folded on the Turn
Seat 2: RAidakCo folded before Flop (didn't bet)
Seat 3: IdrinkBEERI folded on the Turn
Seat 4: supbigdiaper collected ($117.37)
Seat 5: Yaaaazz (button) folded before Flop (didn't bet)
Seat 6: Labuns (small blind) folded before Flop


PokerStars Hand #222987448936:  Hold'em No Limit ($2.50/$5.00 USD) - 2021/01/24 1:31:00 ET
Table 'Aaltje II' 6-max Seat #6 is the button
Seat 1: Rabarber77 ($3200.70 in chips)
Seat 2: RAidakCo ($1147.73 in chips)
Seat 3: IdrinkBEERI ($2087.12 in chips)
Seat 4: supbigdiaper ($973.33 in chips)
Seat 5: Yaaaazz ($500 in chips)
Seat 6: Labuns ($1516.57 in chips)
Rabarber77: posts small blind $2.50
RAidakCo: posts big blind $5
*** HOLE CARDS ***
IdrinkBEERI: folds
supbigdiaper: folds
Yaaaazz: raises $6.25 to $11.25
Labuns: folds
Rabarber77: folds
RAidakCo: folds
Uncalled bet ($6.25) returned to Yaaaazz
Yaaaazz collected $12.50 from pot
Yaaaazz: doesn't show hand
*** SUMMARY ***
Total pot $12.50 | Rake $0
Seat 1: Rabarber77 (small blind) folded before Flop
Seat 2: RAidakCo (big blind) folded before Flop
Seat 3: IdrinkBEERI folded before Flop (didn't bet)
Seat 4: supbigdiaper folded before Flop (didn't bet)
Seat 5: Yaaaazz collected ($12.50)
Seat 6: Labuns (button) folded before Flop (didn't bet)


PokerStars Hand #222987452979:  Hold'em No Limit ($2.50/$5.00 USD) - 2021/01/24 1:31:18 ET
Table 'Aaltje II' 6-max Seat #1 is the button
Seat 1: Rabarber77 ($3198.20 in chips)
Seat 2: RAidakCo ($1142.73 in chips)
Seat 3: IdrinkBEERI ($2087.12 in chips)
Seat 4: supbigdiaper ($973.33 in chips)
Seat 5: Yaaaazz ($507.50 in chips)
Seat 6: Labuns ($1516.57 in chips)
RAidakCo: posts small blind $2.50
IdrinkBEERI: posts big blind $5
*** HOLE CARDS ***
supbigdiaper: raises $7.50 to $12.50
Yaaaazz: folds
Labuns: folds
Rabarber77: folds
RAidakCo: folds
IdrinkBEERI: folds
Uncalled bet ($7.50) returned to supbigdiaper
supbigdiaper collected $12.50 from pot
supbigdiaper: doesn't show hand
*** SUMMARY ***
Total pot $12.50 | Rake $0
Seat 1: Rabarber77 (button) folded before Flop (didn't bet)
Seat 2: RAidakCo (small blind) folded before Flop
Seat 3: IdrinkBEERI (big blind) folded before Flop
Seat 4: supbigdiaper collected ($12.50)
Seat 5: Yaaaazz folded before Flop (didn't bet)
Seat 6: Labuns folded before Flop (didn't bet)


PokerStars Hand #222987456027:  Hold'em No Limit ($2.50/$5.00 USD) - 2021/01/24 1:31:32 ET
Table 'Aaltje II' 6-max Seat #2 is the button
Seat 1: Rabarber77 ($3198.20 in chips)
Seat 2: RAidakCo ($1140.23 in chips)
Seat 3: IdrinkBEERI ($2082.12 in chips)
Seat 4: supbigdiaper ($980.83 in chips)
Seat 5: Yaaaazz ($507.50 in chips)
Seat 6: Labuns ($1516.57 in chips)
IdrinkBEERI: posts small blind $2.50
supbigdiaper: posts big blind $5
*** HOLE CARDS ***
Yaaaazz: folds
Labuns: folds
Rabarber77: folds
RAidakCo: folds
IdrinkBEERI: folds
Uncalled bet ($2.50) returned to supbigdiaper
supbigdiaper collected $5 from pot
supbigdiaper: doesn't show hand
*** SUMMARY ***
Total pot $5 | Rake $0
Seat 1: Rabarber77 folded before Flop (didn't bet)
Seat 2: RAidakCo (button) folded before Flop (didn't bet)
Seat 3: IdrinkBEERI (small blind) folded before Flop
Seat 4: supbigdiaper (big blind) collected ($5)
Seat 5: Yaaaazz folded before Flop (didn't bet)
Seat 6: Labuns folded before Flop (didn't bet)


PokerStars Hand #222987461134:  Hold'em No Limit ($2.50/$5.00 USD) - 2021/01/24 1:31:54 ET
Table 'Aaltje II' 6-max Seat #3 is the button
Seat 1: Rabarber77 ($3198.20 in chips)
Seat 2: RAidakCo ($1140.23 in chips)
Seat 3: IdrinkBEERI ($2079.62 in chips)
Seat 4: supbigdiaper ($983.33 in chips)
Seat 5: Yaaaazz ($507.50 in chips)
Seat 6: Labuns ($1516.57 in chips)
supbigdiaper: posts small blind $2.50
Yaaaazz: posts big blind $5
*** HOLE CARDS ***
Labuns: folds
Rabarber77: raises $10 to $15
RAidakCo: folds
IdrinkBEERI: calls $15
supbigdiaper: folds
Yaaaazz: folds
*** FLOP *** [Qh 3h Tc]
Rabarber77: bets $17.81
IdrinkBEERI: calls $17.81
*** TURN *** [Qh 3h Tc] [5h]
Rabarber77: bets $65
IdrinkBEERI: calls $65
*** RIVER *** [Qh 3h Tc 5h] [5c]
Rabarber77: checks
IdrinkBEERI: bets $134.08
Rabarber77: folds
Uncalled bet ($134.08) returned to IdrinkBEERI
IdrinkBEERI collected $200.12 from pot
IdrinkBEERI: doesn't show hand
*** SUMMARY ***
Total pot $203.12 | Rake $3
Board [Qh 3h Tc 5h 5c]
Seat 1: Rabarber77 folded on the River
Seat 2: RAidakCo folded before Flop (didn't bet)
Seat 3: IdrinkBEERI (button) collected ($200.12)
Seat 4: supbigdiaper (small blind) folded before Flop
Seat 5: Yaaaazz (big blind) folded before Flop
Seat 6: Labuns folded before Flop (didn't bet)


PokerStars Hand #222987481836:  Hold'em No Limit ($2.50/$5.00 USD) - 2021/01/24 1:33:13 ET
Table 'Aaltje II' 6-max Seat #4 is the button
Seat 1: Rabarber77 ($3100.39 in chips)
Seat 2: RAidakCo ($1140.23 in chips)
Seat 3: IdrinkBEERI ($2181.93 in chips)
Seat 4: supbigdiaper ($980.83 in chips)
Seat 5: Yaaaazz ($502.50 in chips)
Seat 6: Labuns ($1516.57 in chips)
Yaaaazz: posts small blind $2.50
Labuns: posts big blind $5
*** HOLE CARDS ***
Rabarber77: folds
RAidakCo: folds
IdrinkBEERI: folds
supbigdiaper: raises $7.50 to $12.50
Yaaaazz: folds
Labuns: folds
Uncalled bet ($7.50) returned to supbigdiaper
supbigdiaper collected $12.50 from pot
supbigdiaper: doesn't show hand
*** SUMMARY ***
Total pot $12.50 | Rake $0
Seat 1: Rabarber77 folded before Flop (didn't bet)
Seat 2: RAidakCo folded before Flop (didn't bet)
Seat 3: IdrinkBEERI folded before Flop (didn't bet)
Seat 4: supbigdiaper (button) collected ($12.50)
Seat 5: Yaaaazz (small blind) folded before Flop
Seat 6: Labuns (big blind) folded before Flop


PokerStars Hand #222987485114:  Hold'em No Limit ($2.50/$5.00 USD) - 2021/01/24 1:33:28 ET
Table 'Aaltje II' 6-max Seat #5 is the button
Seat 1: Rabarber77 ($3100.39 in chips)
Seat 2: RAidakCo ($1140.23 in chips)
Seat 3: IdrinkBEERI ($2181.93 in chips)
Seat 4: supbigdiaper ($988.33 in chips)
Seat 5: Yaaaazz ($500 in chips)
Seat 6: Labuns ($1511.57 in chips)
Labuns: posts small blind $2.50
Rabarber77: posts big blind $5
*** HOLE CARDS ***
RAidakCo: folds
IdrinkBEERI: folds
supbigdiaper: raises $7.50 to $12.50
Yaaaazz: folds
Labuns: folds
Rabarber77: calls $7.50
*** FLOP *** [Ac 7d Kc]
Rabarber77: checks
supbigdiaper: checks
*** TURN *** [Ac 7d Kc] [3h]
Rabarber77: checks
supbigdiaper: bets $19.59
Rabarber77: calls $19.59
*** RIVER *** [Ac 7d Kc 3h] [Kd]
Rabarber77: bets $63.68
supbigdiaper: folds
Uncalled bet ($63.68) returned to Rabarber77
Rabarber77 collected $63.68 from pot
Rabarber77: doesn't show hand
*** SUMMARY ***
Total pot $66.68 | Rake $3
Board [Ac 7d Kc 3h Kd]
Seat 1: Rabarber77 (big blind) collected ($63.68)
Seat 2: RAidakCo folded before Flop (didn't bet)
Seat 3: IdrinkBEERI folded before Flop (didn't bet)
Seat 4: supbigdiaper folded on the River
Seat 5: Yaaaazz (button) folded before Flop (didn't bet)
Seat 6: Labuns (small blind) folded before Flop


PokerStars Hand #222987491629:  Hold'em No Limit ($2.50/$5.00 USD) - 2021/01/24 1:33:58 ET
Table 'Aaltje II' 6-max Seat #6 is the button
Seat 1: Rabarber77 ($3131.98 in chips)
Seat 2: RAidakCo ($1140.23 in chips)
Seat 3: IdrinkBEERI ($2181.93 in chips)
Seat 4: supbigdiaper ($956.24 in chips)
Seat 5: Yaaaazz ($500 in chips)
Seat 6: Labuns ($1509.07 in chips)
Rabarber77: posts small blind $2.50
RAidakCo: posts big blind $5
*** HOLE CARDS ***
IdrinkBEERI: folds
supbigdiaper: raises $7.50 to $12.50
Yaaaazz: folds
Labuns: raises $24.38 to $36.88
Rabarber77: calls $34.38
RAidakCo: folds
supbigdiaper: calls $24.38
*** FLOP *** [3c 8d Qd]
Rabarber77: checks
supbigdiaper: checks
Labuns: bets $33.79
Rabarber77: calls $33.79
supbigdiaper: folds
*** TURN *** [3c 8d Qd] [Kc]
Rabarber77: checks
Labuns: checks
*** RIVER *** [3c 8d Qd Kc] [9d]
Rabarber77: checks
Labuns: checks
*** SHOW DOWN ***
Rabarber77: shows [8s As] (a pair of Eights)
Labuns: mucks hand
Rabarber77 collected $180.22 from pot
*** SUMMARY ***
Total pot $183.22 | Rake $3
Board [3c 8d Qd Kc 9d]
Seat 1: Rabarber77 (small blind) showed [8s As] and won ($180.22) with a pair of Eights
Seat 2: RAidakCo (big blind) folded before Flop
Seat 3: IdrinkBEERI folded before Flop (didn't bet)
Seat 4: supbigdiaper folded on the Flop
Seat 5: Yaaaazz folded before Flop (didn't bet)
Seat 6: Labuns (button) mucked


PokerStars Hand #222987504115:  Hold'em No Limit ($2.50/$5.00 USD) - 2021/01/24 1:34:54 ET
Table 'Aaltje II' 6-max Seat #1 is the button
Seat 1: Rabarber77 ($3241.53 in chips)
Seat 2: RAidakCo ($1135.23 in chips)
Seat 3: IdrinkBEERI ($2181.93 in chips)
Seat 4: supbigdiaper ($919.36 in chips)
Seat 5: Yaaaazz ($500 in chips)
Seat 6: Labuns ($1438.40 in chips)
RAidakCo: posts small blind $2.50
IdrinkBEERI: posts big blind $5
*** HOLE CARDS ***
supbigdiaper: folds
Yaaaazz: folds
Labuns: raises $7.25 to $12.25
Rabarber77: folds
RAidakCo: folds
IdrinkBEERI: folds
Uncalled bet ($7.25) returned to Labuns
Labuns collected $12.50 from pot
Labuns: doesn't show hand
*** SUMMARY ***
Total pot $12.50 | Rake $0
Seat 1: Rabarber77 (button) folded before Flop (didn't bet)
Seat 2: RAidakCo (small blind) folded before Flop
Seat 3: IdrinkBEERI (big blind) folded before Flop
Seat 4: supbigdiaper folded before Flop (didn't bet)
Seat 5: Yaaaazz folded before Flop (didn't bet)
Seat 6: Labuns collected ($12.50)


PokerStars Hand #222987508502:  Hold'em No Limit ($2.50/$5.00 USD) - 2021/01/24 1:35:14 ET
Table 'Aaltje II' 6-max Seat #2 is the button
Seat 1: Rabarber77 ($3241.53 in chips)
Seat 2: RAidakCo ($1132.73 in chips)
Seat 3: IdrinkBEERI ($2176.93 in chips)
Seat 4: supbigdiaper ($919.36 in chips)
Seat 5: Yaaaazz ($500 in chips)
Seat 6: Labuns ($1445.90 in chips)
IdrinkBEERI: posts small blind $2.50
supbigdiaper: posts big blind $5
*** HOLE CARDS ***
Yaaaazz: folds
Labuns: folds
Rabarber77: folds
RAidakCo: raises $7.50 to $12.50
IdrinkBEERI: folds
supbigdiaper: calls $7.50
*** FLOP *** [As 2d 8s]
supbigdiaper: checks
RAidakCo: bets $7.84
supbigdiaper: calls $7.84
*** TURN *** [As 2d 8s] [Qh]
supbigdiaper: checks
RAidakCo: bets $80
supbigdiaper: calls $80
*** RIVER *** [As 2d 8s Qh] [9c]
supbigdiaper: checks
RAidakCo: bets $400
supbigdiaper: calls $400
*** SHOW DOWN ***
RAidakCo: shows [5s Js] (high card Ace)
supbigdiaper: shows [Td Ad] (a pair of Aces)
supbigdiaper collected $1000.18 from pot
*** SUMMARY ***
Total pot $1003.18 | Rake $3
Board [As 2d 8s Qh 9c]
Seat 1: Rabarber77 folded before Flop (didn't bet)
Seat 2: RAidakCo (button) showed [5s Js] and lost with high card Ace
Seat 3: IdrinkBEERI (small blind) folded before Flop
Seat 4: supbigdiaper (big blind) showed [Td Ad] and won ($1000.18) with a pair of Aces
Seat 5: Yaaaazz folded before Flop (didn't bet)
Seat 6: Labuns folded before Flop (didn't bet)


PokerStars Hand #222987526529:  Hold'em No Limit ($2.50/$5.00 USD) - 2021/01/24 1:36:35 ET
Table 'Aaltje II' 6-max Seat #3 is the button
Seat 1: Rabarber77 ($3241.53 in chips)
Seat 2: RAidakCo ($632.39 in chips)
Seat 3: IdrinkBEERI ($2174.43 in chips)
Seat 4: supbigdiaper ($1419.20 in chips)
Seat 5: Yaaaazz ($500 in chips)
Seat 6: Labuns ($1445.90 in chips)
supbigdiaper: posts small blind $2.50
Yaaaazz: posts big blind $5
*** HOLE CARDS ***
Labuns: folds
Rabarber77: folds
RAidakCo: folds
IdrinkBEERI: folds
supbigdiaper: raises $7.50 to $12.50
Yaaaazz: folds
Uncalled bet ($7.50) returned to supbigdiaper
supbigdiaper collected $10 from pot
supbigdiaper: doesn't show hand
*** SUMMARY ***
Total pot $10 | Rake $0
Seat 1: Rabarber77 folded before Flop (didn't bet)
Seat 2: RAidakCo folded before Flop (didn't bet)
Seat 3: IdrinkBEERI (button) folded before Flop (didn't bet)
Seat 4: supbigdiaper (small blind) collected ($10)
Seat 5: Yaaaazz (big blind) folded before Flop
Seat 6: Labuns folded before Flop (didn't bet)


PokerStars Hand #222987532601:  Hold'em No Limit ($2.50/$5.00 USD) - 2021/01/24 1:37:03 ET
Table 'Aaltje II' 6-max Seat #4 is the button
Seat 1: Rabarber77 ($3241.53 in chips)
Seat 2: RAidakCo ($632.39 in chips)
Seat 3: IdrinkBEERI ($2174.43 in chips)
Seat 4: supbigdiaper ($1424.20 in chips)
Seat 5: Yaaaazz ($500 in chips)
Seat 6: Labuns ($1445.90 in chips)
Yaaaazz: posts small blind $2.50
Labuns: posts big blind $5
*** HOLE CARDS ***
Rabarber77: folds
RAidakCo: folds
IdrinkBEERI: raises $11.25 to $16.25
supbigdiaper: folds
Yaaaazz: folds
Labuns: folds
Uncalled bet ($11.25) returned to IdrinkBEERI
IdrinkBEERI collected $12.50 from pot
IdrinkBEERI: doesn't show hand
*** SUMMARY ***
Total pot $12.50 | Rake $0
Seat 1: Rabarber77 folded before Flop (didn't bet)
Seat 2: RAidakCo folded before Flop (didn't bet)
Seat 3: IdrinkBEERI collected ($12.50)
Seat 4: supbigdiaper (button) folded before Flop (didn't bet)
Seat 5: Yaaaazz (small blind) folded before Flop
Seat 6: Labuns (big blind) folded before Flop


PokerStars Hand #222987538060:  Hold'em No Limit ($2.50/$5.00 USD) - 2021/01/24 1:37:27 ET
Table 'Aaltje II' 6-max Seat #5 is the button
Seat 1: Rabarber77 ($3241.53 in chips)
Seat 2: RAidakCo ($632.39 in chips)
Seat 3: IdrinkBEERI ($2181.93 in chips)
Seat 4: supbigdiaper ($1424.20 in chips)
Seat 5: Yaaaazz ($500 in chips)
Seat 6: Labuns ($1440.90 in chips)
Labuns: posts small blind $2.50
Rabarber77: posts big blind $5
*** HOLE CARDS ***
RAidakCo: raises $6 to $11
IdrinkBEERI: folds
supbigdiaper: folds
Yaaaazz: folds
Labuns: folds
Rabarber77: calls $6
*** FLOP *** [Kd 3d 7d]
Rabarber77: checks
RAidakCo: bets $17.46
Rabarber77: calls $17.46
*** TURN *** [Kd 3d 7d] [Qs]
Rabarber77: checks
RAidakCo: bets $100
Rabarber77: folds
Uncalled bet ($100) returned to RAidakCo
RAidakCo collected $56.45 from pot
RAidakCo: doesn't show hand
*** SUMMARY ***
Total pot $59.42 | Rake $2.97
Board [Kd 3d 7d Qs]
Seat 1: Rabarber77 (big blind) folded on the Turn
Seat 2: RAidakCo collected ($56.45)
Seat 3: IdrinkBEERI folded before Flop (didn't bet)
Seat 4: supbigdiaper folded before Flop (didn't bet)
Seat 5: Yaaaazz (button) folded before Flop (didn't bet)
Seat 6: Labuns (small blind) folded before Flop


PokerStars Hand #222987545665:  Hold'em No Limit ($2.50/$5.00 USD) - 2021/01/24 1:38:00 ET
Table 'Aaltje II' 6-max Seat #6 is the button
Seat 1: Rabarber77 ($3213.07 in chips)
Seat 2: RAidakCo ($660.38 in chips)
Seat 3: IdrinkBEERI ($2181.93 in chips)
Seat 4: supbigdiaper ($1424.20 in chips)
Seat 5: Yaaaazz ($500 in chips)
Seat 6: Labuns ($1438.40 in chips)
Rabarber77: posts small blind $2.50
RAidakCo: posts big blind $5
*** HOLE CARDS ***
IdrinkBEERI: folds
supbigdiaper: raises $7.50 to $12.50
Yaaaazz: folds
Labuns: folds
Rabarber77: calls $10
RAidakCo: folds
*** FLOP *** [6d 4s 6c]
Rabarber77: checks
supbigdiaper: bets $9.41
Rabarber77: calls $9.41
*** TURN *** [6d 4s 6c] [2d]
Rabarber77: checks
supbigdiaper: bets $34.79
Rabarber77: folds
Uncalled bet ($34.79) returned to supbigdiaper
supbigdiaper collected $46.38 from pot
supbigdiaper: doesn't show hand
*** SUMMARY ***
Total pot $48.82 | Rake $2.44
Board [6d 4s 6c 2d]
Seat 1: Rabarber77 (small blind) folded on the Turn
Seat 2: RAidakCo (big blind) folded before Flop
Seat 3: IdrinkBEERI folded before Flop (didn't bet)
Seat 4: supbigdiaper collected ($46.38)
Seat 5: Yaaaazz folded before Flop (didn't bet)
Seat 6: Labuns (button) folded before Flop (didn't bet)


PokerStars Hand #222987553889:  Hold'em No Limit ($2.50/$5.00 USD) - 2021/01/24 1:38:37 ET
Table 'Aaltje II' 6-max Seat #1 is the button
Seat 1: Rabarber77 ($3191.16 in chips)
Seat 2: RAidakCo ($655.38 in chips)
Seat 3: IdrinkBEERI ($2181.93 in chips)
Seat 4: supbigdiaper ($1448.67 in chips)
Seat 5: Yaaaazz ($500 in chips)
Seat 6: Labuns ($1438.40 in chips)
RAidakCo: posts small blind $2.50
IdrinkBEERI: posts big blind $5
*** HOLE CARDS ***
supbigdiaper: raises $7.50 to $12.50
Yaaaazz: folds
Labuns: raises $24.38 to $36.88
Rabarber77: raises $59.38 to $96.26
RAidakCo: folds
IdrinkBEERI: folds
supbigdiaper: raises $239.27 to $335.53
Labuns: folds
Rabarber77: calls $239.27
*** FLOP *** [Td Jh 4d]
supbigdiaper: checks
Rabarber77: bets $380
supbigdiaper: calls $380
*** TURN *** [Td Jh 4d] [8d]
supbigdiaper: checks
Rabarber77: bets $2475.63 and is all-in
supbigdiaper: calls $733.14 and is all-in
Uncalled bet ($1742.49) returned to Rabarber77
*** RIVER *** [Td Jh 4d 8d] [2s]
*** SHOW DOWN ***
supbigdiaper: shows [Ad Ah] (a pair of Aces)
Rabarber77: shows [Kh Ks] (a pair of Kings)
supbigdiaper collected $2938.72 from pot
*** SUMMARY ***
Total pot $2941.72 | Rake $3
Board [Td Jh 4d 8d 2s]
Seat 1: Rabarber77 (button) showed [Kh Ks] and lost with a pair of Kings
Seat 2: RAidakCo (small blind) folded before Flop
Seat 3: IdrinkBEERI (big blind) folded before Flop
Seat 4: supbigdiaper showed [Ad Ah] and won ($2938.72) with a pair of Aces
Seat 5: Yaaaazz folded before Flop (didn't bet)
Seat 6: Labuns folded before Flop


PokerStars Hand #222987570094:  Hold'em No Limit ($2.50/$5.00 USD) - 2021/01/24 1:39:50 ET
Table 'Aaltje II' 6-max Seat #2 is the button
Seat 1: Rabarber77 ($1742.49 in chips)
Seat 2: RAidakCo ($652.88 in chips)
Seat 3: IdrinkBEERI ($2176.93 in chips)
Seat 4: supbigdiaper ($2938.72 in chips)
Seat 5: Yaaaazz ($500 in chips)
Seat 6: Labuns ($1401.52 in chips)
IdrinkBEERI: posts small blind $2.50
supbigdiaper: posts big blind $5
*** HOLE CARDS ***
Yaaaazz: folds
Labuns: folds
Rabarber77: raises $10 to $15
RAidakCo: folds
IdrinkBEERI: folds
supbigdiaper: folds
Uncalled bet ($10) returned to Rabarber77
Rabarber77 collected $12.50 from pot
Rabarber77: doesn't show hand
*** SUMMARY ***
Total pot $12.50 | Rake $0
Seat 1: Rabarber77 collected ($12.50)
Seat 2: RAidakCo (button) folded before Flop (didn't bet)
Seat 3: IdrinkBEERI (small blind) folded before Flop
Seat 4: supbigdiaper (big blind) folded before Flop
Seat 5: Yaaaazz folded before Flop (didn't bet)
Seat 6: Labuns folded before Flop (didn't bet)


PokerStars Hand #222987574826:  Hold'em No Limit ($2.50/$5.00 USD) - 2021/01/24 1:40:11 ET
Table 'Aaltje II' 6-max Seat #3 is the button
Seat 1: Rabarber77 ($1749.99 in chips)
Seat 2: RAidakCo ($652.88 in chips)
Seat 3: IdrinkBEERI ($2174.43 in chips)
Seat 4: supbigdiaper ($2933.72 in chips)
Seat 5: Yaaaazz ($500 in chips)
Seat 6: Labuns ($1401.52 in chips)
supbigdiaper: posts small blind $2.50
Yaaaazz: posts big blind $5
*** HOLE CARDS ***
Labuns: folds
Rabarber77: folds
RAidakCo: folds
IdrinkBEERI: raises $9.65 to $14.65
supbigdiaper: folds
Yaaaazz: calls $9.65
*** FLOP *** [3s Jc 8h]
Yaaaazz: checks
IdrinkBEERI: bets $10.27
Yaaaazz: folds
Uncalled bet ($10.27) returned to IdrinkBEERI
IdrinkBEERI collected $30.21 from pot
IdrinkBEERI: doesn't show hand
*** SUMMARY ***
Total pot $31.80 | Rake $1.59
Board [3s Jc 8h]
Seat 1: Rabarber77 folded before Flop (didn't bet)
Seat 2: RAidakCo folded before Flop (didn't bet)
Seat 3: IdrinkBEERI (button) collected ($30.21)
Seat 4: supbigdiaper (small blind) folded before Flop
Seat 5: Yaaaazz (big blind) folded on the Flop
Seat 6: Labuns folded before Flop (didn't bet)


PokerStars Hand #222987586796:  Hold'em No Limit ($2.50/$5.00 USD) - 2021/01/24 1:41:05 ET
Table 'Aaltje II' 6-max Seat #4 is the button
Seat 1: Rabarber77 ($1749.99 in chips)
Seat 2: RAidakCo ($652.88 in chips)
Seat 3: IdrinkBEERI ($2189.99 in chips)
Seat 4: supbigdiaper ($2931.22 in chips)
Seat 5: Yaaaazz ($500 in chips)
Seat 6: Labuns ($1401.52 in chips)
Yaaaazz: posts small blind $2.50
Labuns: posts big blind $5
*** HOLE CARDS ***
Rabarber77: folds
RAidakCo: folds
IdrinkBEERI: folds
supbigdiaper: folds
Yaaaazz: raises $10 to $15
Labuns: folds
Uncalled bet ($10) returned to Yaaaazz
Yaaaazz collected $10 from pot
Yaaaazz: doesn't show hand
*** SUMMARY ***
Total pot $10 | Rake $0
Seat 1: Rabarber77 folded before Flop (didn't bet)
Seat 2: RAidakCo folded before Flop (didn't bet)
Seat 3: IdrinkBEERI folded before Flop (didn't bet)
Seat 4: supbigdiaper (button) folded before Flop (didn't bet)
Seat 5: Yaaaazz (small blind) collected ($10)
Seat 6: Labuns (big blind) folded before Flop


PokerStars Hand #222987590553:  Hold'em No Limit ($2.50/$5.00 USD) - 2021/01/24 1:41:22 ET
Table 'Aaltje II' 6-max Seat #5 is the button
Seat 1: Rabarber77 ($1749.99 in chips)
Seat 2: RAidakCo ($652.88 in chips)
Seat 3: IdrinkBEERI ($2189.99 in chips)
Seat 4: supbigdiaper ($2931.22 in chips)
Seat 5: Yaaaazz ($505 in chips)
Seat 6: Labuns ($1396.52 in chips)
Labuns: posts small blind $2.50
Rabarber77: posts big blind $5
*** HOLE CARDS ***
RAidakCo: raises $6 to $11
IdrinkBEERI: folds
supbigdiaper: raises $29.80 to $40.80
Yaaaazz: folds
Labuns: folds
Rabarber77: folds
RAidakCo: calls $29.80
*** FLOP *** [Qd Tc 3h]
RAidakCo: checks
supbigdiaper: bets $28.41
RAidakCo: raises $71.46 to $99.87
supbigdiaper: folds
Uncalled bet ($71.46) returned to RAidakCo
RAidakCo collected $142.92 from pot
RAidakCo: doesn't show hand
*** SUMMARY ***
Total pot $145.92 | Rake $3
Board [Qd Tc 3h]
Seat 1: Rabarber77 (big blind) folded before Flop
Seat 2: RAidakCo collected ($142.92)
Seat 3: IdrinkBEERI folded before Flop (didn't bet)
Seat 4: supbigdiaper folded on the Flop
Seat 5: Yaaaazz (button) folded before Flop (didn't bet)
Seat 6: Labuns (small blind) folded before Flop


PokerStars Hand #222987596692:  Hold'em No Limit ($2.50/$5.00 USD) - 2021/01/24 1:41:50 ET
Table 'Aaltje II' 6-max Seat #6 is the button
Seat 1: Rabarber77 ($1744.99 in chips)
Seat 2: RAidakCo ($726.59 in chips)
Seat 3: IdrinkBEERI ($2189.99 in chips)
Seat 4: supbigdiaper ($2862.01 in chips)
Seat 5: Yaaaazz ($505 in chips)
Seat 6: Labuns ($1394.02 in chips)
Rabarber77: posts small blind $2.50
RAidakCo: posts big blind $5
*** HOLE CARDS ***
IdrinkBEERI: raises $5.50 to $10.50
supbigdiaper: folds
Yaaaazz: calls $10.50
Labuns: calls $10.50
Rabarber77: calls $8
RAidakCo: folds
*** FLOP *** [2c 7h Tc]
Rabarber77: checks
IdrinkBEERI: bets $22.77
Yaaaazz: folds
Labuns: calls $22.77
Rabarber77: folds
*** TURN *** [2c 7h Tc] [6s]
IdrinkBEERI: checks
Labuns: bets $161.17
IdrinkBEERI: folds
Uncalled bet ($161.17) returned to Labuns
Labuns collected $89.54 from pot
Labuns: doesn't show hand
*** SUMMARY ***
Total pot $92.54 | Rake $3
Board [2c 7h Tc 6s]
Seat 1: Rabarber77 (small blind) folded on the Flop
Seat 2: RAidakCo (big blind) folded before Flop
Seat 3: IdrinkBEERI folded on the Turn
Seat 4: supbigdiaper folded before Flop (didn't bet)
Seat 5: Yaaaazz folded on the Flop
Seat 6: Labuns (button) collected ($89.54)


PokerStars Hand #222987621909:  Hold'em No Limit ($2.50/$5.00 USD) - 2021/01/24 1:43:15 ET
Table 'Aaltje II' 6-max Seat #1 is the button
Seat 1: Rabarber77 ($1734.49 in chips)
Seat 2: RAidakCo ($721.59 in chips)
Seat 3: IdrinkBEERI ($2156.72 in chips)
Seat 4: supbigdiaper ($2862.01 in chips)
Seat 5: Yaaaazz ($500 in chips)
Seat 6: Labuns ($1450.29 in chips)
RAidakCo: posts small blind $2.50
IdrinkBEERI: posts big blind $5
*** HOLE CARDS ***
supbigdiaper: folds
Yaaaazz: folds
Labuns: folds
Rabarber77: raises $10 to $15
RAidakCo: folds
IdrinkBEERI: folds
Uncalled bet ($10) returned to Rabarber77
Rabarber77 collected $12.50 from pot
Rabarber77: doesn't show hand
*** SUMMARY ***
Total pot $12.50 | Rake $0
Seat 1: Rabarber77 (button) collected ($12.50)
Seat 2: RAidakCo (small blind) folded before Flop
Seat 3: IdrinkBEERI (big blind) folded before Flop
Seat 4: supbigdiaper folded before Flop (didn't bet)
Seat 5: Yaaaazz folded before Flop (didn't bet)
Seat 6: Labuns folded before Flop (didn't bet)


PokerStars Hand #222987625226:  Hold'em No Limit ($2.50/$5.00 USD) - 2021/01/24 1:43:30 ET
Table 'Aaltje II' 6-max Seat #2 is the button
Seat 1: Rabarber77 ($1741.99 in chips)
Seat 2: RAidakCo ($719.09 in chips)
Seat 3: IdrinkBEERI ($2151.72 in chips)
Seat 4: supbigdiaper ($2862.01 in chips)
Seat 5: Yaaaazz ($500 in chips)
Seat 6: Labuns ($1450.29 in chips)
IdrinkBEERI: posts small blind $2.50
supbigdiaper: posts big blind $5
*** HOLE CARDS ***
Yaaaazz: raises $6.25 to $11.25
Labuns: folds
Rabarber77: folds
RAidakCo: raises $33.75 to $45
IdrinkBEERI: folds
supbigdiaper: folds
Yaaaazz: folds
Uncalled bet ($33.75) returned to RAidakCo
RAidakCo collected $30 from pot
RAidakCo: doesn't show hand
*** SUMMARY ***
Total pot $30 | Rake $0
Seat 1: Rabarber77 folded before Flop (didn't bet)
Seat 2: RAidakCo (button) collected ($30)
Seat 3: IdrinkBEERI (small blind) folded before Flop
Seat 4: supbigdiaper (big blind) folded before Flop
Seat 5: Yaaaazz folded before Flop
Seat 6: Labuns folded before Flop (didn't bet)


PokerStars Hand #222987630281:  Hold'em No Limit ($2.50/$5.00 USD) - 2021/01/24 1:43:53 ET
Table 'Aaltje II' 6-max Seat #3 is the button
Seat 1: Rabarber77 ($1741.99 in chips)
Seat 2: RAidakCo ($737.84 in chips)
Seat 3: IdrinkBEERI ($2149.22 in chips)
Seat 4: supbigdiaper ($2857.01 in chips)
Seat 5: Yaaaazz ($500 in chips)
Seat 6: Labuns ($1450.29 in chips)
supbigdiaper: posts small blind $2.50
Yaaaazz: posts big blind $5
*** HOLE CARDS ***
Labuns: folds
Rabarber77: raises $10 to $15
RAidakCo: raises $35 to $50
IdrinkBEERI: folds
supbigdiaper: folds
Yaaaazz: folds
Rabarber77: calls $35
*** FLOP *** [Ad 3s 9h]
Rabarber77: checks
RAidakCo: checks
*** TURN *** [Ad 3s 9h] [Jd]
Rabarber77: bets $52.25
RAidakCo: calls $52.25
*** RIVER *** [Ad 3s 9h Jd] [4d]
Rabarber77: checks
RAidakCo: bets $62.70
Rabarber77: folds
Uncalled bet ($62.70) returned to RAidakCo
RAidakCo collected $209 from pot
RAidakCo: doesn't show hand
*** SUMMARY ***
Total pot $212 | Rake $3
Board [Ad 3s 9h Jd 4d]
Seat 1: Rabarber77 folded on the River
Seat 2: RAidakCo collected ($209)
Seat 3: IdrinkBEERI (button) folded before Flop (didn't bet)
Seat 4: supbigdiaper (small blind) folded before Flop
Seat 5: Yaaaazz (big blind) folded before Flop
Seat 6: Labuns folded before Flop (didn't bet)


PokerStars Hand #222987642190:  Hold'em No Limit ($2.50/$5.00 USD) - 2021/01/24 1:44:48 ET
Table 'Aaltje II' 6-max Seat #4 is the button
Seat 1: Rabarber77 ($1639.74 in chips)
Seat 2: RAidakCo ($844.59 in chips)
Seat 3: IdrinkBEERI ($2149.22 in chips)
Seat 4: supbigdiaper ($2854.51 in chips)
Seat 5: Yaaaazz ($500 in chips)
Seat 6: Labuns ($1450.29 in chips)
Yaaaazz: posts small blind $2.50
Labuns: posts big blind $5
*** HOLE CARDS ***
Rabarber77: folds
RAidakCo: folds
IdrinkBEERI: folds
supbigdiaper: folds
Yaaaazz: raises $10 to $15
Labuns: folds
Uncalled bet ($10) returned to Yaaaazz
Yaaaazz collected $10 from pot
Yaaaazz: doesn't show hand
*** SUMMARY ***
Total pot $10 | Rake $0
Seat 1: Rabarber77 folded before Flop (didn't bet)
Seat 2: RAidakCo folded before Flop (didn't bet)
Seat 3: IdrinkBEERI folded before Flop (didn't bet)
Seat 4: supbigdiaper (button) folded before Flop (didn't bet)
Seat 5: Yaaaazz (small blind) collected ($10)
Seat 6: Labuns (big blind) folded before Flop


PokerStars Hand #222987644636:  Hold'em No Limit ($2.50/$5.00 USD) - 2021/01/24 1:44:59 ET
Table 'Aaltje II' 6-max Seat #5 is the button
Seat 1: Rabarber77 ($1639.74 in chips)
Seat 2: RAidakCo ($844.59 in chips)
Seat 3: IdrinkBEERI ($2149.22 in chips)
Seat 4: supbigdiaper ($2854.51 in chips)
Seat 5: Yaaaazz ($505 in chips)
Seat 6: Labuns ($1445.29 in chips)
Labuns: posts small blind $2.50
Rabarber77: posts big blind $5
*** HOLE CARDS ***
RAidakCo: folds
IdrinkBEERI: raises $5.50 to $10.50
supbigdiaper: folds
Yaaaazz: folds
Labuns: folds
Rabarber77: calls $5.50
*** FLOP *** [7h 4h 4s]
Rabarber77: checks
IdrinkBEERI: checks
*** TURN *** [7h 4h 4s] [5d]
Rabarber77: bets $22.32
IdrinkBEERI: calls $22.32
*** RIVER *** [7h 4h 4s 5d] [8d]
Rabarber77: bets $65.14
IdrinkBEERI: folds
Uncalled bet ($65.14) returned to Rabarber77
Rabarber77 collected $65.14 from pot
Rabarber77: doesn't show hand
*** SUMMARY ***
Total pot $68.14 | Rake $3
Board [7h 4h 4s 5d 8d]
Seat 1: Rabarber77 (big blind) collected ($65.14)
Seat 2: RAidakCo folded before Flop (didn't bet)
Seat 3: IdrinkBEERI folded on the River
Seat 4: supbigdiaper folded before Flop (didn't bet)
Seat 5: Yaaaazz (button) folded before Flop (didn't bet)
Seat 6: Labuns (small blind) folded before Flop


PokerStars Hand #222987661360:  Hold'em No Limit ($2.50/$5.00 USD) - 2021/01/24 1:46:16 ET
Table 'Aaltje II' 6-max Seat #6 is the button
Seat 1: Rabarber77 ($1672.06 in chips)
Seat 2: RAidakCo ($844.59 in chips)
Seat 3: IdrinkBEERI ($2116.40 in chips)
Seat 4: supbigdiaper ($2854.51 in chips)
Seat 5: Yaaaazz ($505 in chips)
Seat 6: Labuns ($1442.79 in chips)
Rabarber77: posts small blind $2.50
RAidakCo: posts big blind $5
*** HOLE CARDS ***
IdrinkBEERI: folds
supbigdiaper: folds
Yaaaazz: raises $6.25 to $11.25
Labuns: folds
Rabarber77: folds
RAidakCo: folds
Uncalled bet ($6.25) returned to Yaaaazz
Yaaaazz collected $12.50 from pot
Yaaaazz: doesn't show hand
*** SUMMARY ***
Total pot $12.50 | Rake $0
Seat 1: Rabarber77 (small blind) folded before Flop
Seat 2: RAidakCo (big blind) folded before Flop
Seat 3: IdrinkBEERI folded before Flop (didn't bet)
Seat 4: supbigdiaper folded before Flop (didn't bet)
Seat 5: Yaaaazz collected ($12.50)
Seat 6: Labuns (button) folded before Flop (didn't bet)


PokerStars Hand #222987663976:  Hold'em No Limit ($2.50/$5.00 USD) - 2021/01/24 1:46:28 ET
Table 'Aaltje II' 6-max Seat #1 is the button
Seat 1: Rabarber77 ($1669.56 in chips)
Seat 2: RAidakCo ($839.59 in chips)
Seat 3: IdrinkBEERI ($2116.40 in chips)
Seat 4: supbigdiaper ($2854.51 in chips)
Seat 5: Yaaaazz ($512.50 in chips)
Seat 6: Labuns ($1442.79 in chips)
RAidakCo: posts small blind $2.50
IdrinkBEERI: posts big blind $5
*** HOLE CARDS ***
supbigdiaper: folds
Yaaaazz: folds
supbigdiaper leaves the table
Labuns: folds
Rabarber77: folds
RAidakCo: raises $10 to $15
IdrinkBEERI: folds
Uncalled bet ($10) returned to RAidakCo
RAidakCo collected $10 from pot
RAidakCo: doesn't show hand
*** SUMMARY ***
Total pot $10 | Rake $0
Seat 1: Rabarber77 (button) folded before Flop (didn't bet)
Seat 2: RAidakCo (small blind) collected ($10)
Seat 3: IdrinkBEERI (big blind) folded before Flop
Seat 4: supbigdiaper folded before Flop (didn't bet)
Seat 5: Yaaaazz folded before Flop (didn't bet)
Seat 6: Labuns folded before Flop (didn't bet)


PokerStars Hand #222987667064:  Hold'em No Limit ($2.50/$5.00 USD) - 2021/01/24 1:46:42 ET
Table 'Aaltje II' 6-max Seat #2 is the button
Seat 1: Rabarber77 ($1669.56 in chips)
Seat 2: RAidakCo ($844.59 in chips)
Seat 3: IdrinkBEERI ($2111.40 in chips)
Seat 5: Yaaaazz ($512.50 in chips)
Seat 6: Labuns ($1442.79 in chips)
IdrinkBEERI: posts small blind $2.50
Yaaaazz: posts big blind $5
*** HOLE CARDS ***
Labuns: folds
Rabarber77: raises $10 to $15
Toriiiii joins the table at seat #4
RAidakCo: raises $35 to $50
IdrinkBEERI: folds
Yaaaazz: folds
Rabarber77: calls $35
*** FLOP *** [Ts Qc 3d]
Rabarber77: checks
RAidakCo: bets $31.35
Rabarber77: calls $31.35
*** TURN *** [Ts Qc 3d] [Td]
Rabarber77: checks
RAidakCo: bets $125.40
Rabarber77: folds
Uncalled bet ($125.40) returned to RAidakCo
RAidakCo collected $167.20 from pot
RAidakCo: doesn't show hand
*** SUMMARY ***
Total pot $170.20 | Rake $3
Board [Ts Qc 3d Td]
Seat 1: Rabarber77 folded on the Turn
Seat 2: RAidakCo (button) collected ($167.20)
Seat 3: IdrinkBEERI (small blind) folded before Flop
Seat 5: Yaaaazz (big blind) folded before Flop
Seat 6: Labuns folded before Flop (didn't bet)


PokerStars Hand #222987678616:  Hold'em No Limit ($2.50/$5.00 USD) - 2021/01/24 1:47:35 ET
Table 'Aaltje II' 6-max Seat #3 is the button
Seat 1: Rabarber77 ($1588.21 in chips)
Seat 2: RAidakCo ($930.44 in chips)
Seat 3: IdrinkBEERI ($2108.90 in chips)
Seat 5: Yaaaazz ($507.50 in chips)
Seat 6: Labuns ($1442.79 in chips)
Yaaaazz: posts small blind $2.50
Labuns: posts big blind $5
*** HOLE CARDS ***
Rabarber77: raises $10 to $15
RAidakCo: folds
IdrinkBEERI: folds
Yaaaazz: folds
Labuns: folds
Uncalled bet ($10) returned to Rabarber77
Rabarber77 collected $12.50 from pot
Rabarber77: doesn't show hand
*** SUMMARY ***
Total pot $12.50 | Rake $0
Seat 1: Rabarber77 collected ($12.50)
Seat 2: RAidakCo folded before Flop (didn't bet)
Seat 3: IdrinkBEERI (button) folded before Flop (didn't bet)
Seat 5: Yaaaazz (small blind) folded before Flop
Seat 6: Labuns (big blind) folded before Flop


PokerStars Hand #222987681122:  Hold'em No Limit ($2.50/$5.00 USD) - 2021/01/24 1:47:46 ET
Table 'Aaltje II' 6-max Seat #5 is the button
Seat 1: Rabarber77 ($1595.71 in chips)
Seat 2: RAidakCo ($930.44 in chips)
Seat 3: IdrinkBEERI ($2108.90 in chips)
Seat 5: Yaaaazz ($505 in chips)
Seat 6: Labuns ($1437.79 in chips)
Labuns: posts small blind $2.50
Rabarber77: posts big blind $5
Toriiiii: sits out
*** HOLE CARDS ***
RAidakCo: folds
IdrinkBEERI: raises $5.50 to $10.50
Yaaaazz: folds
Labuns: folds
Rabarber77: folds
Uncalled bet ($5.50) returned to IdrinkBEERI
IdrinkBEERI collected $12.50 from pot
IdrinkBEERI: doesn't show hand
*** SUMMARY ***
Total pot $12.50 | Rake $0
Seat 1: Rabarber77 (big blind) folded before Flop
Seat 2: RAidakCo folded before Flop (didn't bet)
Seat 3: IdrinkBEERI collected ($12.50)
Seat 5: Yaaaazz (button) folded before Flop (didn't bet)
Seat 6: Labuns (small blind) folded before Flop


PokerStars Hand #222987684552:  Hold'em No Limit ($2.50/$5.00 USD) - 2021/01/24 1:48:01 ET
Table 'Aaltje II' 6-max Seat #6 is the button
Seat 1: Rabarber77 ($1590.71 in chips)
Seat 2: RAidakCo ($930.44 in chips)
Seat 3: IdrinkBEERI ($2116.40 in chips)
Seat 5: Yaaaazz ($505 in chips)
Seat 6: Labuns ($1435.29 in chips)
Rabarber77: posts small blind $2.50
RAidakCo: posts big blind $5
Toriiiii: sits out
*** HOLE CARDS ***
IdrinkBEERI: folds
Yaaaazz: folds
Labuns: raises $7.25 to $12.25
Rabarber77: raises $29.50 to $41.75
RAidakCo: raises $98.25 to $140
Labuns: folds
Rabarber77: raises $1450.71 to $1590.71 and is all-in
RAidakCo: calls $790.44 and is all-in
Uncalled bet ($660.27) returned to Rabarber77
*** FLOP *** [7c 5d 7h]
*** TURN *** [7c 5d 7h] [8c]
*** RIVER *** [7c 5d 7h 8c] [Qh]
*** SHOW DOWN ***
Rabarber77: shows [Kh Ac] (a pair of Sevens)
RAidakCo: shows [Ad As] (two pair, Aces and Sevens)
RAidakCo collected $1870.13 from pot
*** SUMMARY ***
Total pot $1873.13 | Rake $3
Board [7c 5d 7h 8c Qh]
Seat 1: Rabarber77 (small blind) showed [Kh Ac] and lost with a pair of Sevens
Seat 2: RAidakCo (big blind) showed [Ad As] and won ($1870.13) with two pair, Aces and Sevens
Seat 3: IdrinkBEERI folded before Flop (didn't bet)
Seat 5: Yaaaazz folded before Flop (didn't bet)
Seat 6: Labuns (button) folded before Flop


PokerStars Hand #222987691931:  Hold'em No Limit ($2.50/$5.00 USD) - 2021/01/24 1:48:35 ET
Table 'Aaltje II' 6-max Seat #1 is the button
Seat 1: Rabarber77 ($660.27 in chips)
Seat 2: RAidakCo ($1870.13 in chips)
Seat 3: IdrinkBEERI ($2116.40 in chips)
Seat 5: Yaaaazz ($505 in chips)
Seat 6: Labuns ($1423.04 in chips)
RAidakCo: posts small blind $2.50
IdrinkBEERI: posts big blind $5
Toriiiii: sits out
*** HOLE CARDS ***
Yaaaazz: folds
Labuns: raises $7.25 to $12.25
Rabarber77: folds
RAidakCo: folds
IdrinkBEERI: folds
Uncalled bet ($7.25) returned to Labuns
Labuns collected $12.50 from pot
Labuns: doesn't show hand
*** SUMMARY ***
Total pot $12.50 | Rake $0
Seat 1: Rabarber77 (button) folded before Flop (didn't bet)
Seat 2: RAidakCo (small blind) folded before Flop
Seat 3: IdrinkBEERI (big blind) folded before Flop
Seat 5: Yaaaazz folded before Flop (didn't bet)
Seat 6: Labuns collected ($12.50)


PokerStars Hand #222987695025:  Hold'em No Limit ($2.50/$5.00 USD) - 2021/01/24 1:48:50 ET
Table 'Aaltje II' 6-max Seat #2 is the button
Seat 1: Rabarber77 ($660.27 in chips)
Seat 2: RAidakCo ($1867.63 in chips)
Seat 3: IdrinkBEERI ($2111.40 in chips)
Seat 4: Toriiiii ($500 in chips)
Seat 5: Yaaaazz ($505 in chips)
Seat 6: Labuns ($1430.54 in chips)
IdrinkBEERI: posts small blind $2.50
Toriiiii: posts big blind $5
*** HOLE CARDS ***
Yaaaazz: folds
Labuns: folds
Rabarber77: folds
RAidakCo: folds
IdrinkBEERI: raises $9.85 to $14.85
Toriiiii: folds
Uncalled bet ($9.85) returned to IdrinkBEERI
IdrinkBEERI collected $10 from pot
IdrinkBEERI: doesn't show hand
*** SUMMARY ***
Total pot $10 | Rake $0
Seat 1: Rabarber77 folded before Flop (didn't bet)
Seat 2: RAidakCo (button) folded before Flop (didn't bet)
Seat 3: IdrinkBEERI (small blind) collected ($10)
Seat 4: Toriiiii (big blind) folded before Flop
Seat 5: Yaaaazz folded before Flop (didn't bet)
Seat 6: Labuns folded before Flop (didn't bet)


PokerStars Hand #222987698775:  Hold'em No Limit ($2.50/$5.00 USD) - 2021/01/24 1:49:07 ET
Table 'Aaltje II' 6-max Seat #3 is the button
Seat 1: Rabarber77 ($660.27 in chips)
Seat 2: RAidakCo ($1867.63 in chips)
Seat 3: IdrinkBEERI ($2116.40 in chips)
Seat 4: Toriiiii ($500 in chips)
Seat 5: Yaaaazz ($505 in chips)
Seat 6: Labuns ($1430.54 in chips)
Toriiiii: posts small blind $2.50
Yaaaazz: posts big blind $5
*** HOLE CARDS ***
Labuns: folds
Rabarber77: folds
RAidakCo: raises $6 to $11
IdrinkBEERI: folds
Toriiiii: folds
Yaaaazz: calls $6
*** FLOP *** [Js 6s 3c]
Yaaaazz: checks
RAidakCo: bets $17.46
Yaaaazz: calls $17.46
*** TURN *** [Js 6s 3c] [Kh]
Yaaaazz: checks
RAidakCo: bets $80
Yaaaazz: folds
Uncalled bet ($80) returned to RAidakCo
RAidakCo collected $56.45 from pot
RAidakCo: doesn't show hand
*** SUMMARY ***
Total pot $59.42 | Rake $2.97
Board [Js 6s 3c Kh]
Seat 1: Rabarber77 folded before Flop (didn't bet)
Seat 2: RAidakCo collected ($56.45)
Seat 3: IdrinkBEERI (button) folded before Flop (didn't bet)
Seat 4: Toriiiii (small blind) folded before Flop
Seat 5: Yaaaazz (big blind) folded on the Turn
Seat 6: Labuns folded before Flop (didn't bet)


PokerStars Hand #222987714519:  Hold'em No Limit ($2.50/$5.00 USD) - 2021/01/24 1:50:18 ET
Table 'Aaltje II' 6-max Seat #4 is the button
Seat 1: Rabarber77 ($660.27 in chips)
Seat 2: RAidakCo ($1895.62 in chips)
Seat 3: IdrinkBEERI ($2116.40 in chips)
Seat 4: Toriiiii ($500 in chips)
Seat 5: Yaaaazz ($500 in chips)
Seat 6: Labuns ($1430.54 in chips)
Yaaaazz: posts small blind $2.50
Labuns: posts big blind $5
*** HOLE CARDS ***
Rabarber77: folds
RAidakCo: folds
Rabarber77 leaves the table
IdrinkBEERI: folds
Toriiiii: raises $7.50 to $12.50
Yaaaazz: folds
Labuns: calls $7.50
*** FLOP *** [Qh Kh Ad]
Labuns: checks
Toriiiii: checks
*** TURN *** [Qh Kh Ad] [Qs]
RAidakCo leaves the table
Labuns: checks
Toriiiii: bets $16.46
Labuns: folds
Uncalled bet ($16.46) returned to Toriiiii
Toriiiii collected $26.12 from pot
Toriiiii: doesn't show hand
*** SUMMARY ***
Total pot $27.50 | Rake $1.38
Board [Qh Kh Ad Qs]
Seat 1: Rabarber77 folded before Flop (didn't bet)
Seat 2: RAidakCo folded before Flop (didn't bet)
Seat 3: IdrinkBEERI folded before Flop (didn't bet)
Seat 4: Toriiiii (button) collected ($26.12)
Seat 5: Yaaaazz (small blind) folded before Flop
Seat 6: Labuns (big blind) folded on the Turn


PokerStars Hand #222987723120:  Hold'em No Limit ($2.50/$5.00 USD) - 2021/01/24 1:50:57 ET
Table 'Aaltje II' 6-max Seat #5 is the button
Seat 3: IdrinkBEERI ($2116.40 in chips)
Seat 4: Toriiiii ($513.62 in chips)
Seat 5: Yaaaazz ($500 in chips)
Seat 6: Labuns ($1418.04 in chips)
Labuns: posts small blind $2.50
IdrinkBEERI: posts big blind $5
*** HOLE CARDS ***
Toriiiii: raises $7.50 to $12.50
Yaaaazz: raises $25 to $37.50
Labuns: folds
IdrinkBEERI: folds
Toriiiii: calls $25
*** FLOP *** [8d 4h 8h]
Toriiiii: checks
Yaaaazz: bets $64.80
Toriiiii: folds
Uncalled bet ($64.80) returned to Yaaaazz
Yaaaazz collected $81 from pot
Yaaaazz: doesn't show hand
*** SUMMARY ***
Total pot $82.50 | Rake $1.50
Board [8d 4h 8h]
Seat 3: IdrinkBEERI (big blind) folded before Flop
Seat 4: Toriiiii folded on the Flop
Seat 5: Yaaaazz (button) collected ($81)
Seat 6: Labuns (small blind) folded before Flop


PokerStars Hand #222987729779:  Hold'em No Limit ($2.50/$5.00 USD) - 2021/01/24 1:51:27 ET
Table 'Aaltje II' 6-max Seat #6 is the button
Seat 3: IdrinkBEERI ($2111.40 in chips)
Seat 4: Toriiiii ($500 in chips)
Seat 5: Yaaaazz ($543.50 in chips)
Seat 6: Labuns ($1415.54 in chips)
IdrinkBEERI: posts small blind $2.50
Toriiiii: posts big blind $5
*** HOLE CARDS ***
Yaaaazz: folds
Labuns: folds
IdrinkBEERI: raises $9.85 to $14.85
Toriiiii: calls $9.85
*** FLOP *** [Td Qc Qh]
rmiguel2007 joins the table at seat #2
IdrinkBEERI: bets $14.39
Toriiiii: folds
Uncalled bet ($14.39) returned to IdrinkBEERI
IdrinkBEERI collected $28.22 from pot
IdrinkBEERI: doesn't show hand
*** SUMMARY ***
Total pot $29.70 | Rake $1.48
Board [Td Qc Qh]
Seat 3: IdrinkBEERI (small blind) collected ($28.22)
Seat 4: Toriiiii (big blind) folded on the Flop
Seat 5: Yaaaazz folded before Flop (didn't bet)
Seat 6: Labuns (button) folded before Flop (didn't bet)


PokerStars Hand #222987735896:  Hold'em No Limit ($2.50/$5.00 USD) - 2021/01/24 1:51:54 ET
Table 'Aaltje II' 6-max Seat #3 is the button
Seat 2: rmiguel2007 ($500 in chips)
Seat 3: IdrinkBEERI ($2124.77 in chips)
Seat 4: Toriiiii ($500 in chips)
Toriiiii: posts small blind $2.50
Yaaaazz: is sitting out
Labuns: is sitting out
rmiguel2007: posts big blind $5
*** HOLE CARDS ***
Yaaaazz leaves the table
IdrinkBEERI: folds
Labuns leaves the table
Toriiiii: raises $7.50 to $12.50
rmiguel2007: calls $7.50
*** FLOP *** [Jh Jc 4s]
Toriiiii: bets $5.94
rmiguel2007: calls $5.94
*** TURN *** [Jh Jc 4s] [2c]
Toriiiii: checks
IdrinkBEERI leaves the table
rmiguel2007: bets $26.54
Toriiiii: folds
Uncalled bet ($26.54) returned to rmiguel2007
rmiguel2007 collected $35.38 from pot
rmiguel2007: doesn't show hand
*** SUMMARY ***
Total pot $36.88 | Rake $1.50
Board [Jh Jc 4s 2c]
Seat 2: rmiguel2007 (big blind) collected ($35.38)
Seat 3: IdrinkBEERI (button) folded before Flop (didn't bet)
Seat 4: Toriiiii (small blind) folded on the Turn